,original_title,revenue,budget,profit,revenue_adj,budget_adj,profit_adj
0,Jurassic World,1513528810,150000000,1363528810,1392445892.5238,137999939.280026,1254445953.243774
1,Mad Max: Fury Road,378436354,150000000,228436354,348161292.489031,137999939.280026,210161353.20900503
2,Insurgent,295238201,110000000,185238201,271619025.407628,101199955.47201899,170419069.935609
3,Star Wars: The Force Awakens,2068178225,200000000,1868178225,1902723129.80182,183999919.040035,1718723210.761785
4,Furious 7,1506249360,190000000,1316249360,1385748801.47052,174799923.08803302,1210948878.382487
5,The Revenant,532950503,135000000,397950503,490314247.02173096,124199945.352024,366114301.66970694
6,Terminator Genisys,440603537,155000000,285603537,405355075.683766,142599937.256027,262755138.427739
7,The Martian,595380321,108000000,487380321,547749654.3101519,99359956.2816192,448389698.02853274
8,Minions,1156730962,74000000,1082730962,1064192016.7955099,68079970.0448131,996112046.7506969
9,Inside Out,853708609,175000000,678708609,785411574.698907,160999929.16003102,624411645.538876
10,Spectre,880674609,245000000,635674609,810220283.783075,225399900.824043,584820382.9590319
11,Jupiter Ascending,183987723,176000003,7987720,169268630.681802,161919931.51523,7348699.166572005
12,Ex Machina,36869414,15000000,21869414,33919845.9552677,13799993.9280026,20119852.027265098
13,Pixels,243637091,88000000,155637091,224146025.095748,80959964.37761559,143186060.71813244
14,Avengers: Age of Ultron,1405035767,280000000,1125035767,1292632336.88177,257599886.656049,1035032450.2257209
15,The Hateful Eight,155760117,44000000,111760117,143299244.588332,40479982.18880779,102819262.39952421
16,Taken 3,325771424,48000000,277771424,299709578.207785,44159980.5696085,255549597.6381765
17,Ant-Man,518602163,130000000,388602163,477113780.029936,119599947.376023,357513832.653913
18,Cinderella,542351353,95000000,447351353,498963025.21626794,87399961.54401691,411563063.67225105
19,The Hunger Games: Mockingjay - Part 2,650523427,160000000,490523427,598481289.508232,147199935.232028,451281354.276204
20,Tomorrowland,209035668,190000000,19035668,192312729.942398,174799923.08803302,17512806.85436499
21,Southpaw,91709827,30000000,61709827,84373003.7158783,27599987.856005296,56773015.859873
22,San Andreas,470490832,110000000,360490832,432851374.985395,101199955.47201899,331651419.513376
23,Fifty Shades of Grey,569651467,40000000,529651467,524079119.045187,36799983.808007106,487279135.2371799
24,The Big Short,133346506,28000000,105346506,122678731.54135801,25759988.665604897,96918742.8757531
25,Mission: Impossible - Rogue Nation,682330139,150000000,532330139,627743451.672881,137999939.280026,489743512.39285505
26,Ted 2,215863606,68000000,147863606,198594430.13845,62559972.4736121,136034457.6648379
27,Kingsman: The Secret Service,403802136,81000000,322802136,371497801.660967,74519967.21121441,296977834.44975257
28,Spotlight,88346473,20000000,68346473,81278719.39736341,18399991.9040035,62878727.49335991
29,Maze Runner: The Scorch Trials,311256926,61000000,250256926,286356245.923251,56119975.30721079,230236270.61604017
30,Mr. Holmes,29355203,0,29355203,27006774.877019,0.0,27006774.877019
31,Chappie,102069268,49000000,53069268,93903685.2423785,45079980.164808705,48823705.0775698
32,Pitch Perfect 2,287506194,29000000,258506194,264505582.09754303,26679988.260805104,237825593.83673793
33,Bridge of Spies,162610473,40000000,122610473,149601569.335309,36799983.808007106,112801585.5273019
34,Goosebumps,150170815,58000000,92170815,138157089.01088,53359976.5216103,84797112.4892697
35,Room,35401758,6000000,29401758,32569603.029374603,5519997.57120106,27049605.458173543
36,Solace,22354572,0,22354572,20566197.1908732,0.0,20566197.1908732
37,The Good Dinosaur,331926147,175000000,156926147,305371920.876354,160999929.16003102,144371991.71632296
38,Run All Night,71561644,50000000,21561644,65836683.5118592,45999979.7600089,19836703.7518503
39,Brooklyn,62076141,11000000,51076141,57110024.5915891,10119995.5472019,46990029.0443872
40,Straight Outta Compton,201634991,28000000,173634991,185504110.098191,25759988.665604897,159744121.4325861
41,The Last Witch Hunter,140396650,90000000,50396650,129164861.16746101,82799963.56801601,46364897.599445
42,Steve Jobs,34441873,30000000,4441873,31686509.2179359,27599987.856005296,4086521.361930605
43,The Man from U.N.C.L.E.,108145109,75000000,33145109,99493456.50287908,68999969.64001329,30493486.86286579
44,The Age of Adaline,42629776,25000000,17629776,39219376.6634742,22999989.8800044,16219386.783469804
45,Hardcore Henry,14333790,10000000,4333790,13187080.9976843,9199995.95200178,3987085.0456825197
46,Home,368871007,135000000,233871007,339361177.121082,124199945.352024,215161231.769058
47,Paper Towns,85512300,12000000,73512300,78671281.38463621,11039995.1424021,67631286.24223411
48,Wild Card,0,30000000,-30000000,0.0,27599987.856005296,-27599987.856005296
49,The Lobster,9064511,4000000,5064511,8339346.45068756,3679998.38080071,4659348.06988685
50,Carol,40272135,11800000,28472135,37050347.8978469,10855995.2233621,26194352.6744848
51,The Intern,194564672,35000000,159564672,178999419.480255,32199985.8320062,146799433.6482488
52,Everest,203427584,55000000,148427584,187153294.93255,50599977.7360098,136553317.1965402
53,Joy,101134059,60000000,41134059,93043293.3409509,55199975.71201059,37843317.628940314
54,Point Break,133718711,105000000,28718711,123021159.990689,96599957.49601871,26421202.494670287
55,Burnt,36606743,20000000,16606743,33678188.7415969,18399991.9040035,15278196.837593399
56,Self/less,30523226,26000000,4523226,28081355.564203497,23919989.475204602,4161366.088998895
57,Mortdecai,30418560,60000000,-29581440,27985062.8865723,55199975.71201059,-27214912.82543829
58,The Danish Girl,64191523,15000000,49191523,59056175.175282896,13799993.9280026,45256181.2472803
59,Blackhat,17752940,70000000,-52247060,16332697.613613,64399971.6640124,-48067274.0503994
60,Sicario,84025816,30000000,54025816,77303716.7063646,27599987.856005296,49703728.850359306
61,Fantastic Four,167977596,120000001,47977595,154539320.322699,110399952.34402,44139367.978679016
62,The Witch,40423945,3500000,36923945,37190013.0363942,3219998.58320062,33970014.45319358
63,Spy,235666219,65000000,170666219,216812826.082356,59799973.6880115,157012852.3943445
64,Focus,153962963,50100000,103862963,141645863.63582,46091979.7195289,95553883.9162911
65,Hitman: Agent 47,82347656,35000000,47347656,75759810.18568349,32199985.8320062,43559824.35367729
66,In the Heart of the Sea,93820758,100000000,-6179242,86315059.3813738,91999959.5200178,-5684900.13864401
67,Survivor,0,20000000,-20000000,0.0,18399991.9040035,-18399991.9040035
68,Creed,137935567,35000000,102935567,126900665.803707,32199985.8320062,94700679.9717008
69,Trainwreck,140795793,35000000,105795793,129532072.56588799,32199985.8320062,97332086.73388179
70,Eye in the Sky,32848185,13000000,19848185,30220316.9030605,11959994.737602301,18260322.1654582
71,Legend,42972994,25000000,17972994,39535137.0845396,22999989.8800044,16535147.204535201
72,Beyond the Reach,45895,0,45895,42223.381421712096,0.0,42223.381421712096
73,Pan,128388320,150000000,-21611680,118117202.42843,137999939.280026,-19882736.851595983
74,Mythica: The Darkspore,0,0,0,0.0,0.0,0.0
75,Me and Earl and the Dying Girl,0,0,0,0.0,0.0,0.0
76,The Peanuts Movie,246233113,99000000,147233113,226534364.284879,91079959.92481759,135454404.3600614
77,Concussion,48623572,35000000,13623572,44733666.5571867,32199985.8320062,12533680.7251805
78,The Night Before,52395996,25000000,27395996,48204295.110110104,22999989.8800044,25204305.230105706
79,Knock Knock,5214043,2500000,2714043,4796917.44935632,2299998.98800044,2496918.4613558804
80,The Longest Ride,63013281,34000000,29013281,57972193.012235,31279986.236806,26692206.775429
81,Hotel Transylvania 2,466183544,80000000,386183544,428888671.76898396,73599967.61601421,355288704.1529697
82,Love the Coopers,24000000,17000000,7000000,22079990.2848042,15639993.118403,6439997.166401198
83,The Walk,61181942,35000000,26181942,56287361.873560704,32199985.8320062,24087376.041554503
84,Tracers,1863315,11000000,-9136685,1714249.04573042,10119995.5472019,-8405746.50147148
85,Vacation,104384188,31000000,73384188,96033410.70529921,28519987.4512055,67513423.2540937
86,Poltergeist,95437994,35000000,60437994,87802915.846717,32199985.8320062,55602930.0147108
87,Maggie,187112,4000000,-3812888,172142.964257095,3679998.38080071,-3507855.416543615
88,Equals,2000000,0,2000000,1839999.19040035,0.0,1839999.19040035
89,Child 44,3324330,50000000,-46675670,3058382.2543117995,45999979.7600089,-42941597.5056971
90,The Gift,58978653,5000000,53978653,54260336.885451704,4599997.97600089,49660338.909450814
91,Daddy's Home,240360392,50000000,190360392,221131463.342156,45999979.7600089,175131483.5821471
92,Mythica: The Necromancer,0,0,0,0.0,0.0,0.0
93,Vice,0,10000000,-10000000,0.0,9199995.95200178,-9199995.95200178
94,The Little Prince,97571250,64000000,33571250,89765510.50317529,58879974.0928114,30885536.41036389
95,Alvin and the Chipmunks: The Road Chip,233755553,0,233755553,215055014.135793,0.0,215055014.135793
96,The Dressmaker,18340000,11930000,6410000,16872792.5759712,10975595.1707381,5897197.405233102
97,The DUFF,43528634,8500000,35028634,40046325.65961671,7819996.55920151,32226329.1004152
98,Sinister 2,52882018,10000000,42882018,48651435.1533685,9199995.95200178,39451439.20136672
99,Paul Blart: Mall Cop 2,107597242,30000000,77597242,98989419.0846556,27599987.856005296,71389431.2286503
100,Frozen Fever,0,0,0,0.0,0.0,0.0
101,High-Rise,0,0,0,0.0,0.0,0.0
102,The Boy Next Door,50163103,4000000,46163103,46150034.4539848,3679998.38080071,42470036.07318409
103,Spooks: The Greater Good,0,0,0,0.0,0.0,0.0
104,Entourage,49263404,30000000,19263404,45322311.73818279,27599987.856005296,17722323.882177494
105,The Wedding Ringer,79799880,23000000,56799880,73415857.2970227,21159990.689604,52255866.6074187
106,Scouts Guide to the Zombie Apocalypse,14860766,15000000,-139234,13671898.704364501,13799993.9280026,-128095.22363809869
107,The Visit,98450062,5000000,93450062,90574017.18743241,4599997.97600089,85974019.21143152
108,Black Mass,99775678,53000000,46775678,91793583.3708233,48759978.5456094,43033604.825213894
109,Heist,50136,8900000,-8849864,46125.099704956105,8187996.39728158,-8141871.297576624
110,Krampus,61548707,15000000,46548707,56624785.5250943,13799993.9280026,42824791.597091705
111,Dark Places,208588,20000000,-19791412,191900.87556361398,18399991.9040035,-18208091.028439887
112,No Escape,54418872,5000000,49418872,50065340.2112503,4599997.97600089,45465342.23524941
113,Dope,17986781,700000,17286781,16547831.2389542,643999.716640124,15903831.522314075
114,American Ultra,28208085,28000000,208085,25951426.781372197,25759988.665604897,191438.11576730013
115,Woman in Gold,61619773,11000000,50619773,56690166.216326796,10119995.5472019,46570170.669124894
116,The Scorpion King: The Lost Throne,0,0,0,0.0,0.0,0.0
117,Sisters,105011053,30000000,75011053,96610126.25154442,27599987.856005296,69010138.39553912
118,Project Almanac,32248241,12000000,20248241,29668368.665917702,11039995.1424021,18628373.523515604
119,Absolutely Anything,5189646,0,5189646,4774472.21923222,0.0,4774472.21923222
120,The Transporter Refueled,72629670,25000000,47629670,66819266.9995225,22999989.8800044,43819277.1195181
121,Crimson Peak,74679822,55000000,19679822,68705406.0096213,50599977.7360098,18105428.27361151
122,Everly,0,0,0,0.0,0.0,0.0
123,Magic Mike XXL,122413057,14800000,107613057,112619962.88721599,13615994.0089626,99003968.87825339
124,Paranormal Activity: The Ghost Dimension,78099553,10000000,68099553,71851557.1453148,9199995.95200178,62651561.19331302
125,Slow West,229094,0,229094,210766.38726278898,0.0,210766.38726278898
126,Trumbo,8235661,15000000,-6764339,7576804.78620589,13799993.9280026,-6223189.14179671
127,Secret in Their Eyes,32189727,19500000,12689727,29614535.809604198,17939992.1064034,11674543.703200798
128,Mistress America,2500431,0,2500431,2300395.50782597,0.0,2300395.50782597
129,The SpongeBob Movie: Sponge Out of Water,311594032,74000000,237594032,286666383.306791,68079970.0448131,218586413.2619779
130,True Story,4719695,0,4719695,4342117.4894683,0.0,4342117.4894683
131,Max,43967255,20000000,23967255,40449856.802063,18399991.9040035,22049864.898059502
132,Shaun the Sheep Movie,59700000,0,59700000,54923975.83345061,0.0,54923975.83345061
133,Louder Than Bombs,0,11000000,-11000000,0.0,10119995.5472019,-10119995.5472019
134,A Perfect Day,1702433,0,1702433,1566237.67085542,0.0,1566237.67085542
135,The Gunman,10664749,40000000,-29335251,9811564.7629115,36799983.808007106,-26988419.045095608
136,Unfriended,62882090,1000000,61882090,57851497.3453411,919999.595200178,56931497.75014092
137,Hot Pursuit,51680201,35000000,16680201,47545763.999863796,32199985.8320062,15345778.167857595
138,Insidious: Chapter 3,104303851,10000000,94303851,95959500.6978197,9199995.95200178,86759504.74581791
139,Z for Zachariah,118483,0,118483,109004.312038102,0.0,109004.312038102
140,Dragonheart 3: The Sorcerer's Curse,0,0,0,0.0,0.0,0.0
141,The Lady in the Van,41387687,6000000,35387687,38076655.2862716,5519997.57120106,32556657.715070542
142,Victor Frankenstein,34227298,40000000,-5772702,31489100.3047958,36799983.808007106,-5310883.503211305
143,Brothers of the Wind,0,0,0,0.0,0.0,0.0
144,Anomalisa,3759286,8000000,-4240714,3458541.59824169,7359996.76160142,-3901455.16335973
145,Bone Tomahawk,0,1800000,-1800000,0.0,1655999.27136032,-1655999.27136032
146,Regression,17671101,0,17671101,16257405.7667414,0.0,16257405.7667414
147,Pawn Sacrifice,0,0,0,0.0,0.0,0.0
148,The Man Who Knew Infinity,11472454,0,11472454,10554653.0359526,0.0,10554653.0359526
149,Momentum,0,20000000,-20000000,0.0,18399991.9040035,-18399991.9040035
150,The Diary of a Teenage Girl,1477002,2000000,-522998,1358841.24210985,1839999.19040035,-481157.94829049986
151,Pay the Ghost,0,0,0,0.0,0.0,0.0
152,The Voices,0,0,0,0.0,0.0,0.0
153,Last Knights,3643591,0,3643591,3352102.24507501,0.0,3352102.24507501
154,Il racconto dei racconti,0,12000000,-12000000,0.0,11039995.1424021,-11039995.1424021
155,Irrational Man,27391084,11000000,16391084,25199786.192094002,10119995.5472019,15079790.644892102
156,Queen of the Desert,0,15000000,-15000000,0.0,13799993.9280026,-13799993.9280026
157,Ricki and the Flash,41325328,18000000,23325328,38019285.0315145,16559992.713603199,21459292.317911305
158,Miss You Already,0,0,0,0.0,0.0,0.0
159,Kung Fury,0,630019,-630019,0.0,579617.224968421,-579617.224968421
160,The Perfect Guy,60273173,12000000,48273173,55451294.7614303,11039995.1424021,44411299.6190282
161,A Bigger Splash,1936524,0,1936524,1781601.29609542,0.0,1781601.29609542
162,While We're Young,7587485,10000000,-2412515,6980483.12858742,9199995.95200178,-2219512.82341436
163,Get Hard,106511453,40000000,66511453,97990493.6441828,36799983.808007106,61190509.836175695
164,Kidnapping Mr. Heineken,0,0,0,0.0,0.0,0.0
165,The Ridiculous 6,0,60000000,-60000000,0.0,55199975.71201059,-55199975.71201059
166,Kill Me Three Times,0,0,0,0.0,0.0,0.0
167,The 33,24902723,25000000,-97277,22910495.079382103,22999989.8800044,-89494.80062229559
168,Suffragette,16002420,14000000,2002420,14722219.9222232,12879994.3328024,1842225.5894207992
169,45 Years,0,0,0,0.0,0.0,0.0
170,We Are Your Friends,11122090,6000000,5122090,10232318.297779901,5519997.57120106,4712320.726578841
171,Barely Lethal,6075,0,6075,5588.997540841079,0.0,5588.997540841079
172,Macbeth,13192457,0,13192457,12137055.0996957,0.0,12137055.0996957
173,Extraction,16775,0,16775,15432.9932094829,0.0,15432.9932094829
174,Jenny's Wedding,0,0,0,0.0,0.0,0.0
175,Descendants,0,0,0,0.0,0.0,0.0
176,Tumbledown,0,0,0,0.0,0.0,0.0
177,Far from the Madding Crowd,30229977,0,30229977,27811566.6029106,0.0,27811566.6029106
178,The End of the Tour,3002884,0,3002884,2762652.06443309,0.0,2762652.06443309
179,The Second Best Exotic Marigold Hotel,85978266,10000000,75978266,79099969.91601321,9199995.95200178,69899973.96401143
180,Little Boy,6420319,20000000,-13579681,5906690.88105601,18399991.9040035,-12493301.02294749
181,LEGO DC Comics Super Heroes: Justice League vs. Bizarro League,0,0,0,0.0,0.0,0.0
182,Remember,1986615,0,1986615,1827684.9958186,0.0,1827684.9958186
183,Aloha,26250020,37000000,-10749980,24150007.7739965,34039985.0224065,-9889977.248410005
184,Accidental Love,0,26000000,-26000000,0.0,23919989.475204602,-23919989.475204602
185,Halo: The Fall of Reach,0,0,0,0.0,0.0,0.0
186,Our Brand Is Crisis,7002261,28000000,-20997739,6442077.28548599,25759988.665604897,-19317911.380118906
187,Into the Forest,0,0,0,0.0,0.0,0.0
188,The Invitation,231737,0,231737,213197.946192903,0.0,213197.946192903
189,The Benefactor,0,0,0,0.0,0.0,0.0
190,Open Season: Scared Silly,0,0,0,0.0,0.0,0.0
191,Cop Car,134552,0,134552,123787.785533374,0.0,123787.785533374
192,Mojave,0,0,0,0.0,0.0,0.0
193,Sleeping with Other People,3214116,0,3214116,2956985.41892641,0.0,2956985.41892641
194,Forsaken,0,11000000,-11000000,0.0,10119995.5472019,-10119995.5472019
195,Amy,8413144,0,8413144,7740089.0743608,0.0,7740089.0743608
196,Madame Bovary,0,0,0,0.0,0.0,0.0
197,The Hallow,0,0,0,0.0,0.0,0.0
198,Barbie in Princess Power,0,0,0,0.0,0.0,0.0
199,Howl,0,0,0,0.0,0.0,0.0
200,Freeheld,573335,7000000,-6426665,527467.967914094,6439997.16640124,-5912529.198487146
201,Man Up,0,0,0,0.0,0.0,0.0
202,Love,695269,3000000,-2304731,639647.198555232,2759998.78560053,-2120351.587045298
203,Truth,2541554,9600000,-7058446,2338228.65117939,8831996.11392171,-6493767.462742319
204,Return to Sender,0,0,0,0.0,0.0,0.0
205,Danny Collins,10835752,10000000,835752,9968887.45368952,9199995.95200178,768891.501687739
206,Rock the Kasbah,3020664,15000000,-11979336,2779009.65723575,13799993.9280026,-11020984.27076685
207,Fathers and Daughters,0,2240000,-2240000,0.0,2060799.09324839,-2060799.09324839
208,"Hello, My Name Is Doris",14444999,1000000,13444999,13289393.2326669,919999.595200178,12369393.637466723
209,The Vatican Tapes,1784763,13000000,-11215237,1641981.23752825,11959994.737602301,-10318013.500074051
210,99 Homes,1411927,8000000,-6588073,1298972.2684521999,7359996.76160142,-6061024.49314922
211,Hot Tub Time Machine 2,12314651,14000000,-1685349,11329473.935031401,12879994.3328024,-1550520.397770999
212,Knight of Cups,0,0,0,0.0,0.0,0.0
213,Manglehorn,143101,4000000,-3856899,131652.86207274,3679998.38080071,-3548345.51872797
214,Mississippi Grind,0,0,0,0.0,0.0,0.0
215,400 Days,0,0,0,0.0,0.0,0.0
216,Lava,0,0,0,0.0,0.0,0.0
217,Air,0,0,0,0.0,0.0,0.0
218,Riot,0,0,0,0.0,0.0,0.0
219,Septembers of Shiraz,0,0,0,0.0,0.0,0.0
220,Every Thing Will Be Fine,8034,0,8034,7391.27674783823,0.0,7391.27674783823
221,Extinction,0,0,0,0.0,0.0,0.0
222,The Childhood of a Leader,0,0,0,0.0,0.0,0.0
223,A Walk in the Woods,35991087,8000000,27991087,33111785.4708143,7359996.76160142,25751788.709212877
224,Clown,0,0,0,0.0,0.0,0.0
225,The Lazarus Effect,64110728,3300000,60810728,58981843.80798871,3035998.66416058,55945845.14382813
226,Batman vs. Robin,0,0,0,0.0,0.0,0.0
227,Careful What You Wish For,0,8000000,-8000000,0.0,7359996.76160142,-7359996.76160142
228,Racing Extinction,0,0,0,0.0,0.0,0.0
229,Unfinished Business,14431253,35000000,-20568747,13276746.918231301,32199985.8320062,-18923238.9137749
230,Lost River,45431,2000000,-1954569,41796.5016095392,1839999.19040035,-1798202.6887908108
231,Cobain: Montage of Heck,0,0,0,0.0,0.0,0.0
232,Hyena Road,0,0,0,0.0,0.0,0.0
233,Criminal Activities,0,7000000,-7000000,0.0,6439997.16640124,-6439997.16640124
234,Life,0,12000000,-12000000,0.0,11039995.1424021,-11039995.1424021
235,"McFarland, USA",45710059,0,45710059,42053235.776576206,0.0,42053235.776576206
236,Backtrack,0,0,0,0.0,0.0,0.0
237,X+Y,0,0,0,0.0,0.0,0.0
238,Home Sweet Hell,0,3000000,-3000000,0.0,2759998.78560053,-2759998.78560053
239,Ooops! Noah is Gone...,0,6000000,-6000000,0.0,5519997.57120106,-5519997.57120106
240,The Unspoken,0,0,0,0.0,0.0,0.0
241,Hot Girls Wanted,0,0,0,0.0,0.0,0.0
242,The Gallows,42664410,100000,42564410,39251239.9294544,91999.95952001779,39159239.96993438
243,Dirty Weekend,0,0,0,0.0,0.0,0.0
244,I Spit on Your Grave III: Vengeance is Mine,0,0,0,0.0,0.0,0.0
245,Experimenter,0,0,0,0.0,0.0,0.0
246,By the Sea,3334927,10000000,-6665073,3068131.49002214,9199995.95200178,-6131864.461979641
247,Woodlawn,0,0,0,0.0,0.0,0.0
248,The Hollow,0,0,0,0.0,0.0,0.0
249,Visions,0,0,0,0.0,0.0,0.0
250,Beyond the Mask,1236094,0,1236094,1137205.97962936,0.0,1137205.97962936
251,I Am Here,0,0,0,0.0,0.0,0.0
252,Wild Horses,0,0,0,0.0,0.0,0.0
253,Pressure,0,0,0,0.0,0.0,0.0
254,Hidden,0,0,0,0.0,0.0,0.0
255,Hell & Back,157768,0,157768,145146.496135541,0.0,145146.496135541
256,Robot Overlords,0,21000000,-21000000,0.0,19319991.4992037,-19319991.4992037
257,The Man with the Iron Fists 2,0,0,0,0.0,0.0,0.0
258,LEGO DC Comics Super Heroes: Justice League: Attack of the Legion of Doom!,0,0,0,0.0,0.0,0.0
259,Crown for Christmas,0,0,0,0.0,0.0,0.0
260,Spare Parts,0,0,0,0.0,0.0,0.0
261,The World Made Straight,0,0,0,0.0,0.0,0.0
262,Last Shift,0,0,0,0.0,0.0,0.0
263,Frankenstein,0,0,0,0.0,0.0,0.0
264,Cartel Land,0,0,0,0.0,0.0,0.0
265,Superfast!,0,20000000,-20000000,0.0,18399991.9040035,-18399991.9040035
266,Moonwalkers,0,0,0,0.0,0.0,0.0
267,Chi-Raq,0,0,0,0.0,0.0,0.0
268,Bad Asses on the Bayou,0,5300000,-5300000,0.0,4875997.85456094,-4875997.85456094
269,Strange Magic,13603453,0,13603453,12515171.2533246,0.0,12515171.2533246
270,Black or White,21571189,9000000,12571189,19845485.147986498,8279996.356801599,11565488.791184898
271,Dead Rising,0,0,0,0.0,0.0,0.0
272,Deathgasm,0,0,0,0.0,0.0,0.0
273,Justice League: Gods and Monsters,0,0,0,0.0,0.0,0.0
274,I Saw the Light,1646788,13000000,-11353212,1515044.29338051,11959994.737602301,-10444950.44422179
275,Good Kill,316472,0,316472,291154.11189219,0.0,291154.11189219
276,Southbound,0,0,0,0.0,0.0,0.0
277,Star Trek: Renegades,0,0,0,0.0,0.0,0.0
278,The Boy,0,0,0,0.0,0.0,0.0
279,Riley's First Date?,0,0,0,0.0,0.0,0.0
280,The Program,3286448,0,3286448,3023530.82964643,0.0,3023530.82964643
281,Lila & Eve,0,0,0,0.0,0.0,0.0
282,The Final Girls,0,0,0,0.0,0.0,0.0
283,He Never Died,0,0,0,0.0,0.0,0.0
284,A Very Murray Christmas,0,0,0,0.0,0.0,0.0
285,Kill Your Friends,0,0,0,0.0,0.0,0.0
286,Battle For SkyArk,0,0,0,0.0,0.0,0.0
287,Jem and the Holograms,2333684,5000000,-2666316,2146988.33532513,4599997.97600089,-2453009.6406757603
288,The Adderall Diaries,0,0,0,0.0,0.0,0.0
289,Grizzly,0,10000000,-10000000,0.0,9199995.95200178,-9199995.95200178
290,Where to Invade Next,0,0,0,0.0,0.0,0.0
291,Beasts of No Nation,90777,6000000,-5909223,83514.8032534865,5519997.57120106,-5436482.767947573
292,A Christmas Horror Story,0,0,0,0.0,0.0,0.0
293,Sunset Song,0,0,0,0.0,0.0,0.0
294,Synchronicity,4505,0,4505,4144.5981763767995,0.0,4144.5981763767995
295,12 Gifts of Christmas,0,0,0,0.0,0.0,0.0
296,The Pack,0,0,0,0.0,0.0,0.0
297,Demonic,3387000,3000000,387000,3116038.628943,2759998.78560053,356039.84334247
298,The Girl in the Photographs,0,0,0,0.0,0.0,0.0
299,The Legend of Barney Thomson,0,0,0,0.0,0.0,0.0
300,The Duke of Burgundy,0,1000000,-1000000,0.0,919999.595200178,-919999.595200178
301,88,0,0,0,0.0,0.0,0.0
302,The Girl in the Book,0,0,0,0.0,0.0,0.0
303,Avengers Grimm,0,0,0,0.0,0.0,0.0
304,The D Train,771317,447524,323793,709611.327771015,411721.89884236397,297889.42892865103
305,The Lion Guard: Return of the Roar,0,0,0,0.0,0.0,0.0
306,A Royal Night Out,228136,0,228136,209885.027650587,0.0,209885.027650587
307,Parallels,0,0,0,0.0,0.0,0.0
308,Born to Be Blue,830129,0,830129,763718.3439639279,0.0,763718.3439639279
309,The Marine 4: Moving Target,0,1950000,-1950000,0.0,1793999.21064034,-1793999.21064034
310,Tales of Halloween,0,0,0,0.0,0.0,0.0
311,Blunt Force Trauma,0,1000000,-1000000,0.0,919999.595200178,-919999.595200178
312,Operator,0,0,0,0.0,0.0,0.0
313,The Human Centipede 3 (Final Sequence),0,0,0,0.0,0.0,0.0
314,Spring,49970,0,49970,45972.3797721529,0.0,45972.3797721529
315,The Intruders,0,0,0,0.0,0.0,0.0
316,We Are Still Here,0,0,0,0.0,0.0,0.0
317,Monster High: Haunted,0,0,0,0.0,0.0,0.0
318,3-Headed Shark Attack,0,0,0,0.0,0.0,0.0
319,Navy Seals vs. Zombies,0,0,0,0.0,0.0,0.0
320,Wrecker,0,0,0,0.0,0.0,0.0
321,The Escort,0,0,0,0.0,0.0,0.0
322,Martyrs,0,0,0,0.0,0.0,0.0
323,Uncanny,0,0,0,0.0,0.0,0.0
324,Bad Hair Day,0,0,0,0.0,0.0,0.0
325,Area 51,0,5000000,-5000000,0.0,4599997.97600089,-4599997.97600089
326,San Andreas Quake,0,0,0,0.0,0.0,0.0
327,The Runner,0,6000000,-6000000,0.0,5519997.57120106,-5519997.57120106
328,Advantageous,0,0,0,0.0,0.0,0.0
329,Partisan,0,0,0,0.0,0.0,0.0
330,R.L. Stine's Monsterville: The Cabinet of Souls,0,4400000,-4400000,0.0,4047998.21888078,-4047998.21888078
331,Strangerland,17472,10000000,-9982528,16074.2329273375,9199995.95200178,-9183921.719074443
332,Ashby,0,0,0,0.0,0.0,0.0
333,Beautiful & Twisted,0,0,0,0.0,0.0,0.0
334,Ronaldo,0,0,0,0.0,0.0,0.0
335,Going Clear: Scientology and the Prison of Belief,0,0,0,0.0,0.0,0.0
336,Zipper,0,0,0,0.0,0.0,0.0
337,War Pigs,0,0,0,0.0,0.0,0.0
338,Turbo Kid,0,0,0,0.0,0.0,0.0
339,Barbie in Rock 'N Royals,0,0,0,0.0,0.0,0.0
340,Circle,0,0,0,0.0,0.0,0.0
341,Monkey Kingdom,16661077,0,16661077,15328184.095599,0.0,15328184.095599
342,Joe Dirt 2: Beautiful Loser,0,0,0,0.0,0.0,0.0
343,Minions: The Competition,0,0,0,0.0,0.0,0.0
344,I'll See You in My Dreams,7449681,0,7449681,6853703.50437045,0.0,6853703.50437045
345,Jesse Stone: Lost in Paradise,0,0,0,0.0,0.0,0.0
346,Steve Jobs: The Man in the Machine,494506,0,494506,454945.31982405897,0.0,454945.31982405897
347,Babysitter's Black Book,0,0,0,0.0,0.0,0.0
348,The Ones Below,0,0,0,0.0,0.0,0.0
349,Tremors 5: Bloodlines,0,0,0,0.0,0.0,0.0
350,Captive,2801508,2000000,801508,2577386.22595006,1839999.19040035,737387.03554971
351,Terminus,0,0,0,0.0,0.0,0.0
352,Andron,0,0,0,0.0,0.0,0.0
353,How to Plan an Orgy in a Small Town,0,0,0,0.0,0.0,0.0
354,Freaks of Nature,70958,0,70958,65281.3312762142,0.0,65281.3312762142
355,Reversal,0,0,0,0.0,0.0,0.0
356,Batman Unlimited: Monster Mayhem,0,0,0,0.0,0.0,0.0
357,The Lovers,0,27000000,-27000000,0.0,24839989.0704048,-24839989.0704048
358,Holding the Man,0,0,0,0.0,0.0,0.0
359,Harbinger Down,0,0,0,0.0,0.0,0.0
360,Batman Unlimited: Animal Instincts,0,0,0,0.0,0.0,0.0
361,Entertainment,0,0,0,0.0,0.0,0.0
362,Meadowland,0,0,0,0.0,0.0,0.0
363,The Stanford Prison Experiment,643557,0,643557,592072.179488241,0.0,592072.179488241
364,The Girl King,0,0,0,0.0,0.0,0.0
365,Bessie,0,0,0,0.0,0.0,0.0
366,The Atticus Institute,0,0,0,0.0,0.0,0.0
367,The Hoarder,0,0,0,0.0,0.0,0.0
368,I Smile Back,0,0,0,0.0,0.0,0.0
369,Oddball,0,0,0,0.0,0.0,0.0
370,Meru,2334228,0,2334228,2147488.81510492,0.0,2147488.81510492
371,Sanjay's Super Team,0,0,0,0.0,0.0,0.0
372,Learning to Drive,3447633,0,3447633,3171820.96439877,0.0,3171820.96439877
373,Christmas Eve,0,0,0,0.0,0.0,0.0
374,The Sisterhood of Night,0,0,0,0.0,0.0,0.0
375,Sharknado 3: Oh Hell No!,0,0,0,0.0,0.0,0.0
376,12 Rounds 3: Lockdown,0,0,0,0.0,0.0,0.0
377,Hitting the Apex,0,0,0,0.0,0.0,0.0
378,Club Life,4444,0,4444,4088.47820106959,0.0,4088.47820106959
379,Cleveland Abduction,0,0,0,0.0,0.0,0.0
380,90 Minutes in Heaven,4842699,5000000,-157301,4455281.1196763,4599997.97600089,-144716.8563245898
381,Lavalantula,0,0,0,0.0,0.0,0.0
382,Unexpected,0,0,0,0.0,0.0,0.0
383,Justice League: Throne of Atlantis,0,3500000,-3500000,0.0,3219998.58320062,-3219998.58320062
384,Lady Chatterley's Lover,0,0,0,0.0,0.0,0.0
385,The Wicked Within,0,0,0,0.0,0.0,0.0
386,Bridgend,0,0,0,0.0,0.0,0.0
387,Backcountry,0,0,0,0.0,0.0,0.0
388,Walter,0,700000,-700000,0.0,643999.716640124,-643999.716640124
389,Ratter,0,500000,-500000,0.0,459999.797600089,-459999.797600089
390,An Inspector Calls,0,0,0,0.0,0.0,0.0
391,The Survivalist,0,0,0,0.0,0.0,0.0
392,Don't Grow Up,0,0,0,0.0,0.0,0.0
393,Night Of The Living Deb,0,2000000,-2000000,0.0,1839999.19040035,-1839999.19040035
394,No Stranger Than Love,0,0,0,0.0,0.0,0.0
395,The Hive,0,0,0,0.0,0.0,0.0
396,Back in Time,0,0,0,0.0,0.0,0.0
397,Nina Forever,0,0,0,0.0,0.0,0.0
398,Some Kind Of Hate,0,0,0,0.0,0.0,0.0
399,The Dead Room,0,1000000,-1000000,0.0,919999.595200178,-919999.595200178
400,Condemned,0,0,0,0.0,0.0,0.0
401,Night Owls,0,0,0,0.0,0.0,0.0
402,The Sand,0,0,0,0.0,0.0,0.0
403,Digging for Fire,0,0,0,0.0,0.0,0.0
404,Ten Thousand Saints,0,0,0,0.0,0.0,0.0
405,From the Dark,0,0,0,0.0,0.0,0.0
406,My All American,0,20000000,-20000000,0.0,18399991.9040035,-18399991.9040035
407,Hangman,0,0,0,0.0,0.0,0.0
408,Larry Gaye: Renegade Male Flight Attendant,0,0,0,0.0,0.0,0.0
409,Grandma,7087452,600000,6487452,6520452.97100069,551999.757120106,5968453.213880584
410,Anarchy Parlor,0,0,0,0.0,0.0,0.0
411,Summer Camp,0,0,0,0.0,0.0,0.0
412,Backmask,0,0,0,0.0,0.0,0.0
413,Already Tomorrow in Hong Kong,0,0,0,0.0,0.0,0.0
414,Those People,0,0,0,0.0,0.0,0.0
415,Show Me a Hero,0,0,0,0.0,0.0,0.0
416,Curve,0,0,0,0.0,0.0,0.0
417,Pound of Flesh,0,7500000,-7500000,0.0,6899996.96400133,-6899996.96400133
418,Cyberbully,0,0,0,0.0,0.0,0.0
419,Final Girl,0,0,0,0.0,0.0,0.0
420,He Named Me Malala,2642899,0,2642899,2431466.01015495,0.0,2431466.01015495
421,The Driftless Area,0,0,0,0.0,0.0,0.0
422,Do You Believe?,0,0,0,0.0,0.0,0.0
423,7 Days in Hell,0,0,0,0.0,0.0,0.0
424,Belli di papÃ ,0,0,0,0.0,0.0,0.0
425,Teen Beach 2,0,0,0,0.0,0.0,0.0
426,Full Out,0,1500000,-1500000,0.0,1379999.39280026,-1379999.39280026
427,Narcopolis,0,1500000,-1500000,0.0,1379999.39280026,-1379999.39280026
428,Staten Island Summer,0,0,0,0.0,0.0,0.0
429,Safelight,0,0,0,0.0,0.0,0.0
430,Bad Roomies,0,0,0,0.0,0.0,0.0
431,Close Range,0,0,0,0.0,0.0,0.0
432,The Reconstruction of William Zero,0,0,0,0.0,0.0,0.0
433,Queen of Earth,0,0,0,0.0,0.0,0.0
434,After the Ball,161820,0,161820,148874.334495292,0.0,148874.334495292
435,A Christmas Detour,0,0,0,0.0,0.0,0.0
436,"What Happened, Miss Simone?",0,0,0,0.0,0.0,0.0
437,Alex of Venice,0,0,0,0.0,0.0,0.0
438,The Eichmann Show,0,0,0,0.0,0.0,0.0
439,"People, Places, Things",0,0,0,0.0,0.0,0.0
440,"The Death of ""Superman Lives"": What Happened?",0,0,0,0.0,0.0,0.0
441,Winter on Fire: Ukraine's Fight for Freedom,0,0,0,0.0,0.0,0.0
442,Ava's Possessions,0,0,0,0.0,0.0,0.0
443,Being Charlie,30400,0,30400,27967.9876940854,0.0,27967.9876940854
444,Containment,0,0,0,0.0,0.0,0.0
445,The Exorcism of Molly Hartley,0,0,0,0.0,0.0,0.0
446,The Diabolical,0,0,0,0.0,0.0,0.0
447,Last Cab to Darwin,0,0,0,0.0,0.0,0.0
448,Intruders,0,0,0,0.0,0.0,0.0
449,Infini,0,0,0,0.0,0.0,0.0
450,A Christmas Melody,0,0,0,0.0,0.0,0.0
451,Muck,0,0,0,0.0,0.0,0.0
452,Robert the Doll,0,0,0,0.0,0.0,0.0
453,Bravetown,0,0,0,0.0,0.0,0.0
454,Bite,0,0,0,0.0,0.0,0.0
455,Taylor Swift: The 1989 World Tour - Live,0,0,0,0.0,0.0,0.0
456,Cosmic Scrat-tastrophe,0,0,0,0.0,0.0,0.0
457,Ghoul,0,0,0,0.0,0.0,0.0
458,Waffle Street,0,0,0,0.0,0.0,0.0
459,Deep Web,0,0,0,0.0,0.0,0.0
460,A LEGO Brickumentary,0,650000,-650000,0.0,597999.736880115,-597999.736880115
461,Richard Pryor: Omit the Logic,0,0,0,0.0,0.0,0.0
462,Don Verdean,0,0,0,0.0,0.0,0.0
463,The Editor,0,0,0,0.0,0.0,0.0
464,Nasty Baby,0,0,0,0.0,0.0,0.0
465,Bitter Lake,0,0,0,0.0,0.0,0.0
466,June,0,0,0,0.0,0.0,0.0
467,The Overnight,1100000,0,1100000,1011999.55472019,0.0,1011999.55472019
468,The Rise of the Krays,0,2500000,-2500000,0.0,2299998.98800044,-2299998.98800044
469,Smosh: The Movie,0,0,0,0.0,0.0,0.0
470,Keepers of the Covenant: Making Exodus: Gods and Kings,0,0,0,0.0,0.0,0.0
471,è§£æ•‘å´å…ˆç”Ÿ,0,0,0,0.0,0.0,0.0
472,The Quiet Hour,0,0,0,0.0,0.0,0.0
473,Lost in the Sun,0,0,0,0.0,0.0,0.0
474,Results,104507,0,104507,96146.397695585,0.0,96146.397695585
475,Addicted to Fresno,0,0,0,0.0,0.0,0.0
476,Listening,0,0,0,0.0,0.0,0.0
477,Jack of the Red Hearts,0,0,0,0.0,0.0,0.0
478,Absolution,0,0,0,0.0,0.0,0.0
479,American Hero,0,0,0,0.0,0.0,0.0
480,The Condemned 2,0,0,0,0.0,0.0,0.0
481,Bound,0,0,0,0.0,0.0,0.0
482,Re-Kill,0,9500000,-9500000,0.0,8739996.15440169,-8739996.15440169
483,SuperBob,0,0,0,0.0,0.0,0.0
484,A Hitman in London,0,0,0,0.0,0.0,0.0
485,Regular Show: The Movie,0,3000000,-3000000,0.0,2759998.78560053,-2759998.78560053
486,If There Be Thorns,0,0,0,0.0,0.0,0.0
487,Pod,0,0,0,0.0,0.0,0.0
488,To Write Love on Her Arms,0,3400000,-3400000,0.0,3127998.6236806,-3127998.6236806
489,Hungry Hearts,6921,0,6921,6367.3171983804295,0.0,6367.3171983804295
490,The Funhouse Massacre,0,0,0,0.0,0.0,0.0
491,Extraordinary Tales,0,0,0,0.0,0.0,0.0
492,War Room,67790117,3000000,64790117,62366880.1985727,2759998.78560053,59606881.412972175
493,A Deadly Adoption,0,0,0,0.0,0.0,0.0
494,Ellis,0,0,0,0.0,0.0,0.0
495,Coconut Hero,0,0,0,0.0,0.0,0.0
496,Janis: Little Girl Blue,0,0,0,0.0,0.0,0.0
497,Io che amo solo te,0,0,0,0.0,0.0,0.0
498,Unknown Caller,0,0,0,0.0,0.0,0.0
499,The Inhabitants,0,0,0,0.0,0.0,0.0
500,Amy Schumer: Live at the Apollo,0,0,0,0.0,0.0,0.0
501,Glassland,0,0,0,0.0,0.0,0.0
502,Whitney,0,0,0,0.0,0.0,0.0
503,Heaven Knows What,0,0,0,0.0,0.0,0.0
504,Keith Richards: Under the Influence,0,0,0,0.0,0.0,0.0
505,Landmine Goes Click,0,1000000,-1000000,0.0,919999.595200178,-919999.595200178
506,Hellions,0,0,0,0.0,0.0,0.0
507,13 Cameras,0,0,0,0.0,0.0,0.0
508,Bastard,0,0,0,0.0,0.0,0.0
509,Strange Blood,0,0,0,0.0,0.0,0.0
510,Jurassic City,0,0,0,0.0,0.0,0.0
511,6 Years,0,0,0,0.0,0.0,0.0
512,I Am Chris Farley,0,0,0,0.0,0.0,0.0
513,Chloe and Theo,0,0,0,0.0,0.0,0.0
514,All Things Must Pass,0,0,0,0.0,0.0,0.0
515,Capsule,0,1300000,-1300000,0.0,1195999.47376023,-1195999.47376023
516,The Nightmare,28281,0,28281,26018.5085518562,0.0,26018.5085518562
517,Tangerine,0,0,0,0.0,0.0,0.0
518,Nightlight,0,0,0,0.0,0.0,0.0
519,"Stockholm, Pennsylvania",0,0,0,0.0,0.0,0.0
520,Power/Rangers,0,0,0,0.0,0.0,0.0
521,Appropriate Behavior,0,0,0,0.0,0.0,0.0
522,See You In Valhalla,0,0,0,0.0,0.0,0.0
523,The True Cost,0,0,0,0.0,0.0,0.0
524,"Kumiko, the Treasure Hunter",0,0,0,0.0,0.0,0.0
525,Invisible Sister,0,0,0,0.0,0.0,0.0
526,The Forbidden Room,0,0,0,0.0,0.0,0.0
527,Finders Keepers,0,0,0,0.0,0.0,0.0
528,Merry Kissmas,0,0,0,0.0,0.0,0.0
529,Most Likely to Die,0,0,0,0.0,0.0,0.0
530,A Girl Like Her,0,0,0,0.0,0.0,0.0
531,Private Number,0,0,0,0.0,0.0,0.0
532,Iliza Shlesinger: Freezing Hot,0,0,0,0.0,0.0,0.0
533,The Barber,0,0,0,0.0,0.0,0.0
534,James White,0,0,0,0.0,0.0,0.0
535,Hitchcock/Truffaut,0,0,0,0.0,0.0,0.0
536,A Faster Horse,0,0,0,0.0,0.0,0.0
537,Amnesiac,0,3000000,-3000000,0.0,2759998.78560053,-2759998.78560053
538,The Mask You Live In,0,0,0,0.0,0.0,0.0
539,Soaked in Bleach,0,0,0,0.0,0.0,0.0
540,And Then There Were None,0,0,0,0.0,0.0,0.0
541,Bloodsucking Bastards,0,0,0,0.0,0.0,0.0
542,The Culling,0,0,0,0.0,0.0,0.0
543,Comedy Central Roast of Justin Bieber,0,0,0,0.0,0.0,0.0
544,Boy Meets Girl,0,0,0,0.0,0.0,0.0
545,Listen to Me Marlon,0,0,0,0.0,0.0,0.0
546,The Ouija Experiment 2: Theatre of Death,0,0,0,0.0,0.0,0.0
547,Walt Before Mickey,0,0,0,0.0,0.0,0.0
548,Sense8: Creating the World,0,0,0,0.0,0.0,0.0
549,Big Sky,0,0,0,0.0,0.0,0.0
550,The Fear of 13,0,0,0,0.0,0.0,0.0
551,Dior and I,0,0,0,0.0,0.0,0.0
552,Ominous,0,0,0,0.0,0.0,0.0
553,Doctor Who: The Husbands of River Song,0,0,0,0.0,0.0,0.0
554,Call Me Lucky,0,0,0,0.0,0.0,0.0
555,Tiger House,0,0,0,0.0,0.0,0.0
556,With This Ring,0,0,0,0.0,0.0,0.0
557,Brothers,0,0,0,0.0,0.0,0.0
558,Anguish,0,0,0,0.0,0.0,0.0
559,Childhood's End,0,0,0,0.0,0.0,0.0
560,Digging Up the Marrow,0,0,0,0.0,0.0,0.0
561,Naomi and Ely's No Kiss List,0,0,0,0.0,0.0,0.0
562,The Cokeville Miracle,0,0,0,0.0,0.0,0.0
563,They Found Hell,0,0,0,0.0,0.0,0.0
564,Junun,0,0,0,0.0,0.0,0.0
565,The Chosen,0,0,0,0.0,0.0,0.0
566,The Flintstones & WWE: Stone Age Smackdown,0,0,0,0.0,0.0,0.0
567,Chris Tucker: Live,0,0,0,0.0,0.0,0.0
568,VANish,0,0,0,0.0,0.0,0.0
569,Harry Price: Ghost Hunter,0,0,0,0.0,0.0,0.0
570,Brotherly Love,0,1900000,-1900000,0.0,1747999.23088033,-1747999.23088033
571,Wildlike,0,0,0,0.0,0.0,0.0
572,The Audition,0,0,0,0.0,0.0,0.0
573,Louis C.K.: Live at The Comedy Store,0,0,0,0.0,0.0,0.0
574,The Wolfpack,1301696,0,1301696,1197559.79307369,0.0,1197559.79307369
575,The Challenger,0,0,0,0.0,0.0,0.0
576,Aziz Ansari: Live at Madison Square Garden,0,0,0,0.0,0.0,0.0
577,Bleeding Heart,0,0,0,0.0,0.0,0.0
578,Requiem for the American Dream,44695,0,44695,41119.3819074719,0.0,41119.3819074719
579,3 Nights in the Desert,0,0,0,0.0,0.0,0.0
580,The House on Pine Street,0,0,0,0.0,0.0,0.0
581,Slow Learners,0,0,0,0.0,0.0,0.0
582,Welcome to Leith,0,0,0,0.0,0.0,0.0
583,Stonewall,187674,13500000,-13312326,172660.004029598,12419994.5352024,-12247334.531172803
584,The Phoenix Incident,0,0,0,0.0,0.0,0.0
585,Contracted: Phase II,0,0,0,0.0,0.0,0.0
586,Penis Boy,0,10,-10,0.0,9.199995952001778,-9.199995952001778
587,The Hunting Ground,0,0,0,0.0,0.0,0.0
588,One & Two,0,0,0,0.0,0.0,0.0
589,Tig,0,0,0,0.0,0.0,0.0
590,Christmas Incorporated,0,0,0,0.0,0.0,0.0
591,Submerged,0,0,0,0.0,0.0,0.0
592,Hurricane of Fun: The Making of Wet Hot,0,0,0,0.0,0.0,0.0
593,Gascoigne,0,0,0,0.0,0.0,0.0
594,One Soldier's Story: The Journey of American Sniper,0,0,0,0.0,0.0,0.0
595,Deep Dark,0,0,0,0.0,0.0,0.0
596,Best of Enemies,0,1000000,-1000000,0.0,919999.595200178,-919999.595200178
597,Vendetta,0,0,0,0.0,0.0,0.0
598,Breaking Through,0,0,0,0.0,0.0,0.0
599,The Stranger,0,0,0,0.0,0.0,0.0
600,Star Wars: TIE Fighter,0,0,0,0.0,0.0,0.0
601,Dough,0,0,0,0.0,0.0,0.0
602,The Bad Education Movie,0,0,0,0.0,0.0,0.0
603,Student Bodies,0,0,0,0.0,0.0,0.0
604,The Subjects,0,0,0,0.0,0.0,0.0
605,Walking with the Dead,0,0,0,0.0,0.0,0.0
606,Floride,0,0,0,0.0,0.0,0.0
607,The Outskirts,0,0,0,0.0,0.0,0.0
608,Twinsters,0,0,0,0.0,0.0,0.0
609,The Jinx: The Life and Deaths of Robert Durst,0,0,0,0.0,0.0,0.0
610,The Curse of Downers Grove,0,2000000,-2000000,0.0,1839999.19040035,-1839999.19040035
611,World of Tomorrow,0,0,0,0.0,0.0,0.0
612,Dawg Fight,0,0,0,0.0,0.0,0.0
613,King Jack,0,0,0,0.0,0.0,0.0
614,The Suicide Theory,0,0,0,0.0,0.0,0.0
615,Stalked By My Neighbor,0,0,0,0.0,0.0,0.0
616,The Outfield,0,0,0,0.0,0.0,0.0
617,Buzzard,13684,0,13684,12589.2744607192,0.0,12589.2744607192
618,The Gamechangers,0,0,0,0.0,0.0,0.0
619,Residue,0,0,0,0.0,0.0,0.0
620,All Hallows' Eve 2,0,0,0,0.0,0.0,0.0
621,Always Watching: A Marble Hornets Story,0,0,0,0.0,0.0,0.0
622,A Ballerina's Tale,0,0,0,0.0,0.0,0.0
623,Man vs. Snake,0,0,0,0.0,0.0,0.0
624,Once I Was a Beehive,732655,0,732655,674042.303421386,0.0,674042.303421386
625,John Mulaney: The Comeback Kid,0,0,0,0.0,0.0,0.0
626,Meet the Patels,0,0,0,0.0,0.0,0.0
627,I Hate Christian Laettner,0,0,0,0.0,0.0,0.0
628,The Emperor's New Clothes,0,0,0,0.0,0.0,0.0
629,Interstellar,621752480,165000000,456752480,572690645.122961,151980023.37728998,420710621.74567103
630,Guardians of the Galaxy,773312399,170000000,603312399,712291130.169508,156585478.631148,555705651.53836
631,Captain America: The Winter Soldier,714766572,170000000,544766572,658365092.859794,156585478.631148,501779614.22864604
632,John Wick,78739897,20000000,58739897,72526614.4653665,18421821.015429102,54104793.449937396
633,The Hunger Games: Mockingjay - Part 1,752100229,125000000,627100229,692752790.215065,115136381.346432,577616408.868633
634,The Hobbit: The Battle of the Five Armies,955119788,250000000,705119788,879752289.141534,230272762.692864,649479526.4486699
635,Big Hero 6,652105443,165000000,487105443,600648487.706658,151980023.37728998,448668464.329368
636,The Imitation Game,233555708,14000000,219555708,215126072.495392,12895274.7108004,202230797.7845916
637,The Maze Runner,348319861,34000000,314319861,320834306.773058,31317095.7262296,289517211.0468284
638,Birdman,103215094,18000000,85215094,95070499.387935,16579638.9138862,78490860.4740488
639,Gone Girl,369330363,61000000,308330363,340186892.137474,56186554.097059,284000338.040415
640,Fury,211817906,68000000,143817906,195103577.60975,62634191.4524592,132469386.1572908
641,Night at the Museum: Secret of the Tomb,349424282,127000000,222424282,321851579.072442,116978563.447975,204873015.62446702
642,Divergent,288747895,85000000,203747895,265963102.013597,78292739.315574,187670362.69802302
643,X-Men: Days of Future Past,746000000,250000000,496000000,687133923.875509,230272762.692864,456861161.182645
644,Lucy,463360063,40000000,423360063,426796807.31419903,36843642.03085829,389953165.28334075
645,Teenage Mutant Ninja Turtles,477200000,125000000,352200000,439544649.42814,115136381.346432,324408268.08170795
646,Sex Tape,126069509,40000000,86069509,116121496.515052,36843642.03085829,79277854.48419371
647,Nightcrawler,38697217,8500000,30197217,35643660.268461205,7829273.9315574,27814386.336903803
648,Transformers: Age of Extinction,245500000,210000000,35500000,226127852.96439302,193429120.66200602,32698732.302387
649,The Grand Budapest Hotel,174600318,30000000,144600318,160822790.371651,27632731.5231437,133190058.84850729
650,Whiplash,13993093,3300000,10693093,12888912.7349127,3039600.46754581,9849312.26736689
651,Dawn of the Planet of the Apes,708200000,170000000,538200000,652316682.1563469,156585478.631148,495731203.52519894
652,The Equalizer,192330738,55000000,137330738,177154121.56007,50660007.7924302,126494113.76763982
653,Horrible Bosses 2,106645357,42000000,64645357,98230083.9390274,38685824.132401295,59544259.806626104
654,The Amazing Spider-Man 2,705717432,200000000,505717432,650030010.988616,184218210.154291,465811800.83432496
655,Edge of Tomorrow,370541256,178000000,192541256,341302234.843216,163954207.037319,177348027.805897
656,The Interview,11305175,44000000,-32694825,10413095.519905198,40528006.2339442,-30114910.714039
657,American Sniper,542307423,58800000,483507423,499514514.09223205,54160153.7853618,445354360.3068702
658,Exodus: Gods and Kings,268031828,140000000,128031828,246881718.092715,128952747.108004,117928970.98471099
659,Godzilla,529076069,160000000,369076069,487327232.33324295,147374568.123433,339952664.20980996
660,Maleficent,758410378,180000000,578410378,698565011.988,165796389.138862,532768622.849138
661,The November Man,32556119,15000000,17556119,29987149.858750604,13816365.761571802,16170784.097178802
662,Ouija,102529779,5000000,97529779,94439261.8744755,4605455.25385729,89833806.62061821
663,How to Train Your Dragon 2,609123048,145000000,464123048,561057788.331434,133558202.361861,427499585.969573
664,It Follows,13500000,2000000,11500000,12434729.185414698,1842182.10154291,10592547.083871787
665,The Expendables 3,206172544,90000000,116172544,189903685.193185,82898194.5694313,107005490.6237537
666,The Lego Movie,469160692,60000000,409160692,432139714.774945,55265463.0462875,376874251.72865754
667,The Loft,0,13000000,-13000000,0.0,11974183.660028901,-11974183.660028901
668,Seventh Son,114178613,95000000,19178613,105168898.623797,87503649.8232886,17665248.800508395
669,The Theory of Everything,121201940,15000000,106201940,111638022.270139,13816365.761571802,97821656.50856718
670,Let's Be Cops,136621271,17000000,119621271,125840630.063122,15658547.8631148,110182082.2000072
671,Dracula Untold,215529201,70000000,145529201,198522018.221023,64476373.5540021,134045644.66702089
672,Penguins of Madagascar,373552094,132000000,241552094,344075490.780339,121584018.70183201,222491472.078507
673,Into the Woods,212902372,50000000,162902372,196102469.53721598,46054552.5385729,150047916.99864307
674,300: Rise of an Empire,337580051,110000000,227580051,310941963.895073,101320015.58486,209621948.310213
675,The Giver,66980456,25000000,41980456,61695098.59819151,23027276.269286398,38667822.328905106
676,22 Jump Street,188441614,50000000,138441614,173571884.248329,46054552.5385729,127517331.7097561
677,A Walk Among the Tombstones,53181600,28000000,25181600,48985095.8257074,25790549.4216008,23194546.4041066
678,Paddington,259207227,55000000,204207227,238753457.08498597,50660007.7924302,188093449.29255578
679,Cake,2360281,7000000,-4639719,2174033.70640591,6447637.35540021,-4273603.6489943005
680,Chef,45967935,11000000,34967935,42340653.550944105,10132001.558486,32208651.992458105
681,The Purge: Anarchy,108782847,9000000,99782847,100198906.84914,8289819.45694313,91909087.39219688
682,Left Behind,19682924,16000000,3682924,18129765.1494147,14737456.812343301,3392308.3370713983
683,Boyhood,44349000,4000000,40349000,40849467.0106634,3684364.20308583,37165102.807577565
684,A Most Violent Year,12007070,20000000,-7992930,11059604.7229864,18421821.015429102,-7362216.292442702
685,Hercules,243400000,100000000,143400000,224193561.757773,92109105.0771459,132084456.68062711
686,Noah,362637473,125000000,237637473,334022131.054676,115136381.346432,218885749.708244
687,The Judge,83719388,50000000,33719388,77113179.0628635,46054552.5385729,31058626.5242906
688,Drive Hard,0,12000000,-12000000,0.0,11053092.6092575,-11053092.6092575
689,Blended,123494610,40000000,83494610,113749780.089511,36843642.03085829,76906138.05865271
690,Neighbors,268157400,18000000,250157400,246997381.33814198,16579638.9138862,230417742.4242558
691,If I Stay,78874843,11000000,67874843,72650912.0183039,10132001.558486,62518910.4598179
692,Step Up All In,86165646,45000000,41165646,79366405.41454159,41449097.2847156,37917308.12982599
693,"Love, Rosie",4439431,0,4439431,4089120.16461739,0.0,4089120.16461739
694,The Fault in Our Stars,305151265,12000000,293151265,281072099.32309,11053092.6092575,270019006.7138325
695,I Origins,336472,0,336472,309921.34803517396,0.0,309921.34803517396
696,Ride Along,153997819,25000000,128997819,141846012.919223,23027276.269286398,118818736.64993662
697,The Captive,1075178,0,1075178,990336.8337863559,0.0,990336.8337863559
698,Inherent Vice,11110975,20000000,-8889025,10234219.6378454,18421821.015429102,-8187601.377583701
699,Jack Ryan: Shadow Recruit,50549107,60000000,-9450893,46560330.0821889,55265463.0462875,-8705132.964098603
700,Non-Stop,222809600,50000000,172809600,205227928.585968,46054552.5385729,159173376.04739508
701,Predestination,3000000,5500000,-2500000,2763273.15231437,5066000.77924302,-2302727.6269286503
702,AutÃ³mata,0,7000000,-7000000,0.0,6447637.35540021,-6447637.35540021
703,Mythica: A Quest for Heroes,0,0,0,0.0,0.0,0.0
704,The Drop,18658381,12600000,6058381,17186067.760984197,11605747.2397203,5580320.521263897
705,RoboCop,239379423,120000000,119379423,220490244.264135,110530926.092575,109959318.17156
706,Transcendence,103039258,100000000,3039258,94908538.42193149,92109105.0771459,2799433.344785586
707,The Other Woman,196781193,40000000,156781193,181253395.83243102,36843642.03085829,144409753.80157274
708,Mr. Peabody & Sherman,272912430,145000000,127912430,251377196.917292,133558202.361861,117818994.555431
709,A Merry Friggin' Christmas,0,0,0,0.0,0.0,0.0
710,Sin City: A Dame to Kill For,39407616,65000000,-25592384,36298002.429838106,59870918.3001448,-23572915.870306693
711,Tinker Bell and the Legend of the NeverBeast,0,0,0,0.0,0.0,0.0
712,Rio 2,500188435,103000000,397188435,460719091.177882,94872378.2294603,365846712.9484217
713,Dumb and Dumber To,169837010,40000000,129837010,156435350.000782,36843642.03085829,119591707.96992372
714,Before I Go to Sleep,15060457,0,15060457,13872052.163228301,0.0,13872052.163228301
715,The Monuments Men,154984035,70000000,84984035,142754407.65095,64476373.5540021,78278034.09694791
716,Unbroken,163442937,65000000,98442937,150545826.582503,59870918.3001448,90674908.2823582
717,Selma,66787908,20000000,46787908,61517744.3585475,18421821.015429102,43095923.3431184
718,Mommy,3494070,4900000,-1405930,3218356.60776903,4513346.14878015,-1294989.5410111202
719,Escobar: Paradise Lost,0,17000000,-17000000,0.0,15658547.8631148,-15658547.8631148
720,Tinker Bell and the Pirate Fairy,20300000,0,20300000,18698148.3306606,0.0,18698148.3306606
721,Wild,52501541,15000000,37501541,48358699.566810794,13816365.761571802,34542333.80523899
722,Pompeii,117831631,130000000,-12168369,108533660.811904,119741836.60028899,-11208175.788384989
723,The Best of Me,35926213,26000000,9926213,33091313.2824092,23948367.3200579,9142945.9623513
724,Annie,133821816,65000000,68821816,123262077.11558402,59870918.3001448,63391158.81543922
725,Stonehearst Asylum,0,0,0,0.0,0.0,0.0
726,The Book of Life,97437106,50000000,47437106,89748446.3496701,46054552.5385729,43693893.8110972
727,St. Vincent,54837234,13000000,41837234,50510085.4864604,11974183.660028901,38535901.8264315
728,Need for Speed,203277636,66000000,137277636,187237211.341578,60792009.350916296,126445201.99066171
729,Two Night Stand,18612,0,18612,17143.346636958402,0.0,17143.346636958402
730,Good People,0,0,0,0.0,0.0,0.0
731,The Hundred-Foot Journey,88880821,22000000,66880821,81867328.80832,20264003.1169721,61603325.6913479
732,The Boxtrolls,108255770,60000000,48255770,99713420.94137341,55265463.0462875,44447957.89508591
733,Big Eyes,28883511,10000000,18883511,26604343.496959,9210910.50771459,17393432.98924441
734,The Prince,266586800,18000000,248586800,245550715.73380098,16579638.9138862,228971076.8199148
735,Black Sea,1171559,0,1171559,1079112.51035076,0.0,1079112.51035076
736,Song of the Sea,857522,0,857522,789855.840039643,0.0,789855.840039643
737,Marvel One-Shot: All Hail the King,0,0,0,0.0,0.0,0.0
738,The Signal,600896,4000000,-3399104,553479.928044367,3684364.20308583,-3130884.275041463
739,White Bird in a Blizzard,0,0,0,0.0,0.0,0.0
740,Into the Storm,160602194,50000000,110602194,147929243.62766102,46054552.5385729,101874691.08908811
741,Outcast,0,25000000,-25000000,0.0,23027276.269286398,-23027276.269286398
742,3 Days to Kill,0,28000000,-28000000,0.0,25790549.4216008,-25790549.4216008
743,Planes: Fire & Rescue,151165787,50000000,101165787,139237453.588524,46054552.5385729,93182901.0499511
744,'71,1625847,0,1625847,1497553.12162362,0.0,1497553.12162362
745,Sabotage,17508518,35000000,-17491482,16126939.242070999,32238186.777001,-16111247.534930002
746,A Million Ways to Die in the West,0,0,0,0.0,0.0,0.0
747,The Forger,0,0,0,0.0,0.0,0.0
748,Frank,645186,0,645186,594275.050683035,0.0,594275.050683035
749,Camp X-Ray,0,1000000,-1000000,0.0,921091.050771459,-921091.050771459
750,No Good Deed,53830415,13200000,40630415,49582713.5158137,12158401.870183198,37424311.6456305
751,Still Alice,41797583,5000000,36797583,38499379.6451773,4605455.25385729,33893924.391320005
752,"As Above, So Below",40100000,5000000,35100000,36935751.1359355,4605455.25385729,32330295.882078208
753,Foxcatcher,12096300,24000000,-11903700,11141793.6774468,22106185.218515,-10964391.541068202
754,Playing It Cool,0,0,0,0.0,0.0,0.0
755,Endless Love,34077920,20000000,14077920,31388867.1409057,18421821.015429102,12967046.125476599
756,The Rover,2295423,12250000,-9954577,2114293.58303497,11283365.3719503,-9169071.78891533
757,Think Like a Man Too,70181428,24000000,46181428,64643485.2611615,22106185.218515,42537300.0426465
758,Suite FranÃ§aise,9104716,15000000,-5895284,8386272.42741572,13816365.761571802,-5430093.334156082
759,The Two Faces of January,4507463,0,4507463,4151783.83098347,0.0,4151783.83098347
760,Walk of Shame,59209,15000000,-14940791,54536.880025127306,13816365.761571802,-13761828.881546674
761,Enemy,3396726,0,3396726,3128693.92052273,0.0,3128693.92052273
762,Annabelle,255273813,6500000,248773813,235130424.650607,5987091.83001448,229143332.82059252
763,Echoes,0,0,0,0.0,0.0,0.0
764,Maya the Bee Movie,0,0,0,0.0,0.0,0.0
765,"I, Frankenstein",71154592,65000000,6154592,65539857.912494496,59870918.3001448,5668939.612349696
766,That Awkward Moment,26049082,8000000,18049082,23993576.3110119,7368728.40617167,16624847.90484023
767,Palo Alto,0,0,0,0.0,0.0,0.0
768,Draft Day,28831145,27000000,1831145,26556109.6429943,24869458.370829396,1686651.2721649036
769,Brick Mansions,68896829,28000000,40896829,63460252.61843149,25790549.4216008,37669703.19683069
770,The Babadook,6676471,2000000,4676471,6149637.68883517,1842182.10154291,4307455.58729226
771,Tammy,100525432,20000000,80525432,92593075.7901349,18421821.015429102,74171254.7747058
772,Boychoir,0,0,0,0.0,0.0,0.0
773,Serena,176391,0,176391,162472.171536628,0.0,162472.171536628
774,Testament of Youth,1822250,0,1822250,1678458.16726829,0.0,1678458.16726829
775,American Heist,0,10000000,-10000000,0.0,9210910.50771459,-9210910.50771459
776,Bullet,0,3000000,-3000000,0.0,2763273.15231437,-2763273.15231437
777,The Skeleton Twins,5284309,0,5284309,4867329.72941108,0.0,4867329.72941108
778,Salting the Battlefield,0,0,0,0.0,0.0,0.0
779,The Calling,0,0,0,0.0,0.0,0.0
780,Winter's Tale,30800231,60000000,-29199769,28369817.135793604,55265463.0462875,-26895645.910493895
781,Pride,7523634,0,7523634,6929951.94667988,0.0,6929951.94667988
782,Laggies,0,0,0,0.0,0.0,0.0
783,The Guest,2367161,5000000,-2632839,2180370.81283522,4605455.25385729,-2425084.4410220706
784,Frontera,0,0,0,0.0,0.0,0.0
785,The Cobbler,0,0,0,0.0,0.0,0.0
786,Blue Ruin,258384,0,258384,237995.190062532,0.0,237995.190062532
787,How to Make Love Like an Englishman,0,0,0,0.0,0.0,0.0
788,The Water Diviner,15520023,22500000,-6979977,14295354.2930672,20724548.6423578,-6429194.3492906
789,The Green Inferno,6833445,5000000,1833445,6294225.03543897,4605455.25385729,1688769.7815816794
790,Magic in the Moonlight,32339326,0,32339326,29787463.7665807,0.0,29787463.7665807
791,Kite,0,0,0,0.0,0.0,0.0
792,"Alexander and the Terrible, Horrible, No Good, Very Bad Day",100654149,28000000,72654149,92711635.866917,25790549.4216008,66921086.445316195
793,This Is Where I Leave You,41296320,19800000,21496320,38037670.7817944,18237602.8052749,19800067.9765195
794,The Homesman,2429989,16000000,-13570011,2238241.12137308,14737456.812343301,-12499215.690970222
795,Son of a Gun,0,0,0,0.0,0.0,0.0
796,Cold in July,427418,0,427418,393690.894738635,0.0,393690.894738635
797,The Double,200406,0,200406,184592.173120905,0.0,184592.173120905
798,The Nut Job,0,0,0,0.0,0.0,0.0
799,Skin Trade,0,9000000,-9000000,0.0,8289819.45694313,-8289819.45694313
800,Open Windows,0,0,0,0.0,0.0,0.0
801,Big Game,7500000,8500000,-1000000,6908182.88078594,7829273.9315574,-921091.0507714599
802,The Bag Man,56574,0,56574,52109.8051063445,0.0,52109.8051063445
803,Jersey Boys,67347013,40000000,27347013,62032730.9704891,36843642.03085829,25189088.939630806
804,About Last Night,49002684,12500000,36502684,45135933.6961818,11513638.134643199,33622295.5615386
805,Million Dollar Arm,38307627,25000000,13307627,35284812.4059911,23027276.269286398,12257536.136704702
806,Wish I Was Here,5483299,5500000,-16701,5050617.63760409,5066000.77924302,-15383.141638929956
807,Infinitely Polar Bear,1430655,6700000,-5269345,1317763.51724144,6171310.04016878,-4853546.52292734
808,Cymbeline,0,0,0,0.0,0.0,0.0
809,Adult Beginners,108808,0,108808,100222.075052341,0.0,100222.075052341
810,Zodiac,0,0,0,0.0,0.0,0.0
811,Before We Go,37151,0,37151,34219.453627210496,0.0,34219.453627210496
812,Under the Skin,5380251,13300000,-7919749,4955701.04700419,12250510.975260401,-7294809.928256211
813,Veronica Mars,3485127,6000000,-2514873,3210119.29050198,5526546.30462875,-2316427.01412677
814,Hector and the Search for Happiness,1124445,0,1124445,1035716.22658471,0.0,1035716.22658471
815,Son of God,67800064,22000000,45800064,62450032.192132205,20264003.1169721,42186029.0751601
816,Fed Up,0,0,0,0.0,0.0,0.0
817,Batman: Assault on Arkham,4571025,0,4571025,4210330.22035261,0.0,4210330.22035261
818,Barefoot,15071,6000000,-5984929,13881.7632261766,5526546.30462875,-5512664.541402574
819,Justice League: War,5155325,3500000,1655325,4748523.72131837,3223818.6777001,1524705.0436182697
820,The Zero Theorem,770706,8500000,-7729294,709890.3993758679,7829273.9315574,-7119383.532181532
821,Housebound,0,0,0,0.0,0.0,0.0
822,A Good Marriage,0,0,0,0.0,0.0,0.0
823,When the Game Stands Tall,30127963,15000000,15127963,27750597.097273603,13816365.761571802,13934231.3357018
824,Turks & Caicos,0,0,0,0.0,0.0,0.0
825,Toy Story That Time Forgot,0,0,0,0.0,0.0,0.0
826,Feast,0,0,0,0.0,0.0,0.0
827,Jackie & Ryan,0,0,0,0.0,0.0,0.0
828,The Riot Club,2146041,0,2146041,1976699.15968863,0.0,1976699.15968863
829,The Scribbler,0,0,0,0.0,0.0,0.0
830,Grace of Monaco,0,30000000,-30000000,0.0,27632731.5231437,-27632731.5231437
831,Decoding Annie Parker,48390,2000000,-1951610,44571.5959468309,1842182.10154291,-1797610.5055960792
832,The Little Death,0,0,0,0.0,0.0,0.0
833,In Your Eyes,0,1000000,-1000000,0.0,921091.050771459,-921091.050771459
834,Bad Ass 2: Bad Asses,0,5500000,-5500000,0.0,5066000.77924302,-5066000.77924302
835,Cuban Fury,0,0,0,0.0,0.0,0.0
836,Dying of the Light,0,15000000,-15000000,0.0,13816365.761571802,-13816365.761571802
837,The Quiet Ones,17834867,200000,17634867,16427536.3853992,184218.210154291,16243318.175244909
838,Tokarev,0,21000000,-21000000,0.0,19342912.066200603,-19342912.066200603
839,A Most Wanted Man,31554855,15000000,16554855,29064894.548890997,13816365.761571802,15248528.787319195
840,Top Five,25434291,0,25434291,23427297.822817,0.0,23427297.822817
841,Get on Up,31911598,0,31911598,29393487.333616402,0.0,29393487.333616402
842,The Pyramid,13865435,6500000,7365435,12771328.093553301,5987091.83001448,6784236.263538821
843,Deliver Us from Evil,0,30000000,-30000000,0.0,27632731.5231437,-27632731.5231437
844,Clouds of Sils Maria,1554000,6600000,-5046000,1431375.49289884,6079200.93509163,-4647825.442192789
845,Kill the Messenger,2450846,5000000,-2549154,2257452.31741902,4605455.25385729,-2348002.9364382704
846,Calvary,13287735,0,13287735,12239213.793522699,0.0,12239213.793522699
847,Time Lapse,0,0,0,0.0,0.0,0.0
848,Sheâ€™s Funny That Way,111996,0,111996,103158.5133222,0.0,103158.5133222
849,What We Do in the Shadows,0,0,0,0.0,0.0,0.0
850,Cut Bank,0,5000000,-5000000,0.0,4605455.25385729,-4605455.25385729
851,Honeymoon,9318,1000000,-990682,8582.726411088459,921091.050771459,-912508.3243603705
852,Starred Up,54915,0,54915,50581.7150531147,0.0,50581.7150531147
853,Space Station 76,0,0,0,0.0,0.0,0.0
854,Locke,4635300,2000000,2635300,4269533.34764094,1842182.10154291,2427351.24609803
855,"20,000 Days on Earth",0,0,0,0.0,0.0,0.0
856,Dolphin Tale 2,52424533,36000000,16424533,48287768.187173,33159277.827772498,15128490.359400503
857,The Longest Week,0,0,0,0.0,0.0,0.0
858,A Certain Justice,0,0,0,0.0,0.0,0.0
859,The Angriest Man in Brooklyn,0,0,0,0.0,0.0,0.0
860,Hellion,0,0,0,0.0,0.0,0.0
861,The Woman in Black 2: Angel of Death,26501323,1000000,25501323,24410131.4489038,921091.050771459,23489040.39813234
862,God's Pocket,169976,0,169976,156563.372445929,0.0,156563.372445929
863,Jessabelle,0,0,0,0.0,0.0,0.0
864,Muppets Most Wanted,80383113,50000000,30383113,74040166.0174509,46054552.5385729,27985613.478878
865,You're Not You,11486,0,11486,10579.6518091609,0.0,10579.6518091609
866,The Drownsman,0,0,0,0.0,0.0,0.0
867,Search Party,0,20000000,-20000000,0.0,18421821.015429102,-18421821.015429102
868,Gun Woman,0,0,0,0.0,0.0,0.0
869,The Taking of Deborah Logan,0,0,0,0.0,0.0,0.0
870,Tusk,1826705,2800000,-973295,1682561.62789947,2579054.94216008,-896493.3142606101
871,"Men, Women & Children",461162,0,461162,424772.191155867,0.0,424772.191155867
872,Shelter,0,0,0,0.0,0.0,0.0
873,Hello Ladies: The Movie,0,0,0,0.0,0.0,0.0
874,Sx_Tape,0,600000,-600000,0.0,552654.630462875,-552654.630462875
875,What We Did on Our Holiday,0,0,0,0.0,0.0,0.0
876,The Anomaly,0,0,0,0.0,0.0,0.0
877,Stretch,0,0,0,0.0,0.0,0.0
878,5 Flights Up,1020921,6000000,-4979079,940361.196644649,5526546.30462875,-4586185.107984101
879,A Haunted House 2,0,0,0,0.0,0.0,0.0
880,Love & Mercy,28641776,0,28641776,26381683.551800698,0.0,26381683.551800698
881,Heaven is for Real,101332962,12000000,89332962,93336884.4463644,11053092.6092575,82283791.8371069
882,Reach Me,0,5000000,-5000000,0.0,4605455.25385729,-4605455.25385729
883,In the Blood,0,10000000,-10000000,0.0,9210910.50771459,-9210910.50771459
884,Lizzie Borden Took An Ax,0,0,0,0.0,0.0,0.0
885,Monsters: Dark Continent,0,0,0,0.0,0.0,0.0
886,Night Moves,0,0,0,0.0,0.0,0.0
887,Paper Planes,0,0,0,0.0,0.0,0.0
888,The Inbetweeners 2,0,0,0,0.0,0.0,0.0
889,Barbie and the Secret Door,0,0,0,0.0,0.0,0.0
890,Time Out of Mind,0,0,0,0.0,0.0,0.0
891,Citizenfour,0,0,0,0.0,0.0,0.0
892,A Little Chaos,0,0,0,0.0,0.0,0.0
893,Bears,0,0,0,0.0,0.0,0.0
894,The Possession of Michael King,0,0,0,0.0,0.0,0.0
895,The Town that Dreaded Sundown,0,0,0,0.0,0.0,0.0
896,The Legend of Hercules,61279452,70000000,-8720548,56443954.8333792,64476373.5540021,-8032418.720622897
897,Maps to the Stars,1338365,0,1338365,1232756.02416574,0.0,1232756.02416574
898,Zombeavers,14947,0,14947,13767.547935881,0.0,13767.547935881
899,13 Sins,0,5000000,-5000000,0.0,4605455.25385729,-4605455.25385729
900,Lemon Tree Passage,0,0,0,0.0,0.0,0.0
901,And So It Goes,25312387,30000000,-4687613,23315013.1393638,27632731.5231437,-4317718.383779902
902,Mr. Turner,5405500,0,5405500,4978957.67494512,0.0,4978957.67494512
903,Bad Johnson,0,0,0,0.0,0.0,0.0
904,Northmen: A Viking Saga,0,0,0,0.0,0.0,0.0
905,Wolves,0,18000000,-18000000,0.0,16579638.9138862,-16579638.9138862
906,Roald Dahl's Esio Trot,0,0,0,0.0,0.0,0.0
907,Burying the Ex,0,0,0,0.0,0.0,0.0
908,Vampire Academy,0,0,0,0.0,0.0,0.0
909,The Disappearance of Eleanor Rigby: Them,985007,0,985007,907281.132647243,0.0,907281.132647243
910,Life After Beth,88273,2400000,-2311727,81307.47032474901,2210618.5218515,-2129311.051526751
911,Out of the Dark,0,0,0,0.0,0.0,0.0
912,Kick,0,0,0,0.0,0.0,0.0
913,Cloud 9,0,0,0,0.0,0.0,0.0
914,Premature,0,0,0,0.0,0.0,0.0
915,The Good Lie,0,0,0,0.0,0.0,0.0
916,Bad Country,0,0,0,0.0,0.0,0.0
917,GirlHouse,0,3150000,-3150000,0.0,2901436.80993009,-2901436.80993009
918,The Mule,0,0,0,0.0,0.0,0.0
919,ABCs of Death 2,7171,0,7171,6605.14392508213,0.0,6605.14392508213
920,Sharknado 2: The Second One,0,0,0,0.0,0.0,0.0
921,Love Is Strange,2262223,0,2262223,2083713.36014936,0.0,2083713.36014936
922,Walking on Sunshine,0,0,0,0.0,0.0,0.0
923,Jinn,149337,0,149337,137552.974249057,0.0,137552.974249057
924,Miss Julie,5000000,5500000,-500000,4605455.25385729,5066000.77924302,-460545.52538572997
925,Flying Home,0,0,0,0.0,0.0,0.0
926,Redirected,0,2700000,-2700000,0.0,2486945.83708294,-2486945.83708294
927,Behaving Badly,0,0,0,0.0,0.0,0.0
928,Wrong Turn 6: Last Resort,0,1200000,-1200000,0.0,1105309.26092575,-1105309.26092575
929,Welcome to Me,0,0,0,0.0,0.0,0.0
930,Alien Outpost,0,0,0,0.0,0.0,0.0
931,Just Before I Go,0,0,0,0.0,0.0,0.0
932,The Disappearance of Eleanor Rigby: Her,0,0,0,0.0,0.0,0.0
933,October Gale,0,0,0,0.0,0.0,0.0
934,Get Santa,0,0,0,0.0,0.0,0.0
935,Freezer,0,0,0,0.0,0.0,0.0
936,Mercenaries,0,0,0,0.0,0.0,0.0
937,Reasonable Doubt,0,8000000,-8000000,0.0,7368728.40617167,-7368728.40617167
938,The Face of an Angel,0,0,0,0.0,0.0,0.0
939,The Single Moms Club,16337881,0,16337881,15048675.977669,0.0,15048675.977669
940,Song One,32251,6000000,-5967749,29706.1074784303,5526546.30462875,-5496840.19715032
941,Rampage: Capital Punishment,0,0,0,0.0,0.0,0.0
942,A Girl Walks Home Alone at Night,395000,1000000,-605000,363830.965054726,921091.050771459,-557260.085716733
943,Before I Disappear,8251,0,8251,7599.922259915309,0.0,7599.922259915309
944,Afflicted,121179,318000,-196821,111616.892441434,292906.954145324,-181290.06170389
945,The Swan Princess: A Royal Family Tale,0,30000000,-30000000,0.0,27632731.5231437,-27632731.5231437
946,Addicted,0,0,0,0.0,0.0,0.0
947,Beyond the Lights,14618727,7000000,7618727,13465178.6133711,6447637.35540021,7017541.25797089
948,About Alex,0,0,0,0.0,0.0,0.0
949,A Royal Christmas,0,0,0,0.0,0.0,0.0
950,A Long Way Down,7176347,0,7176347,6610068.99893061,0.0,6610068.99893061
951,Lost After Dark,0,0,0,0.0,0.0,0.0
952,Pas son genre,0,0,0,0.0,0.0,0.0
953,The Pact II,0,0,0,0.0,0.0,0.0
954,Moms' Night Out,10429707,5000000,5429707,9606709.77986845,4605455.25385729,5001254.52601116
955,Son of Batman,0,0,0,0.0,0.0,0.0
956,Earth to Echo,45300000,13000000,32300000,41725424.5999471,11974183.660028901,29751240.9399182
957,Boulevard,126150,0,126150,116195.636054819,0.0,116195.636054819
958,Falcon Rising,0,0,0,0.0,0.0,0.0
959,The Damned,0,0,0,0.0,0.0,0.0
960,Sleeping Beauty,0,0,0,0.0,0.0,0.0
961,God Help the Girl,0,0,0,0.0,0.0,0.0
962,Wicked Blood,0,3500000,-3500000,0.0,3223818.6777001,-3223818.6777001
963,Avalanche Sharks,0,0,0,0.0,0.0,0.0
964,Young Ones,0,0,0,0.0,0.0,0.0
965,Catch Hell,0,2500000,-2500000,0.0,2302727.62692864,-2302727.62692864
966,Big Driver,0,0,0,0.0,0.0,0.0
967,Jamesy Boy,0,0,0,0.0,0.0,0.0
968,Obvious Child,3123963,0,3123963,2877454.36224116,0.0,2877454.36224116
969,My Little Pony: Equestria Girls - Rainbow Rocks,0,0,0,0.0,0.0,0.0
970,Red Sky,0,25000000,-25000000,0.0,23027276.269286398,-23027276.269286398
971,Stage Fright,0,0,0,0.0,0.0,0.0
972,Sword of Vengeance,0,0,0,0.0,0.0,0.0
973,The Coed and the Zombie Stoner,0,0,0,0.0,0.0,0.0
974,Reclaim,0,0,0,0.0,0.0,0.0
975,Best Night Ever,0,0,0,0.0,0.0,0.0
976,The Gambler,39171130,25000000,14171130,36080177.2916054,23027276.269286398,13052901.022319
977,Tapped Out,0,0,0,0.0,0.0,0.0
978,Halo: Nightfall,0,0,0,0.0,0.0,0.0
979,By the Gun,0,0,0,0.0,0.0,0.0
980,The Humbling,0,2000000,-2000000,0.0,1842182.10154291,-1842182.10154291
981,Plastic,0,10,-10,0.0,9.21091050771459,-9.21091050771459
982,Road to Paloma,0,0,0,0.0,0.0,0.0
983,The Grand Seduction,3430018,12700000,-9269982,3159358.88378502,11697856.344797501,-8538497.46101248
984,"Electric Boogaloo: The Wild, Untold Story of Cannon Films",0,0,0,0.0,0.0,0.0
985,Joe,2365467,4000000,-1634533,2178810.48459521,3684364.20308583,-1505553.7184906201
986,Let's Kill Ward's Wife,0,5000000,-5000000,0.0,4605455.25385729,-4605455.25385729
987,Extraterrestrial,0,0,0,0.0,0.0,0.0
988,Haunt,0,0,0,0.0,0.0,0.0
989,Olive Kitteridge,0,0,0,0.0,0.0,0.0
990,Starry Eyes,0,0,0,0.0,0.0,0.0
991,Cantinflas,0,0,0,0.0,0.0,0.0
992,Manny,0,0,0,0.0,0.0,0.0
993,7500,0,0,0,0.0,0.0,0.0
994,Free Fall,0,1500000,-1500000,0.0,1381636.57615718,-1381636.57615718
995,5 to 7,0,0,0,0.0,0.0,0.0
996,Angry Video Game Nerd: The Movie,0,325927,-325927,0.0,300208.442904789,-300208.442904789
997,Star Wars Rebels: Spark of Rebellion,0,0,0,0.0,0.0,0.0
998,These Final Hours,0,0,0,0.0,0.0,0.0
999,The Pretty One,13769,0,13769,12682.5026780722,0.0,12682.5026780722
1000,Debug,0,0,0,0.0,0.0,0.0
1001,Flowers in the Attic,0,0,0,0.0,0.0,0.0
1002,Outlaw Prophet: Warren Jeffs,0,0,0,0.0,0.0,0.0
1003,The Song,1009620,0,1009620,929951.946679881,0.0,929951.946679881
1004,Parts Per Billion,15000000,500000,14500000,13816365.761571802,460545.525385729,13355820.236186074
1005,The Last Five Years,0,0,0,0.0,0.0,0.0
1006,Better Living Through Chemistry,75143,5000000,-4924857,69213.5448281198,4605455.25385729,-4536241.709029171
1007,Cabin Fever: Patient Zero,0,0,0,0.0,0.0,0.0
1008,Bad Turn Worse,0,0,0,0.0,0.0,0.0
1009,The Disappearance of Eleanor Rigby: Him,0,0,0,0.0,0.0,0.0
1010,Cooties,0,0,0,0.0,0.0,0.0
1011,Hangar 10,0,0,0,0.0,0.0,0.0
1012,Leprechaun: Origins,0,0,0,0.0,0.0,0.0
1013,Someone Marry Barry,0,0,0,0.0,0.0,0.0
1014,Viking: The Berserkers,0,0,0,0.0,0.0,0.0
1015,Kid Cannabis,0,0,0,0.0,0.0,0.0
1016,Swelter,0,0,0,0.0,0.0,0.0
1017,Elsa & Fred,0,10000000,-10000000,0.0,9210910.50771459,-9210910.50771459
1018,The Rewrite,4453524,0,4453524,4102101.10079591,0.0,4102101.10079591
1019,John Doe: Vigilante,0,0,0,0.0,0.0,0.0
1020,Ride,0,0,0,0.0,0.0,0.0
1021,The Dark Horse,0,0,0,0.0,0.0,0.0
1022,Wyrmwood: Road Of The Dead,0,0,0,0.0,0.0,0.0
1023,God's Not Dead,29789000,17000000,12789000,27438381.311431,15658547.8631148,11779833.448316198
1024,Against the Sun,0,0,0,0.0,0.0,0.0
1025,That Sugar Film,0,0,0,0.0,0.0,0.0
1026,Date and Switch,0,0,0,0.0,0.0,0.0
1027,Don't Blink,0,0,0,0.0,0.0,0.0
1028,The Lookalike,0,0,0,0.0,0.0,0.0
1029,"Marvel: 75 Years, From Pulp to Pop!",0,0,0,0.0,0.0,0.0
1030,Sniper: Legacy,0,0,0,0.0,0.0,0.0
1031,Horsehead,0,0,0,0.0,0.0,0.0
1032,Marvel Studios: Assembling a Universe,0,0,0,0.0,0.0,0.0
1033,V/H/S: Viral,2756,0,2756,2538.5269359261397,0.0,2538.5269359261397
1034,Comet,0,0,0,0.0,0.0,0.0
1035,The One I Love,0,0,0,0.0,0.0,0.0
1036,Grace,0,0,0,0.0,0.0,0.0
1037,The Canal,0,0,0,0.0,0.0,0.0
1038,Mall,0,0,0,0.0,0.0,0.0
1039,Blood Punch,0,0,0,0.0,0.0,0.0
1040,The Normal Heart,0,0,0,0.0,0.0,0.0
1041,Faults,0,0,0,0.0,0.0,0.0
1042,Devil's Due,36433975,7000000,29433975,33559008.31653111,6447637.35540021,27111370.961130895
1043,Colt 45,0,0,0,0.0,0.0,0.0
1044,Every Secret Thing,0,0,0,0.0,0.0,0.0
1045,The Keeping Room,0,0,0,0.0,0.0,0.0
1046,Dinosaur Island,0,0,0,0.0,0.0,0.0
1047,Lap Dance,0,0,0,0.0,0.0,0.0
1048,Let Us Prey,0,0,0,0.0,0.0,0.0
1049,Lovesick,0,0,0,0.0,0.0,0.0
1050,Zapped,0,0,0,0.0,0.0,0.0
1051,Revenge of the Green Dragons,0,5000000,-5000000,0.0,4605455.25385729,-4605455.25385729
1052,My Mistress,0,0,0,0.0,0.0,0.0
1053,Kajaki,0,0,0,0.0,0.0,0.0
1054,Unlocking Sherlock,0,0,0,0.0,0.0,0.0
1055,Expelled,0,0,0,0.0,0.0,0.0
1056,Authors Anonymous,0,0,0,0.0,0.0,0.0
1057,Dear White People,0,1000000,-1000000,0.0,921091.050771459,-921091.050771459
1058,Land Ho!,0,0,0,0.0,0.0,0.0
1059,Felony,0,0,0,0.0,0.0,0.0
1060,Appleseed Alpha,0,0,0,0.0,0.0,0.0
1061,Savaged,0,0,0,0.0,0.0,0.0
1062,Effie Gray,0,0,0,0.0,0.0,0.0
1063,Joy Ride 3,0,0,0,0.0,0.0,0.0
1064,Android Cop,0,0,0,0.0,0.0,0.0
1065,Scooby-Doo! WrestleMania Mystery,0,0,0,0.0,0.0,0.0
1066,Charlie's Farm,0,3000000,-3000000,0.0,2763273.15231437,-2763273.15231437
1067,Video Games: The Movie,0,0,0,0.0,0.0,0.0
1068,Exists,0,0,0,0.0,0.0,0.0
1069,My Old Lady,4013786,5000000,-986214,3697062.36431177,4605455.25385729,-908392.8895455203
1070,I Am Ali,7205,0,7205,6636.46102080836,0.0,6636.46102080836
1071,One Square Mile,0,0,0,0.0,0.0,0.0
1072,Age of Tomorrow,0,0,0,0.0,0.0,0.0
1073,Rudderless,0,5000000,-5000000,0.0,4605455.25385729,-4605455.25385729
1074,Copenhagen,0,0,0,0.0,0.0,0.0
1075,Bang Bang,0,0,0,0.0,0.0,0.0
1076,TEKKEN: A Man Called X,0,0,0,0.0,0.0,0.0
1077,Houdini,0,0,0,0.0,0.0,0.0
1078,7 Minutes,0,0,0,0.0,0.0,0.0
1079,De toutes nos forces,0,0,0,0.0,0.0,0.0
1080,Life Itself,0,0,0,0.0,0.0,0.0
1081,Life Partners,8265,0,8265,7612.81753462611,0.0,7612.81753462611
1082,Mercy,0,0,0,0.0,0.0,0.0
1083,Late Phases,0,0,0,0.0,0.0,0.0
1084,10.000 KM,0,0,0,0.0,0.0,0.0
1085,Mockingbird,0,0,0,0.0,0.0,0.0
1086,A Good Man,0,7000000,-7000000,0.0,6447637.35540021,-6447637.35540021
1087,Fort Bliss,0,0,0,0.0,0.0,0.0
1088,Finding Vivian Maier,1503616,0,1503616,1384967.24139677,0.0,1384967.24139677
1089,Where Hope Grows,1156000,0,1156000,1064781.2546918,0.0,1064781.2546918
1090,The Well,0,0,0,0.0,0.0,0.0
1091,Dinosaur 13,0,0,0,0.0,0.0,0.0
1092,"Like Sunday, Like Rain",28208,0,28208,25982.136360161297,0.0,25982.136360161297
1093,Cesar Chavez,0,10000000,-10000000,0.0,9210910.50771459,-9210910.50771459
1094,Little Accidents,0,0,0,0.0,0.0,0.0
1095,Supermensch: The Legend of Shep Gordon,0,0,0,0.0,0.0,0.0
1096,The Internet's Own Boy: The Story of Aaron Swartz,0,0,0,0.0,0.0,0.0
1097,Almost Home,0,0,0,0.0,0.0,0.0
1098,Harmontown,0,0,0,0.0,0.0,0.0
1099,El Inventor de Juegos,0,6000000,-6000000,0.0,5526546.30462875,-5526546.30462875
1100,Petals on the Wind,0,0,0,0.0,0.0,0.0
1101,Iron Man & Captain America: Heroes United,0,0,0,0.0,0.0,0.0
1102,Preservation,0,0,0,0.0,0.0,0.0
1103,My Man is a Loser,0,0,0,0.0,0.0,0.0
1104,Virunga,0,0,0,0.0,0.0,0.0
1105,Interstellar: Nolan's Odyssey,0,0,0,0.0,0.0,0.0
1106,American Muscle,0,0,0,0.0,0.0,0.0
1107,Deep in the Darkness,0,0,0,0.0,0.0,0.0
1108,Jacky au royaume des filles,0,0,0,0.0,0.0,0.0
1109,Alien Abduction,0,0,0,0.0,0.0,0.0
1110,ì‹ ì˜ í•œ ìˆ˜,0,0,0,0.0,0.0,0.0
1111,The Frame,0,0,0,0.0,0.0,0.0
1112,Batman: Strange Days,0,0,0,0.0,0.0,0.0
1113,Boys of Abu Ghraib,0,0,0,0.0,0.0,0.0
1114,Born to Race: Fast Track,0,0,0,0.0,0.0,0.0
1115,The Falling,0,0,0,0.0,0.0,0.0
1116,Poker Night,0,0,0,0.0,0.0,0.0
1117,I Am Santa Claus,0,0,0,0.0,0.0,0.0
1118,Postman Pat: The Movie,0,0,0,0.0,0.0,0.0
1119,Creep,0,0,0,0.0,0.0,0.0
1120,The Identical,0,12000000,-12000000,0.0,11053092.6092575,-11053092.6092575
1121,Miss Meadows,0,2000000,-2000000,0.0,1842182.10154291,-1842182.10154291
1122,Supremacy,0,0,0,0.0,0.0,0.0
1123,The Look of Silence,153516,0,153516,141402.213750231,0.0,141402.213750231
1124,The Outsider,0,4000000,-4000000,0.0,3684364.20308583,-3684364.20308583
1125,Iris,0,0,0,0.0,0.0,0.0
1126,Squatters,0,0,0,0.0,0.0,0.0
1127,The Redwood Massacre,0,156660,-156660,0.0,144298.124013856,-144298.124013856
1128,Bird People,0,0,0,0.0,0.0,0.0
1129,Ribbit,0,0,0,0.0,0.0,0.0
1130,How to Build a Better Boy,0,0,0,0.0,0.0,0.0
1131,Aloft,53086,8000000,-7946914,48897.039521253704,7368728.40617167,-7319831.3666504165
1132,Jarhead 2: Field of Fire,0,0,0,0.0,0.0,0.0
1133,Survivor,0,0,0,0.0,0.0,0.0
1134,Seal Team Eight: Behind Enemy Lines,0,0,0,0.0,0.0,0.0
1135,Ask Me Anything,0,950000,-950000,0.0,875036.498232886,-875036.498232886
1136,Suburban Gothic,0,0,0,0.0,0.0,0.0
1137,Welcome to New York,0,0,0,0.0,0.0,0.0
1138,An Honest Liar,0,0,0,0.0,0.0,0.0
1139,Heavenly Sword,0,6000000,-6000000,0.0,5526546.30462875,-5526546.30462875
1140,JLA Adventures: Trapped in Time,0,0,0,0.0,0.0,0.0
1141,Enchanted Kingdom,0,18,-18,0.0,16.5796389138862,-16.5796389138862
1142,Kristy,0,6900000,-6900000,0.0,6355528.25032307,-6355528.25032307
1143,I Am Soldier,0,0,0,0.0,0.0,0.0
1144,Desert Dancer,0,0,0,0.0,0.0,0.0
1145,See No Evil 2,0,0,0,0.0,0.0,0.0
1146,Queen and Country,0,0,0,0.0,0.0,0.0
1147,Goodbye to All That,0,0,0,0.0,0.0,0.0
1148,Northern Soul,0,0,0,0.0,0.0,0.0
1149,Doctor Who: Last Christmas,0,0,0,0.0,0.0,0.0
1150,Lilting,0,0,0,0.0,0.0,0.0
1151,Fear Clinic,0,1,-1,0.0,0.921091050771459,-0.921091050771459
1152,School Dance,0,0,0,0.0,0.0,0.0
1153,Valley Uprising,0,0,0,0.0,0.0,0.0
1154,9 Kisses,0,0,0,0.0,0.0,0.0
1155,In My Dreams,0,0,0,0.0,0.0,0.0
1156,Julia,2710,0,2710,2496.15674759065,0.0,2496.15674759065
1157,Perfect Sisters,0,0,0,0.0,0.0,0.0
1158,Ironclad 2: Battle for Blood,0,0,0,0.0,0.0,0.0
1159,Jackass Presents: Bad Grandpa .5,0,0,0,0.0,0.0,0.0
1160,Dark Was the Night,0,0,0,0.0,0.0,0.0
1161,Asthma,0,0,0,0.0,0.0,0.0
1162,Saint Laurent,0,0,0,0.0,0.0,0.0
1163,Street Fighter: Assassin's Fist,0,0,0,0.0,0.0,0.0
1164,Jamie Marks Is Dead,0,0,0,0.0,0.0,0.0
1165,The Device,0,0,0,0.0,0.0,0.0
1166,WolfCop,0,0,0,0.0,0.0,0.0
1167,At the Devil's Door,0,0,0,0.0,0.0,0.0
1168,Roger Waters: The Wall,0,0,0,0.0,0.0,0.0
1169,Kelly & Cal,0,0,0,0.0,0.0,0.0
1170,Cat Run 2,0,0,0,0.0,0.0,0.0
1171,The Remaining,1169603,0,1169603,1077310.85625545,0.0,1077310.85625545
1172,Apocalypse Pompeii,0,0,0,0.0,0.0,0.0
1173,The Search for General Tso,0,0,0,0.0,0.0,0.0
1174,Take Care,0,0,0,0.0,0.0,0.0
1175,Low Down,0,0,0,0.0,0.0,0.0
1176,The Prophet,0,0,0,0.0,0.0,0.0
1177,JohnnyExpress,0,0,0,0.0,0.0,0.0
1178,Sharktopus vs Pteracuda,0,0,0,0.0,0.0,0.0
1179,Mrs. Brown's Boys D'Movie,23000000,5900000,17100000,21185094.1677435,5434437.19955161,15750656.96819189
1180,Listen Up Philip,0,0,0,0.0,0.0,0.0
1181,Iverson,0,0,0,0.0,0.0,0.0
1182,The Road Within,0,0,0,0.0,0.0,0.0
1183,Ascension,0,0,0,0.0,0.0,0.0
1184,Dans la cour,0,0,0,0.0,0.0,0.0
1185,Crawl or Die,0,0,0,0.0,0.0,0.0
1186,Red Army,0,0,0,0.0,0.0,0.0
1187,Whitey: United States of America v. James J. Bulger,0,0,0,0.0,0.0,0.0
1188,The Living,0,500000,-500000,0.0,460545.525385729,-460545.525385729
1189,Rosewater,0,0,0,0.0,0.0,0.0
1190,Last Days in Vietnam,0,0,0,0.0,0.0,0.0
1191,ç­‰ä¸€å€‹äººå’–å•¡,0,0,0,0.0,0.0,0.0
1192,Two Men in Town,0,0,0,0.0,0.0,0.0
1193,Hyena,0,0,0,0.0,0.0,0.0
1194,Finders Keepers,0,0,0,0.0,0.0,0.0
1195,Trailer Park Boys: Don't Legalize It,0,0,0,0.0,0.0,0.0
1196,Elephant Song,0,0,0,0.0,0.0,0.0
1197,Teen Lust,0,0,0,0.0,0.0,0.0
1198,The Little Rascals Save the Day,0,8000000,-8000000,0.0,7368728.40617167,-7368728.40617167
1199,Nowhere Safe,0,0,0,0.0,0.0,0.0
1200,Black Mirror: White Christmas,0,0,0,0.0,0.0,0.0
1201,Animal,0,0,0,0.0,0.0,0.0
1202,We'll Never Have Paris,0,0,0,0.0,0.0,0.0
1203,Free to Play,0,150000,-150000,0.0,138163.657615718,-138163.657615718
1204,They Came Together,0,0,0,0.0,0.0,0.0
1205,Jersey Shore Massacre,0,1400000,-1400000,0.0,1289527.47108004,-1289527.47108004
1206,The Story of Frozen: Making a Disney Animated Classic,0,0,0,0.0,0.0,0.0
1207,Inner Demons,0,0,0,0.0,0.0,0.0
1208,Cowspiracy: The Sustainability Secret,0,117,-117,0.0,107.76765294025999,-107.76765294025999
1209,Killer Legends,0,0,0,0.0,0.0,0.0
1210,Amira & Sam,0,0,0,0.0,0.0,0.0
1211,Midnight Sun,0,18000000,-18000000,0.0,16579638.9138862,-16579638.9138862
1212,Grumpy Cat's Worst Christmas Ever,0,0,0,0.0,0.0,0.0
1213,The Hornet's Nest,0,0,0,0.0,0.0,0.0
1214,Viharsarok,0,0,0,0.0,0.0,0.0
1215,The Mummy Resurrected,0,0,0,0.0,0.0,0.0
1216,The Wedding Pact,0,0,0,0.0,0.0,0.0
1217,Over the Garden Wall,0,0,0,0.0,0.0,0.0
1218,Alive Inside,0,0,0,0.0,0.0,0.0
1219,Gunday,0,0,0,0.0,0.0,0.0
1220,The Cut,0,16000000,-16000000,0.0,14737456.812343301,-14737456.812343301
1221,Rosemary's Baby,0,0,0,0.0,0.0,0.0
1222,Happy Christmas,0,0,0,0.0,0.0,0.0
1223,The 7:39,0,0,0,0.0,0.0,0.0
1224,The Perfect Wave,0,0,0,0.0,0.0,0.0
1225,Billy Elliot: The Musical,0,0,0,0.0,0.0,0.0
1226,Delirium,0,0,0,0.0,0.0,0.0
1227,Sex Ed,0,0,0,0.0,0.0,0.0
1228,The Houses October Built,0,0,0,0.0,0.0,0.0
1229,Lullaby,0,0,0,0.0,0.0,0.0
1230,Marvellous,0,0,0,0.0,0.0,0.0
1231,Hercules Reborn,0,0,0,0.0,0.0,0.0
1232,Road,0,0,0,0.0,0.0,0.0
1233,Party Central,0,0,0,0.0,0.0,0.0
1234,Mostly Ghostly: Have You Met My Ghoulfriend?,0,0,0,0.0,0.0,0.0
1235,Klondike,0,0,0,0.0,0.0,0.0
1236,No No: A Dockumentary,0,0,0,0.0,0.0,0.0
1237,Way of the Wicked,0,3000000,-3000000,0.0,2763273.15231437,-2763273.15231437
1238,Lust for Love,0,0,0,0.0,0.0,0.0
1239,Where the Devil Hides,0,7000000,-7000000,0.0,6447637.35540021,-6447637.35540021
1240,Believe Me,0,0,0,0.0,0.0,0.0
1241,Dance-Off,0,0,0,0.0,0.0,0.0
1242,Jim Jefferies: BARE,0,0,0,0.0,0.0,0.0
1243,Bill Burr: I'm Sorry You Feel That Way,0,0,0,0.0,0.0,0.0
1244,The Guvnors,0,0,0,0.0,0.0,0.0
1245,Nick Offerman: American Ham,0,0,0,0.0,0.0,0.0
1246,Tell,0,0,0,0.0,0.0,0.0
1247,Night Will Fall,0,0,0,0.0,0.0,0.0
1248,The Battered Bastards of Baseball,0,0,0,0.0,0.0,0.0
1249,Jailbait,0,0,0,0.0,0.0,0.0
1250,The Rise and Rise of Bitcoin,0,0,0,0.0,0.0,0.0
1251,Breakup Buddies,0,0,0,0.0,0.0,0.0
1252,CÃ¡sese quien pueda,0,0,0,0.0,0.0,0.0
1253,Death Clique,0,2000000,-2000000,0.0,1842182.10154291,-1842182.10154291
1254,Hits,0,1000000,-1000000,0.0,921091.050771459,-921091.050771459
1255,All Relative,0,0,0,0.0,0.0,0.0
1256,Banksy Does New York,0,0,0,0.0,0.0,0.0
1257,Not Cool,0,0,0,0.0,0.0,0.0
1258,Merchants of Doubt,192400,0,192400,177217.918168428,0.0,177217.918168428
1259,96 heures,0,0,0,0.0,0.0,0.0
1260,Camp Takota,0,0,0,0.0,0.0,0.0
1261,Swedish House Mafia - Leave the World Behind,0,750000,-750000,0.0,690818.288078594,-690818.288078594
1262,Montana,0,0,0,0.0,0.0,0.0
1263,Atari: Game Over,0,0,0,0.0,0.0,0.0
1264,Indigenous,0,0,0,0.0,0.0,0.0
1265,Mardaani,0,0,0,0.0,0.0,0.0
1266,Amour Sur Place ou Ã  Emporter,0,0,0,0.0,0.0,0.0
1267,Wanderers,0,0,0,0.0,0.0,0.0
1268,Eden,65460,0,65460,60294.6201834997,0.0,60294.6201834997
1269,Something Wicked,0,3000000,-3000000,0.0,2763273.15231437,-2763273.15231437
1270,Old Fashioned,0,0,0,0.0,0.0,0.0
1271,The Fluffy Movie,0,0,0,0.0,0.0,0.0
1272,Khoobsurat,0,0,0,0.0,0.0,0.0
1273,Showrunners: The Art of Running a TV Show,0,0,0,0.0,0.0,0.0
1274,Saints and Soldiers: The Void,0,0,0,0.0,0.0,0.0
1275,Not Safe for Work,0,0,0,0.0,0.0,0.0
1276,The Gunfighter,0,0,0,0.0,0.0,0.0
1277,Heaven Adores You,0,0,0,0.0,0.0,0.0
1278,Korengal,0,0,0,0.0,0.0,0.0
1279,America: Imagine the World Without Her,0,0,0,0.0,0.0,0.0
1280,23 Blast,0,0,0,0.0,0.0,0.0
1281,All This Mayhem,0,0,0,0.0,0.0,0.0
1282,Plague,0,200000,-200000,0.0,184218.210154291,-184218.210154291
1283,Vie Sauvage,0,0,0,0.0,0.0,0.0
1284,Jim Gaffigan: Obsessed,0,0,0,0.0,0.0,0.0
1285,Chelsea Handler Uganda Be Kidding Me Live,0,0,0,0.0,0.0,0.0
1286,To Be Takei,0,0,0,0.0,0.0,0.0
1287,Nas: Time Is Illmatic,0,0,0,0.0,0.0,0.0
1288,Top Gear: The Perfect Road Trip 2,0,0,0,0.0,0.0,0.0
1289,Treehouse,0,3250000,-3250000,0.0,2993545.91500724,-2993545.91500724
1290,Come Back to Me,0,0,0,0.0,0.0,0.0
1291,The 10 Year Plan,0,0,0,0.0,0.0,0.0
1292,Ardennes Fury,0,0,0,0.0,0.0,0.0
1293,Tim Maia,0,0,0,0.0,0.0,0.0
1294,Tracks,4878242,0,4878242,4493305.04969746,0.0,4493305.04969746
1295,Point and Shoot,0,0,0,0.0,0.0,0.0
1296,Maidentrip,0,0,0,0.0,0.0,0.0
1297,Ballet 422,0,0,0,0.0,0.0,0.0
1298,Chelsea Peretti: One of the Greats,0,0,0,0.0,0.0,0.0
1299,The After,0,0,0,0.0,0.0,0.0
1300,The Trip to Italy,0,0,0,0.0,0.0,0.0
1301,The Dead Lands,5240,0,5240,4826.51710604244,0.0,4826.51710604244
1302,Mary Kom,0,0,0,0.0,0.0,0.0
1303,The Green Prince,0,0,0,0.0,0.0,0.0
1304,Ambition,0,0,0,0.0,0.0,0.0
1305,Corner Gas: The Movie,0,8500000,-8500000,0.0,7829273.9315574,-7829273.9315574
1306,The Overnighters,0,0,0,0.0,0.0,0.0
1307,Altar,0,0,0,0.0,0.0,0.0
1308,Happy Ending,0,0,0,0.0,0.0,0.0
1309,"Fat, Sick & Nearly Dead 2",0,0,0,0.0,0.0,0.0
1310,Nowitzki: The Perfect Shot,0,0,0,0.0,0.0,0.0
1311,Mitt,0,0,0,0.0,0.0,0.0
1312,Berkshire County,0,0,0,0.0,0.0,0.0
1313,Des Lendemains Qui Chantent,0,5,-5,0.0,4.60545525385729,-4.60545525385729
1314,Main Tera Hero,0,0,0,0.0,0.0,0.0
1315,Happy Valley,0,0,0,0.0,0.0,0.0
1316,Kids for Cash,0,0,0,0.0,0.0,0.0
1317,Lost Soul: The Doomed Journey of Richard Stanley's Island of Dr. Moreau,0,0,0,0.0,0.0,0.0
1318,Kill Dil,0,0,0,0.0,0.0,0.0
1319,Love Me,0,0,0,0.0,0.0,0.0
1320,We Still Kill the Old Way,0,0,0,0.0,0.0,0.0
1321,Finding Fanny,0,2489400,-2489400,0.0,2292964.06179047,-2292964.06179047
1322,One Direction: Where We Are - The Concert,0,0,0,0.0,0.0,0.0
1323,Stop at Nothing: The Lance Armstrong Story,0,0,0,0.0,0.0,0.0
1324,Humpty Sharma Ki Dulhania,0,0,0,0.0,0.0,0.0
1325,Anatomy of a Love Seen,0,0,0,0.0,0.0,0.0
1326,Rich Hill,0,0,0,0.0,0.0,0.0
1327,Pantani: The Accidental Death of a Cyclist,0,0,0,0.0,0.0,0.0
1328,Do I Sound Gay?,0,0,0,0.0,0.0,0.0
1329,Star Wars,775398007,11000000,764398007,2789712242.27745,39575591.3582738,2750136650.919176
1330,The Spy Who Loved Me,185438673,14000000,171438673,667167740.424415,50368934.4559849,616798805.96843
1331,The Rescuers,71215869,1200000,70015869,256219102.706214,4317337.23908442,251901765.4671296
1332,Annie Hall,38251425,4000000,34251425,137620251.33378702,14391124.1302814,123229127.20350562
1333,Pete's Dragon,0,10000000,-10000000,0.0,35977810.325703494,-35977810.325703494
1334,Close Encounters of the Third Kind,303788635,20000000,283788635,1092964988.91343,71955620.65140699,1021009368.262023
1335,A Bridge Too Far,50750000,22000000,28750000,182587387.40294498,79151182.7165477,103436204.68639728
1336,The Many Adventures of Winnie the Pooh,0,0,0,0.0,0.0,0.0
1337,Herbie Goes To Monte Carlo,0,0,0,0.0,0.0,0.0
1338,Sinbad and the Eye of the Tiger,16000000,3500000,12500000,57564496.5211256,12592233.613996198,44972262.9071294
1339,March or Die,0,0,0,0.0,0.0,0.0
1340,Saturday Night Fever,237113184,3500000,233613184,853081315.967563,12592233.613996198,840489082.3535669
1341,High Anxiety,31063038,3400000,27663038,111758008.93041201,12232455.5107391,99525553.4196729
1342,Smokey and the Bandit,126737428,0,126737428,455973514.57515,0.0,455973514.57515
1343,Pumping Iron,0,0,0,0.0,0.0,0.0
1344,The Gauntlet,26414658,5500000,20914658,95034155.5342327,19787795.6791369,75246359.8550958
1345,Cross of Iron,0,6000000,-6000000,0.0,21586686.1954221,-21586686.1954221
1346,"New York, New York",0,0,0,0.0,0.0,0.0
1347,Slap Shot,28000000,0,28000000,100737868.91196899,0.0,100737868.91196899
1348,The Duellists,0,900000,-900000,0.0,3238002.92931331,-3238002.92931331
1349,Julia,0,0,0,0.0,0.0,0.0
1350,Audrey Rose,0,0,0,0.0,0.0,0.0
1351,Exorcist II: The Heretic,30749142,14000000,16749142,110628679.855412,50368934.4559849,60259745.39942711
1352,Airport '77,30000000,6000000,24000000,107933430.97711,21586686.1954221,86346744.7816879
1353,Jabberwocky,0,0,0,0.0,0.0,0.0
1354,Eraserhead,7000000,10000,6990000,25184467.227992397,35977.8103257035,25148489.417666692
1355,Rolling Thunder,0,0,0,0.0,0.0,0.0
1356,The Message,0,0,0,0.0,0.0,0.0
1357,The Hobbit,0,3000000,-3000000,0.0,10793343.097711,-10793343.097711
1358,The Man in the Iron Mask,0,0,0,0.0,0.0,0.0
1359,Black Sunday,0,0,0,0.0,0.0,0.0
1360,Candleshoe,0,0,0,0.0,0.0,0.0
1361,The Serpent's Egg,0,0,0,0.0,0.0,0.0
1362,The White Buffalo,0,0,0,0.0,0.0,0.0
1363,Orca: The Killer Whale,14717854,6000000,8717854,52951615.9613396,21586686.1954221,31364929.7659175
1364,Sorcerer,12000000,22000000,-10000000,43173372.3908442,79151182.7165477,-35977810.325703494
1365,The Last Wave,1258000,810000,448000,4526008.5389735,2914202.63638198,1611805.90259152
1366,"Oh, God!",41687243,0,41687243,149981572.165551,0.0,149981572.165551
1367,3 Women,0,1500000,-1500000,0.0,5396671.54885552,-5396671.54885552
1368,Kingdom of the Spiders,17000000,500000,16500000,61162277.553695895,1798890.51628517,59363387.03741072
1369,The Car,0,0,0,0.0,0.0,0.0
1370,Wizards,9000000,1200000,7800000,32380029.2931331,4317337.23908442,28062692.05404868
1371,Rollercoaster,0,0,0,0.0,0.0,0.0
1372,The Hills Have Eyes,25000000,230000,24770000,89944525.8142588,827489.63749118,89117036.17676762
1373,Demon Seed,0,0,0,0.0,0.0,0.0
1374,The Kentucky Fried Movie,0,600000,-600000,0.0,2158668.61954221,-2158668.61954221
1375,The Island of Dr. Moreau,0,0,0,0.0,0.0,0.0
1376,Martin,0,0,0,0.0,0.0,0.0
1377,The Deep,0,0,0,0.0,0.0,0.0
1378,Empire of the Ants,0,0,0,0.0,0.0,0.0
1379,Day of the Animals,0,0,0,0.0,0.0,0.0
1380,The Sentinel,3,0,3,10.793343097711,0.0,10.793343097711
1381,The Goodbye Girl,102000000,0,102000000,366973665.322175,0.0,366973665.322175
1382,Opening Night,0,0,0,0.0,0.0,0.0
1383,Rabid,0,530000,-530000,0.0,1906823.94726228,-1906823.94726228
1384,Shock Waves,0,200000,-200000,0.0,719556.20651407,-719556.20651407
1385,Emmet Otter's Jug-Band Christmas,0,0,0,0.0,0.0,0.0
1386,Avatar,2781505847,237000000,2544505847,2827123750.41189,240886902.887613,2586236847.524277
1387,Inglourious Basterds,319131050,70000000,249131050,324364937.762752,71148030.38874671,253216907.3740053
1388,Underworld: Rise of the Lycans,91327197,35000000,56327197,92825002.67821509,35574015.194373295,57250987.48384179
1389,Harry Potter and the Half-Blood Prince,933959197,250000000,683959197,949276533.285793,254100108.531238,695176424.754555
1390,Up,731342744,175000000,556342744,743337082.495734,177870075.97186598,565467006.523868
1391,Star Trek,385680446,150000000,235680446,392005772.74790496,152460065.118743,239545707.62916195
1392,Terminator Salvation,371353001,200000000,171353001,377443351.430004,203280086.82499,174163264.605014
1393,District 9,210819611,30000000,180819611,214277144.142453,30492013.023748603,183785131.1187044
1394,Sherlock Holmes,524028679,90000000,434028679,532622976.829525,91476039.0712458,441146937.7582792
1395,(500) Days of Summer,60722734,7500000,53222734,61718613.19885401,7623003.25593715,54095609.942916855
1396,Ice Age: Dawn of the Dinosaurs,886686817,90000000,796686817,901228865.731673,91476039.0712458,809752826.6604272
1397,The Hangover,459270619,35000000,424270619,466802856.532436,35574015.194373295,431228841.3380627
1398,Watchmen,185258983,130000000,55258983,188297310.746747,132132056.436243,56165254.31050399
1399,2012,769653595,200000000,569653595,782276248.083831,203280086.82499,578996161.2588409
1400,9,48428063,30000000,18428063,49222304.257030606,30492013.023748603,18730291.233282004
1401,Angels & Demons,356613439,150000000,206613439,362462054.214392,152460065.118743,210001989.095649
1402,The Princess and the Frog,267045765,105000000,162045765,271425431.47722995,106722045.58311999,164703385.89410996
1403,The Blind Side,309208309,29000000,280208309,314279459.502642,29475612.589623604,284803846.91301835
1404,Zombieland,102391382,23600000,78791382,104070645.115453,23987050.245348897,80083594.8701041
1405,The Twilight Saga: New Moon,709827462,50000000,659827462,721468940.530613,50820021.7062476,670648918.8243654
1406,He's Just Not That Into You,177259441,40000000,137259441,180166572.785146,40656017.3649981,139510555.4201479
1407,G.I. Joe: The Rise of Cobra,302469017,175000000,127469017,307429640.188147,177870075.97186598,129559564.21628103
1408,The Proposal,317375031,40000000,277375031,322580119.28882,40656017.3649981,281924101.9238219
1409,The Pink Panther 2,75871032,0,75871032,77115349.8623082,0.0,77115349.8623082
1410,The Ugly Truth,205298907,38000000,167298907,208665898.200178,38623216.49674821,170042681.7034298
1411,Cloudy with a Chance of Meatballs,242988466,100000000,142988466,246973582.329756,101640043.412495,145333538.917261
1412,Fantastic Mr. Fox,46471023,40000000,6471023,47233167.9514307,40656017.3649981,6577150.5864325985
1413,Coraline,124596398,60000000,64596398,126639833.017605,60984026.047497205,65655806.9701078
1414,Night at the Museum: Battle of the Smithsonian,413106170,150000000,263106170,419881290.527696,152460065.118743,267421225.408953
1415,17 Again,136267476,20000000,116267476,138502321.763511,20328008.682499,118174313.08101201
1416,A Christmas Carol,325233863,200000000,125233863,330567839.545335,203280086.82499,127287752.72034499
1417,The Rebound,0,0,0,0.0,0.0,0.0
1418,The Lovely Bones,93525586,65000000,28525586,95059446.21219058,66066028.2181219,28993417.994068682
1419,Paul Blart: Mall Cop,183293131,26000000,157293131,186299217.920521,26426411.2872487,159872806.6332723
1420,Hachi: A Dog's Tale,47801389,16000000,31801389,48585352.5313757,16262406.9459992,32322945.5853765
1421,Law Abiding Citizen,126690726,53000000,73690726,128768508.90600501,53869223.0086225,74899285.89738251
1422,The Box,33333531,30000000,3333531,33880215.379317604,30492013.023748603,3388202.3555690013
1423,Crank: High Voltage,34560577,20000000,14560577,35127385.466408804,20328008.682499,14799376.783909805
1424,Pandorum,20645327,33000000,-12354673,20983919.3254516,33541214.3261234,-12557295.0006718
1425,Tinker Bell and the Lost Treasure,0,0,0,0.0,0.0,0.0
1426,Drag Me to Hell,90842646,30000000,60842646,92332504.83145942,30492013.023748603,61840491.80771081
1427,Splice,0,26000000,-26000000,0.0,26426411.2872487,-26426411.2872487
1428,Knowing,155446362,50000000,105446362,157995749.819944,50820021.7062476,107175728.1136964
1429,Moon,9760104,5000000,4760104,9920173.94270469,5082002.17062476,4838171.772079931
1430,G-Force,292817841,150000000,142817841,297620180.711931,152460065.118743,145160115.593188
1431,Van Wilder: Freshman Year,0,0,0,0.0,0.0,0.0
1432,The Taking of Pelham 1 2 3,150166126,100000000,50166126,152628915.657262,101640043.412495,50988872.244766995
1433,The Invention of Lying,31912793,18500000,13412793,32436176.659339696,18803408.0313116,13632768.628028095
1434,Confessions of a Shopaholic,108332743,40000000,68332743,110109447.015147,40656017.3649981,69453429.6501489
1435,Ghosts of Girlfriends Past,102223269,0,102223269,103899774.989271,0.0,103899774.989271
1436,Gamer,40828540,50000000,-9171460,41498145.780688,50820021.7062476,-9321875.925559595
1437,Anaconda 4: Trail of Blood,0,0,0,0.0,0.0,0.0
1438,Mr. Nobody,3547209,47000000,-43452791,3605384.76753194,47770820.403872795,-44165435.63634086
1439,Couples Retreat,171844840,70000000,101844840,174663169.978133,71148030.38874671,103515139.58938628
1440,Brothers,43318349,26000000,17318349,44028788.7291762,26426411.2872487,17602377.4419275
1441,The Road,27635305,32000000,-4364695,28088535.999175396,32524813.8919985,-4436277.892823104
1442,Monsters vs Aliens,381509870,175000000,206509870,387766797.490954,177870075.97186598,209896721.519088
1443,Fish Tank,2357852,3000000,-642148,2396521.79640238,3049201.30237486,-652679.5059724799
1444,Julie & Julia,129540499,40000000,89540499,131665019.420363,40656017.3649981,91009002.05536489
1445,Chloe,8459458,15000000,-6540542,8598196.78366181,15246006.511874301,-6647809.728212491
1446,Public Enemies,214104620,80000000,134104620,217616028.716158,81312034.7299962,136303993.9861618
1447,Merry Madagascar,0,0,0,0.0,0.0,0.0
1448,Jennifer's Body,31556061,16000000,15556061,32073594.0996735,16262406.9459992,15811187.153674299
1449,Orphan,41596251,20000000,21596251,42278447.5743705,20328008.682499,21950438.891871504
1450,All About Steve,40105542,15000000,25105542,40763290.2996165,15246006.511874301,25517283.787742198
1451,The Final Destination,186167139,40000000,146167139,189220360.8994,40656017.3649981,148564343.5344019
1452,Alvin and the Chipmunks: The Squeakquel,443140005,75000000,368140005,450407693.46013397,76230032.5593715,374177660.90076244
1453,After.Life,3606395,4500000,-893605,3665541.44362606,4573801.95356229,-908260.5099362303
1454,Bride Wars,114663461,30000000,84663461,116543991.53866899,30492013.023748603,86051978.51492038
1455,Precious,63647833,10000000,53647833,64691685.0923125,10164004.3412495,54527680.751063004
1456,State of Play,87784194,60000000,27784194,89223892.89090909,60984026.047497205,28239866.843411885
1457,The Unborn,76514050,16000000,60514050,77768913.63665842,16262406.9459992,61506506.69065922
1458,"New York, I Love You",8049666,14700000,-6650334,8181684.01696087,14941086.3816368,-6759402.364675931
1459,"I Love You, Man",91636986,41000000,50636986,93139872.3523022,41672417.799123,51467454.5531792
1460,The Informant!,35424826,22000000,13424826,36005808.525200896,22360809.5507489,13644998.974451996
1461,Race to Witch Mountain,106303988,50000000,56303988,108047419.552413,50820021.7062476,57227397.8461654
1462,Case 39,29000000,27000000,2000000,29475612.589623604,27442811.7213737,2032800.8682499044
1463,The Boat That Rocked,36348784,50000000,-13651216,36944919.8375141,50820021.7062476,-13875101.868733495
1464,Wrong Turn 3: Left for Dead,0,0,0,0.0,0.0,0.0
1465,Daybreakers,51416464,20000000,31416464,52259716.33077,20328008.682499,31931707.648271002
1466,The Time Traveler's Wife,101229792,39000000,62229792,102890004.535178,39639616.9308731,63250387.6043049
1467,Fanboys,948753,0,948753,964312.9610773509,0.0,964312.9610773509
1468,Antichrist,791867,11000000,-10208133,804853.9625692241,11180404.7753744,-10375550.812805176
1469,From Time to Time,0,0,0,0.0,0.0,0.0
1470,Love Happens,36133014,18000000,18133014,36725611.115843,18295207.814249102,18430403.301593896
1471,Push,45465299,38000000,7465299,46210949.64122079,38623216.49674821,7587733.144472584
1472,Brooklyn's Finest,29536299,17000000,12536299,30020707.126044396,17278807.3801242,12741899.745920196
1473,Saw VI,68233629,11000000,57233629,69352690.137521,11180404.7753744,58172285.3621466
1474,The Young Victoria,27409889,35000000,-7590111,27859423.0789167,35574015.194373295,-7714592.115456596
1475,A Serious Man,31430334,7000000,24430334,31945805.1222922,7114803.03887467,24831002.083417527
1476,A Perfect Getaway,22852638,14000000,8852638,23227431.1841004,14229606.0777493,8997825.1063511
1477,Spread,12032983,0,12032983,12230329.1450181,0.0,12230329.1450181
1478,Whiteout,12206028,40000000,-27793972,12406212.1581413,40656017.3649981,-28249805.206856802
1479,The Uninvited,41624046,0,41624046,42306698.424437,0.0,42306698.424437
1480,Powder Blue,0,0,0,0.0,0.0,0.0
1481,I Love You Phillip Morris,10652035,13000000,-2347965,10826732.9983141,13213205.643624302,-2386472.6453102026
1482,Enter the Void,754249,13000000,-12245751,766619.011038312,13213205.643624302,-12446586.63258599
1483,A Single Man,0,7000000,-7000000,0.0,7114803.03887467,-7114803.03887467
1484,12 Rounds,17280326,20000000,-2719674,17563730.8482207,20328008.682499,-2764277.8342783004
1485,Green Street Hooligans 2,0,8000000,-8000000,0.0,8131203.47299962,-8131203.47299962
1486,3 Idiots,70000000,9000000,61000000,71148030.38874671,9147603.90712458,62000426.48162213
1487,Transformers: Revenge of the Fallen,836297228,150000000,686297228,850012865.5966951,152460065.118743,697552800.477952
1488,The Men Who Stare at Goats,68729358,24000000,44729358,69856549.3083293,24393610.4189988,45462938.8893305
1489,Whatever Works,0,15000000,-15000000,0.0,15246006.511874301,-15246006.511874301
1490,Ninja Assassin,60462347,40000000,20462347,61453955.7390135,40656017.3649981,20797938.3740154
1491,Bandslam,5210988,20000000,-14789012,5296450.46541992,20328008.682499,-15031558.217079079
1492,Where the Wild Things Are,100086793,100000000,86793,101728259.855374,101640043.412495,88216.44287899137
1493,It's Complicated,219103655,85000000,134103655,222697050.060364,86394036.900621,136303013.159743
1494,Elsewhere,0,500000,-500000,0.0,508200.21706247603,-508200.21706247603
1495,The Butterfly Effect 3: Revelations,0,0,0,0.0,0.0,0.0
1496,"I Love You, Beth Cooper",0,18000000,-18000000,0.0,18295207.814249102,-18295207.814249102
1497,Youth in Revolt,0,18000000,-18000000,0.0,18295207.814249102,-18295207.814249102
1498,Land of the Lost,68688831,100000000,-31311169,69815357.6479355,101640043.412495,-31824685.764559507
1499,Invictus,122233971,60000000,62233971,124238661.18921599,60984026.047497205,63254635.14171878
1500,Planet 51,104945765,70000000,34945765,106666921.105575,71148030.38874671,35518890.71682829
1501,Dorian Gray,4706919,0,4706919,4784114.51499099,0.0,4784114.51499099
1502,The Haunting in Connecticut,77527732,0,77527732,78799220.461523,0.0,78799220.461523
1503,American Pie Presents: The Book of Love,0,0,0,0.0,0.0,0.0
1504,Green Lantern: First Flight,0,3500000,-3500000,0.0,3557401.51943733,-3557401.51943733
1505,The Tournament,0,8000000,-8000000,0.0,8131203.47299962,-8131203.47299962
1506,Year One,62357900,60000000,2357900,63380596.6311204,60984026.047497205,2396570.583623193
1507,Life During Wartime,744816,4500000,-3755184,757031.305743211,4573801.95356229,-3816770.6478190795
1508,Ondine,1644755,12000000,-10355245,1671729.69602918,12196805.2094994,-10525075.51347022
1509,Oceans,19406406,0,19406406,19724679.483205102,0.0,19724679.483205102
1510,My Bloody Valentine,100734718,15000000,85734718,102386811.106654,15246006.511874301,87140804.5947797
1511,Arthur et la vengeance de Maltazard,0,87000000,-87000000,0.0,88426837.7688709,-88426837.7688709
1512,Battlestar Galactica: The Plan,0,0,0,0.0,0.0,0.0
1513,Home,0,0,0,0.0,0.0,0.0
1514,Old Dogs,92219310,35000000,57219310,93731746.71870358,35574015.194373295,58157731.52433029
1515,Bitch Slap,199436,0,199436,202706.836980144,0.0,202706.836980144
1516,Agora,39041505,70000000,-30958495,39681802.630891494,71148030.38874671,-31466227.757855214
1517,Mary and Max,0,8000000,-8000000,0.0,8131203.47299962,-8131203.47299962
1518,The Boondock Saints II: All Saints Day,10629321,8000000,2629321,10803646.478853399,8131203.47299962,2672443.0058537787
1519,The Bad Lieutenant: Port of Call - New Orleans,10589102,25000000,-14410898,10762767.8697934,25410010.8531238,-14647242.983330399
1520,The Imaginarium of Doctor Parnassus,61808775,30000000,31808775,62822465.7427315,30492013.023748603,32330452.718982894
1521,Horsemen,1017401,20000000,-18982599,1034086.81807916,20328008.682499,-19293921.86441984
1522,Armored,22942221,20000000,2942221,23318483.3841906,20328008.682499,2990474.7016916014
1523,Carriers,5802422,0,5802422,5897584.23977618,0.0,5897584.23977618
1524,L'ArmÃ©e du crime,0,10000000,-10000000,0.0,10164004.3412495,-10164004.3412495
1525,Hole in One,0,0,0,0.0,0.0,0.0
1526,My Fake Fiance,0,0,0,0.0,0.0,0.0
1527,Cirque du Freak: The Vampire's Assistant,28169671,40000000,-11830329,28631665.833557103,40656017.3649981,-12024351.531441
1528,Hulk vs. Wolverine,0,0,0,0.0,0.0,0.0
1529,Leaves of Grass,985117,9000000,-8014883,1001273.34646387,9147603.90712458,-8146330.560660711
1530,An Education,26096852,7500000,18596852,26524851.7020946,7623003.25593715,18901848.446157448
1531,Funny People,61458982,75000000,-13541018,62466935.9856777,76230032.5593715,-13763096.573693804
1532,Paper Man,0,0,0,0.0,0.0,0.0
1533,Up in the Air,163670000,25000000,138670000,166354259.053231,25410010.8531238,140944248.20010722
1534,Astro Boy,44091067,65000000,-20908933,44814179.6398324,66066028.2181219,-21251848.5782895
1535,The International,60161391,50000000,10161391,61148063.929960996,50820021.7062476,10328042.223713398
1536,Triangle,0,12000000,-12000000,0.0,12196805.2094994,-12196805.2094994
1537,The Hole,0,0,0,0.0,0.0,0.0
1538,Universal Soldier: Regeneration,875386,14000000,-13124614,889742.7104269059,14229606.0777493,-13339863.367322395
1539,Fast & Furious,363164265,85000000,278164265,369120316.604669,86394036.900621,282726279.704048
1540,Suck,0,0,0,0.0,0.0,0.0
1541,Nothing Personal,0,0,0,0.0,0.0,0.0
1542,Capitalism: A Love Story,17436509,20000000,-2563491,17722475.3172236,20328008.682499,-2605533.365275398
1543,Grey Gardens,0,12000000,-12000000,0.0,12196805.2094994,-12196805.2094994
1544,Thick as Thieves,0,25000000,-25000000,0.0,25410010.8531238,-25410010.8531238
1545,Che: Part Two,0,40000000,-40000000,0.0,40656017.3649981,-40656017.3649981
1546,Halloween II,39421467,15000000,24421467,40067996.1726425,15246006.511874301,24821989.660768196
1547,Eating Out: All You Can Eat,0,0,0,0.0,0.0,0.0
1548,Observe and Report,24007324,0,24007324,24401054.5357784,0.0,24401054.5357784
1549,Middle Men,0,22000000,-22000000,0.0,22360809.5507489,-22360809.5507489
1550,Hannah Montana: The Movie,155545279,35000000,120545279,158096289.101687,35574015.194373295,122522273.90731372
1551,Fighting,32474120,0,32474120,33006709.6658258,0.0,33006709.6658258
1552,Banlieue 13 - Ultimatum,8786375,15000000,-6213625,8930475.36438463,15246006.511874301,-6315531.147489671
1553,Baby on Board,0,8000000,-8000000,0.0,8131203.47299962,-8131203.47299962
1554,Aliens in the Attic,57881056,45000000,12881056,58830330.44601071,45738019.5356229,13092310.910387807
1555,Tell-Tale,0,12000000,-12000000,0.0,12196805.2094994,-12196805.2094994
1556,Adam,2277396,0,2277396,2314746.28307443,0.0,2314746.28307443
1557,The Descent: Part 2,0,0,0,0.0,0.0,0.0
1558,The Collector,9444018,3400000,6044018,9598903.99508387,3455761.47602484,6143142.51905903
1559,Die PÃ¤pstin,27412220,0,27412220,27861792.3083287,0.0,27861792.3083287
1560,Beautiful Kate,0,4300000,-4300000,0.0,4370521.8667373005,-4370521.8667373005
1561,Women in Trouble,18097,3000000,-2981903,18393.7986563592,3049201.30237486,-3030807.5037185005
1562,The Fourth Kind,42333295,10000000,32333295,43027579.4159397,10164004.3412495,32863575.074690204
1563,Glorious 39,0,6000000,-6000000,0.0,6098402.60474972,-6098402.60474972
1564,Solitary Man,5024782,15000000,-9975218,5107190.60618325,15246006.511874301,-10138815.90569105
1565,Cracks,0,0,0,0.0,0.0,0.0
1566,Redline,0,0,0,0.0,0.0,0.0
1567,The Infidel,0,0,0,0.0,0.0,0.0
1568,The Disappearance of Alice Creed,867714,800000,67714,881944.886296299,813120.3472999621,68824.53899633698
1569,Duplicity,60000000,78146652,-18146652,60984026.047497205,79428291.0182116,-18444264.970714398
1570,Wild Cherry,0,3500000,-3500000,0.0,3557401.51943733,-3557401.51943733
1571,Superman/Batman: Public Enemies,0,0,0,0.0,0.0,0.0
1572,Cabin Fever 2: Spring Fever,0,10000000,-10000000,0.0,10164004.3412495,-10164004.3412495
1573,Shrink,0,5100000,-5100000,0.0,5183642.21403726,-5183642.21403726
1574,In the Electric Mist,0,0,0,0.0,0.0,0.0
1575,Space Buddies,0,0,0,0.0,0.0,0.0
1576,Wonder Woman,0,0,0,0.0,0.0,0.0
1577,Bright Star,4440055,8500000,-4059945,4512873.82953867,8639403.6900621,-4126529.8605234297
1578,Stargate SG-1: Children of the Gods,0,0,0,0.0,0.0,0.0
1579,Assassin's Creed: Lineage,0,0,0,0.0,0.0,0.0
1580,Ninja,0,10000000,-10000000,0.0,10164004.3412495,-10164004.3412495
1581,Santa Buddies,0,0,0,0.0,0.0,0.0
1582,Adventureland,17164377,9500000,7664377,17445880.2342843,9655804.12418705,7790076.11009725
1583,Extract,10848783,8000000,2848783,11026707.7509274,8131203.47299962,2895504.2779277796
1584,Scooby-Doo! The Mystery Begins,0,0,0,0.0,0.0,0.0
1585,Defendor,44462,3500000,-3455538,45191.1961020636,3557401.51943733,-3512210.323335266
1586,Beauty and the Beast,0,0,0,0.0,0.0,0.0
1587,American Virgin,0,0,0,0.0,0.0,0.0
1588,Nine,53825515,80000000,-26174485,54708276.812999204,81312034.7299962,-26603757.916997
1589,Red Riding: In the Year of Our Lord 1983,0,0,0,0.0,0.0,0.0
1590,The Messenger,1521261,6500000,-4978739,1546210.34081736,6606602.82181219,-5060392.48099483
1591,The Stepfather,0,0,0,0.0,0.0,0.0
1592,Without a Paddle: Nature's Calling,0,6300000,-6300000,0.0,6403322.7349872,-6403322.7349872
1593,Away We Go,14899417,17000000,-2100583,15143773.9070087,17278807.3801242,-2135033.4731155
1594,My Life in Ruins,20455276,17000000,3455276,20790751.4065457,17278807.3801242,3511944.0264214985
1595,My Sister's Keeper,95714875,30000000,65714875,97284640.5022156,30492013.023748603,66792627.47846699
1596,Seulpeumboda deo seulpeun Iyagi,0,0,0,0.0,0.0,0.0
1597,Rampage,0,0,0,0.0,0.0,0.0
1598,The Cove,1162422,0,1162422,1181486.22543639,0.0,1181486.22543639
1599,The Soloist,31720158,60000000,-28279842,32240382.3617121,60984026.047497205,-28743643.685785104
1600,"Family Guy Presents: Something, Something, Something, Dark Side",0,0,0,0.0,0.0,0.0
1601,Friday the 13th,91379051,19000000,72379051,92877707.10632621,19311608.248374104,73566098.8579521
1602,The Greatest,0,6000000,-6000000,0.0,6098402.60474972,-6098402.60474972
1603,Crossing Over,1037335,25000000,-23962665,1054347.744333,25410010.8531238,-24355663.1087908
1604,The Last House on the Left,0,0,0,0.0,0.0,0.0
1605,Mother and Child,0,7000000,-7000000,0.0,7114803.03887467,-7114803.03887467
1606,Turtles Forever,0,0,0,0.0,0.0,0.0
1607,Harry Brown,10329747,7300000,3029747,10499159.3352009,7419723.16911216,3079436.1660887403
1608,Surrogates,122444772,80000000,42444772,124452919.41713001,81312034.7299962,43140884.687133804
1609,Merantau,0,0,0,0.0,0.0,0.0
1610,Blood and Bone,0,3700000,-3700000,0.0,3760681.60626232,-3760681.60626232
1611,Labor Pains,0,0,0,0.0,0.0,0.0
1612,Street Fighter: The Legend of Chun-Li,12764201,50000000,-37235799,12973539.4376581,50820021.7062476,-37846482.2685895
1613,Hotel for Dogs,73034460,35000000,38034460,74232256.85008149,35574015.194373295,38658241.655708194
1614,Creation,0,0,0,0.0,0.0,0.0
1615,Veronika Decides to Die,0,9000000,-9000000,0.0,9147603.90712458,-9147603.90712458
1616,Barbie Presents: Thumbelina,0,0,0,0.0,0.0,0.0
1617,Exam,0,0,0,0.0,0.0,0.0
1618,Obsessed,73830340,20000000,53830340,75041189.6275929,20328008.682499,54713180.94509391
1619,Tetro,113221,15000000,-14886779,115077.87355206099,15246006.511874301,-15130928.63832224
1620,Children of the Corn,0,4500000,-4500000,0.0,4573801.95356229,-4573801.95356229
1621,The Keeper,0,10000000,-10000000,0.0,10164004.3412495,-10164004.3412495
1622,Lesbian Vampire Killers,0,0,0,0.0,0.0,0.0
1623,44 Inch Chest,0,0,0,0.0,0.0,0.0
1624,The Good Witch's Garden,0,0,0,0.0,0.0,0.0
1625,Whip It,16633035,15000000,1633035,16905823.9948155,15246006.511874301,1659817.4829411972
1626,The Trotsky,0,6400000,-6400000,0.0,6504962.7783997,-6504962.7783997
1627,Metropia,0,5060730,-5060730,0.0,5143728.16898917,-5143728.16898917
1628,In the Loop,6149791,0,6149791,6250650.24217773,0.0,6250650.24217773
1629,Michael Jackson's This Is It,0,60000000,-60000000,0.0,60984026.047497205,-60984026.047497205
1630,The Vicious Kind,0,0,0,0.0,0.0,0.0
1631,The Last Station,0,0,0,0.0,0.0,0.0
1632,Contracorriente,0,0,0,0.0,0.0,0.0
1633,Dolan's Cadillac,0,10000000,-10000000,0.0,10164004.3412495,-10164004.3412495
1634,Dadnapped,0,0,0,0.0,0.0,0.0
1635,The Limits of Control,0,0,0,0.0,0.0,0.0
1636,According to Greta,0,0,0,0.0,0.0,0.0
1637,Solomon Kane,7810000,45000000,-37190000,7938087.39051588,45738019.5356229,-37799932.14510702
1638,Dead Man Running,0,0,0,0.0,0.0,0.0
1639,Survival of the Dead,143191,4000000,-3856809,145539.394562786,4065601.73649981,-3920062.341937024
1640,Dance Flick,0,0,0,0.0,0.0,0.0
1641,The Devil's Tomb,0,10000000,-10000000,0.0,10164004.3412495,-10164004.3412495
1642,Red Riding: In the Year of Our Lord 1974,0,0,0,0.0,0.0,0.0
1643,Barbie and the Three Musketeers,0,0,0,0.0,0.0,0.0
1644,X-Men Origins: Wolverine,341131793,150000000,191131793,346726502.499023,152460065.118743,194266437.38028002
1645,Balls Out: The Gary Houseman Story,0,0,0,0.0,0.0,0.0
1646,Mutant Pumpkins from Outer Space,0,0,0,0.0,0.0,0.0
1647,Mammoth,0,10000000,-10000000,0.0,10164004.3412495,-10164004.3412495
1648,S. Darko,4100000,4000000,100000,4167241.7799123,4065601.73649981,101640.04341248982
1649,Prison Break: The Final Break,0,0,0,0.0,0.0,0.0
1650,Happily N'Ever After 2,0,0,0,0.0,0.0,0.0
1651,Virtuality,0,0,0,0.0,0.0,0.0
1652,Tanner Hall,0,0,0,0.0,0.0,0.0
1653,Black Dynamite,296557,2900000,-2603443,301420.663542793,2947561.25896236,-2646140.595419567
1654,The Thaw,0,0,0,0.0,0.0,0.0
1655,City Island,6670712,6000000,670712,6780114.57272253,6098402.60474972,681711.9679728104
1656,The Gruffalo,0,0,0,0.0,0.0,0.0
1657,The Secret of Kells,0,0,0,0.0,0.0,0.0
1658,Amelia,19258519,40000000,-20741481,19574367.072203603,40656017.3649981,-21081650.2927945
1659,Screamers: The Hunting,0,0,0,0.0,0.0,0.0
1660,Desert Flower,44348,0,44348,45075.3264525734,0.0,45075.3264525734
1661,Partly Cloudy,0,0,0,0.0,0.0,0.0
1662,Der Knochenmann,0,0,0,0.0,0.0,0.0
1663,Afro Samurai: Resurrection,0,0,0,0.0,0.0,0.0
1664,Boogie Woogie,0,0,0,0.0,0.0,0.0
1665,Echelon Conspiracy,500154,0,500154,508356.742729331,0.0,508356.742729331
1666,Beyond a Reasonable Doubt,4388563,25000000,-20611437,4460537.3383847,25410010.8531238,-20949473.5147391
1667,Love and Other Impossible Pursuits,0,0,0,0.0,0.0,0.0
1668,Possession,0,0,0,0.0,0.0,0.0
1669,Nativity!,0,0,0,0.0,0.0,0.0
1670,BaarÃ¬a,0,35000000,-35000000,0.0,35574015.194373295,-35574015.194373295
1671,Dug's Special Mission,0,0,0,0.0,0.0,0.0
1672,Hunter Prey,0,425000,-425000,0.0,431970.184503105,-431970.184503105
1673,Motherhood,0,0,0,0.0,0.0,0.0
1674,New in Town,29010817,8000000,21010817,29486606.9931195,8131203.47299962,21355403.52011988
1675,Me and Orson Welles,2336172,25000000,-22663828,2374486.23499056,25410010.8531238,-23035524.61813324
1676,Shorts,28972508,40000000,-11027492,29447669.708888598,40656017.3649981,-11208347.656109504
1677,"My Son, My Son, What Have Ye Done",0,0,0,0.0,0.0,0.0
1678,Alice,0,0,0,0.0,0.0,0.0
1679,Miss March,0,0,0,0.0,0.0,0.0
1680,In Her Skin,0,7000000,-7000000,0.0,7114803.03887467,-7114803.03887467
1681,Five Minutes of Heaven,0,0,0,0.0,0.0,0.0
1682,Super Rhino,0,0,0,0.0,0.0,0.0
1683,Ju-on: Shiroi rÃ´jo,0,0,0,0.0,0.0,0.0
1684,The Private Lives of Pippa Lee,0,0,0,0.0,0.0,0.0
1685,Imagine That,0,55000000,-55000000,0.0,55902023.8768724,-55902023.8768724
1686,Personal Effects,0,0,0,0.0,0.0,0.0
1687,Fame,0,0,0,0.0,0.0,0.0
1688,From Within,66456,0,66456,67545.9072502079,0.0,67545.9072502079
1689,Nine Miles Down,0,0,0,0.0,0.0,0.0
1690,Robin Williams: Weapons of Self Destruction,0,0,0,0.0,0.0,0.0
1691,Prep & Landing,0,0,0,0.0,0.0,0.0
1692,Gentlemen Broncos,0,10000000,-10000000,0.0,10164004.3412495,-10164004.3412495
1693,Walled In,0,10000000,-10000000,0.0,10164004.3412495,-10164004.3412495
1694,The Human Centipede (First Sequence),0,2011799,-2011799,0.0,2044793.37697214,-2044793.37697214
1695,Dread,0,0,0,0.0,0.0,0.0
1696,Dragonball Evolution,0,100000000,-100000000,0.0,101640043.412495,-101640043.412495
1697,The Countess,0,8500000,-8500000,0.0,8639403.6900621,-8639403.6900621
1698,John Rabe,0,20000000,-20000000,0.0,20328008.682499,-20328008.682499
1699,Sorority Row,27206120,12500000,14706120,27652312.1788555,12705005.4265619,14947306.752293602
1700,Hardwired,0,5000000,-5000000,0.0,5082002.17062476,-5082002.17062476
1701,The Maiden Heist,0,20000000,-20000000,0.0,20328008.682499,-20328008.682499
1702,The Last Templar,0,0,0,0.0,0.0,0.0
1703,Middle of Nowhere,0,0,0,0.0,0.0,0.0
1704,The Killing Room,0,0,0,0.0,0.0,0.0
1705,The House of the Devil,0,0,0,0.0,0.0,0.0
1706,Legally Blondes,0,0,0,0.0,0.0,0.0
1707,The Revenant,0,0,0,0.0,0.0,0.0
1708,Giallo,0,14000000,-14000000,0.0,14229606.0777493,-14229606.0777493
1709,Deep in the Valley,0,0,0,0.0,0.0,0.0
1710,The New Daughter,0,0,0,0.0,0.0,0.0
1711,Nowhere Boy,0,0,0,0.0,0.0,0.0
1712,Prayers for Bobby,0,0,0,0.0,0.0,0.0
1713,St Trinian's 2: The Legend of Fritton's Gold,0,0,0,0.0,0.0,0.0
1714,Stay Cool,0,4500000,-4500000,0.0,4573801.95356229,-4573801.95356229
1715,Behind Enemy Lines III: Colombia,0,0,0,0.0,0.0,0.0
1716,Forget Me Not,0,0,0,0.0,0.0,0.0
1717,Dead Like Me: Life After Death,0,0,0,0.0,0.0,0.0
1718,Open Graves,0,6500000,-6500000,0.0,6606602.82181219,-6606602.82181219
1719,Gifted Hands: The Ben Carson Story,0,0,0,0.0,0.0,0.0
1720,B.O.B.'s Big Break,0,0,0,0.0,0.0,0.0
1721,Princess Protection Program,0,0,0,0.0,0.0,0.0
1722,ChÃ©ri,9366227,23000000,-13633773,9519837.18891286,23377209.9848739,-13857372.79596104
1723,Tales of the Black Freighter,0,0,0,0.0,0.0,0.0
1724,The Joneses,7022728,10000000,-2977272,7137903.78794146,10164004.3412495,-3026100.55330804
1725,Arlen Faber,0,0,0,0.0,0.0,0.0
1726,Espion(s),0,0,0,0.0,0.0,0.0
1727,Mrs. Miracle,0,0,0,0.0,0.0,0.0
1728,Fired Up!,18599102,20000000,-1400898,18904135.3471342,20328008.682499,-1423873.3353648
1729,Cherrybomb,0,0,0,0.0,0.0,0.0
1730,My One and Only,2479538,0,2479538,2520203.49962931,0.0,2520203.49962931
1731,The Firm,0,0,0,0.0,0.0,0.0
1732,Serious Moonlight,0,0,0,0.0,0.0,0.0
1733,Wanted,134,75,59,136.197658172743,76.2300325593715,59.967625613371496
1734,World's Greatest Dad,295750,10000000,-9704250,300600.428392455,10164004.3412495,-9863403.912857044
1735,Road Trip: Beer Pong,0,0,0,0.0,0.0,0.0
1736,The Girlfriend Experience,1007962,1700000,-692038,1024493.01438145,1727880.73801242,-703387.72363097
1737,Night of the Demons,0,10000000,-10000000,0.0,10164004.3412495,-10164004.3412495
1738,Wuthering Heights,0,0,0,0.0,0.0,0.0
1739,Transylmania,263941,0,263941,268269.746983374,0.0,268269.746983374
1740,Damage,0,0,0,0.0,0.0,0.0
1741,Summer's Blood,0,0,0,0.0,0.0,0.0
1742,Cold Souls,0,0,0,0.0,0.0,0.0
1743,Into the Blue 2: The Reef,0,0,0,0.0,0.0,0.0
1744,A Dangerous Man,0,6500000,-6500000,0.0,6606602.82181219,-6606602.82181219
1745,When You're Strange,0,0,0,0.0,0.0,0.0
1746,The Lodger,0,0,0,0.0,0.0,0.0
1747,Dark Country,0,0,0,0.0,0.0,0.0
1748,Leningrad,0,0,0,0.0,0.0,0.0
1749,The Phantom,0,0,0,0.0,0.0,0.0
1750,Hulk vs. Thor,0,0,0,0.0,0.0,0.0
1751,12 Men of Christmas,0,0,0,0.0,0.0,0.0
1752,Under the Sea 3D,0,0,0,0.0,0.0,0.0
1753,Into the Storm,0,0,0,0.0,0.0,0.0
1754,Frequently Asked Questions About Time Travel,0,0,0,0.0,0.0,0.0
1755,De helaasheid der dingen,0,0,0,0.0,0.0,0.0
1756,Post Grad,6405245,15000000,-8594755,6510293.79867668,15246006.511874301,-8735712.713197622
1757,Grace,0,5000000,-5000000,0.0,5082002.17062476,-5082002.17062476
1758,Paper Heart,1296971,1000000,296971,1318241.88744747,1016400.43412495,301841.45332252013
1759,Across the Hall,0,0,0,0.0,0.0,0.0
1760,The Marine 2,0,0,0,0.0,0.0,0.0
1761,Ben 10: Alien Swarm,0,40000000,-40000000,0.0,40656017.3649981,-40656017.3649981
1762,Doghouse,0,0,0,0.0,0.0,0.0
1763,The Hills Run Red,0,0,0,0.0,0.0,0.0
1764,Looking for Eric,0,0,0,0.0,0.0,0.0
1765,Taking Woodstock,0,0,0,0.0,0.0,0.0
1766,George & A.J.,0,0,0,0.0,0.0,0.0
1767,The Terminators,0,0,0,0.0,0.0,0.0
1768,Taking Chance,0,0,0,0.0,0.0,0.0
1769,Notorious,43051547,0,43051547,43757611.0605508,0.0,43757611.0605508
1770,The Loved Ones,0,0,0,0.0,0.0,0.0
1771,Everybody's Fine,0,21000000,-21000000,0.0,21344409.116623998,-21344409.116623998
1772,Bionicle: The Legend Reborn,0,0,0,0.0,0.0,0.0
1773,ZMD: Zombies of Mass Destruction,0,0,0,0.0,0.0,0.0
1774,Crazy Heart,39462438,7000000,32462438,40109639.114829,7114803.03887467,32994836.075954325
1775,The Three Investigators and the Secret of Terror Castle,0,0,0,0.0,0.0,0.0
1776,Tormented,0,0,0,0.0,0.0,0.0
1777,"The Goods: Live Hard, Sell Hard",0,10000000,-10000000,0.0,10164004.3412495,-10164004.3412495
1778,Triage,0,0,0,0.0,0.0,0.0
1779,Ricky,0,0,0,0.0,0.0,0.0
1780,Stolen Lives,7306,2000000,-1992694,7425.82157171691,2032800.8682499,-2025375.0466781831
1781,I Hate Valentine's Day,0,0,0,0.0,0.0,0.0
1782,Driven To Kill,0,10000000,-10000000,0.0,10164004.3412495,-10164004.3412495
1783,"Give 'em Hell, Malone",0,15000000,-15000000,0.0,15246006.511874301,-15246006.511874301
1784,The Courageous Heart of Irena Sendler,0,0,0,0.0,0.0,0.0
1785,The Jerk Theory,0,0,0,0.0,0.0,0.0
1786,Jusqu'Ã  toi,0,0,0,0.0,0.0,0.0
1787,Perrierâ€™s Bounty,0,0,0,0.0,0.0,0.0
1788,Alabama Moon,0,0,0,0.0,0.0,0.0
1789,Humpday,0,0,0,0.0,0.0,0.0
1790,The Haunted World of El Superbeasto,0,0,0,0.0,0.0,0.0
1791,Not Forgotten,0,0,0,0.0,0.0,0.0
1792,The Six Wives of Henry Lefay,0,0,0,0.0,0.0,0.0
1793,Tetsuo: The Bullet Man,0,0,0,0.0,0.0,0.0
1794,TiMER,0,0,0,0.0,0.0,0.0
1795,The September Issue,0,0,0,0.0,0.0,0.0
1796,Feast III: The Happy Finish,0,0,0,0.0,0.0,0.0
1797,Like Dandelion Dust,352810,2500000,-2147190,358596.23716362397,2541001.08531238,-2182404.848148756
1798,Tellement proches,0,0,0,0.0,0.0,0.0
1799,Homecoming,0,1500000,-1500000,0.0,1524600.65118743,-1524600.65118743
1800,I Hope They Serve Beer in Hell,1429299,7000000,-5570701,1452740.12409436,7114803.03887467,-5662062.914780309
1801,Amreeka,0,0,0,0.0,0.0,0.0
1802,Emma,0,0,0,0.0,0.0,0.0
1803,Lebanon,0,0,0,0.0,0.0,0.0
1804,Mega Shark vs Giant Octopus,0,0,0,0.0,0.0,0.0
1805,Lascars,0,12500000,-12500000,0.0,12705005.4265619,-12705005.4265619
1806,It Might Get Loud,1896244,0,1896244,1927343.22480683,0.0,1927343.22480683
1807,The Cell 2,0,0,0,0.0,0.0,0.0
1808,BrÃ¼no,0,42000000,-42000000,0.0,42688818.233247995,-42688818.233247995
1809,Wizards of Waverly Place: The Movie,0,0,0,0.0,0.0,0.0
1810,Accidents Happen,0,0,0,0.0,0.0,0.0
1811,Oscar et la dame Rose,0,0,0,0.0,0.0,0.0
1812,Command Performance,0,0,0,0.0,0.0,0.0
1813,Futurama: Into the Wild Green Yonder,0,0,0,0.0,0.0,0.0
1814,Gabriel Iglesias: I'm Not Fat... I'm Fluffy,0,0,0,0.0,0.0,0.0
1815,The King of Fighters,0,12000000,-12000000,0.0,12196805.2094994,-12196805.2094994
1816,Mystery Team,0,0,0,0.0,0.0,0.0
1817,The Hunt for Gollum,0,5000,-5000,0.0,5082.00217062476,-5082.00217062476
1818,Beautiful,56000,1500000,-1444000,56918.4243109973,1524600.65118743,-1467682.2268764325
1819,Blood Creek,0,0,0,0.0,0.0,0.0
1820,Ace Ventura Jr: Pet Detective,0,7500000,-7500000,0.0,7623003.25593715,-7623003.25593715
1821,Sorority Wars,0,0,0,0.0,0.0,0.0
1822,Uncertainty,0,0,0,0.0,0.0,0.0
1823,Night Train,0,0,0,0.0,0.0,0.0
1824,Infestation,0,0,0,0.0,0.0,0.0
1825,Next Day Air,0,0,0,0.0,0.0,0.0
1826,The Good Guy,0,3200000,-3200000,0.0,3252481.38919985,-3252481.38919985
1827,The Canyon,0,0,0,0.0,0.0,0.0
1828,Goal! III: Taking On The World,0,0,0,0.0,0.0,0.0
1829,Did You Hear About The Morgans?,85280250,58000000,27280250,86678883.1222845,58951225.179247305,27727657.943037197
1830,Garfield's Pet Force,0,0,0,0.0,0.0,0.0
1831,The Grudge 3,38610009,5000000,33610009,39243229.909168296,5082002.17062476,34161227.73854353
1832,The Shortcut,0,0,0,0.0,0.0,0.0
1833,Doctor Who: Planet of the Dead,0,0,0,0.0,0.0,0.0
1834,Kevin Hart: I'm a Grown Little Man,0,0,0,0.0,0.0,0.0
1835,Coco,0,0,0,0.0,0.0,0.0
1836,Le Vilain,0,0,0,0.0,0.0,0.0
1837,Make the Yuletide Gay,0,0,0,0.0,0.0,0.0
1838,To Save A Life,0,0,0,0.0,0.0,0.0
1839,Le Coach,0,0,0,0.0,0.0,0.0
1840,Good Hair,0,0,0,0.0,0.0,0.0
1841,Ink,0,0,0,0.0,0.0,0.0
1842,Hit and Run,0,3500000,-3500000,0.0,3557401.51943733,-3557401.51943733
1843,Trailer Park Boys: Countdown to Liquor Day,0,3500000,-3500000,0.0,3557401.51943733,-3557401.51943733
1844,Amore 14,0,0,0,0.0,0.0,0.0
1845,Weather Girl,0,0,0,0.0,0.0,0.0
1846,Paintball,0,0,0,0.0,0.0,0.0
1847,The Messengers 2: The Scarecrow,0,0,0,0.0,0.0,0.0
1848,Lightbulb,0,0,0,0.0,0.0,0.0
1849,Spectacular!,0,0,0,0.0,0.0,0.0
1850,Against the Dark,0,9000000,-9000000,0.0,9147603.90712458,-9147603.90712458
1851,Stan Helsing,0,108,-108,0.0,109.77124688549401,-109.77124688549401
1852,The Diary of Anne Frank,0,0,0,0.0,0.0,0.0
1853,Big Fan,232732,250000,-17268,236548.905834768,254100.10853123802,-17551.20269647002
1854,Italians,0,0,0,0.0,0.0,0.0
1855,Best Worst Movie,0,0,0,0.0,0.0,0.0
1856,Sweet Karma,0,0,0,0.0,0.0,0.0
1857,The Marc Pease Experience,0,0,0,0.0,0.0,0.0
1858,I Can Do Bad All By Myself,0,0,0,0.0,0.0,0.0
1859,Heartless,0,0,0,0.0,0.0,0.0
1860,2081,0,0,0,0.0,0.0,0.0
1861,Cairo Time,0,0,0,0.0,0.0,0.0
1862,Hatching Pete,0,0,0,0.0,0.0,0.0
1863,The Age of Stupid,0,0,0,0.0,0.0,0.0
1864,Iron Maiden: Flight 666,0,0,0,0.0,0.0,0.0
1865,Life,0,0,0,0.0,0.0,0.0
1866,Mao's Last Dancer,20719451,25000000,-4280549,21059258.9912307,25410010.8531238,-4350751.861893099
1867,Laid to Rest,0,0,0,0.0,0.0,0.0
1868,Vertige,0,0,0,0.0,0.0,0.0
1869,The Slammin' Salmon,0,0,0,0.0,0.0,0.0
1870,Loose Change 9/11: An American Coup,0,0,0,0.0,0.0,0.0
1871,Down Terrace,10000,31192,-21192,10164.0043412495,31703.562341225497,-21539.557999975998
1872,Paa,0,3250000,-3250000,0.0,3303301.41090609,-3303301.41090609
1873,A Very Potter Musical,0,0,0,0.0,0.0,0.0
1874,Paranormal Entity,0,0,0,0.0,0.0,0.0
1875,Fear Island,0,0,0,0.0,0.0,0.0
1876,Art & Copy,0,0,0,0.0,0.0,0.0
1877,The Damned United,0,10000000,-10000000,0.0,10164004.3412495,-10164004.3412495
1878,Collapse,0,0,0,0.0,0.0,0.0
1879,Doctor Who: The End of Time,0,0,0,0.0,0.0,0.0
1880,Direct Contact,0,6000000,-6000000,0.0,6098402.60474972,-6098402.60474972
1881,The War Boys,0,0,0,0.0,0.0,0.0
1882,CinÃ©man,0,0,0,0.0,0.0,0.0
1883,Madea Goes to Jail,90508336,0,90508336,91992712.0023271,0.0,91992712.0023271
1884,35 Rhums,0,0,0,0.0,0.0,0.0
1885,Don McKay,0,0,0,0.0,0.0,0.0
1886,The Wild and Wonderful Whites of West Virginia,0,0,0,0.0,0.0,0.0
1887,Book of Blood,0,0,0,0.0,0.0,0.0
1888,La Guerre des Miss,0,0,0,0.0,0.0,0.0
1889,Objectified,0,0,0,0.0,0.0,0.0
1890,Hamlet,0,0,0,0.0,0.0,0.0
1891,"Nightmares in Red, White and Blue",0,0,0,0.0,0.0,0.0
1892,The Winning Season,0,0,0,0.0,0.0,0.0
1893,Alien Trespass,0,0,0,0.0,0.0,0.0
1894,Bring It On: Fight to the Finish,0,0,0,0.0,0.0,0.0
1895,Doctor Who: The Waters of Mars,0,0,0,0.0,0.0,0.0
1896,Logorama,0,0,0,0.0,0.0,0.0
1897,Jonas Brothers: The Concert Experience,0,0,0,0.0,0.0,0.0
1898,R.T.T.,0,0,0,0.0,0.0,0.0
1899,Alma,0,0,0,0.0,0.0,0.0
1900,Waking Sleeping Beauty,80,0,80,81.3120347299962,0.0,81.3120347299962
1901,Kurbaan,0,0,0,0.0,0.0,0.0
1902,The Yes Men Fix the World,0,0,0,0.0,0.0,0.0
1903,Deadline,0,0,0,0.0,0.0,0.0
1904,Today's Special,400654,0,400654,407224.899533899,0.0,407224.899533899
1905,Un'estate ai Caraibi,0,0,0,0.0,0.0,0.0
1906,Table for Three,0,0,0,0.0,0.0,0.0
1907,Los Bandoleros,0,0,0,0.0,0.0,0.0
1908,Long Weekend,0,0,0,0.0,0.0,0.0
1909,Map of the Sounds of Tokyo,0,0,0,0.0,0.0,0.0
1910,Talhotblond,0,0,0,0.0,0.0,0.0
1911,His Name Was Jason: 30 Years of Friday the 13th,0,0,0,0.0,0.0,0.0
1912,Cencoroll,0,0,0,0.0,0.0,0.0
1913,De Dana Dan,0,0,0,0.0,0.0,0.0
1914,Jean Charles,0,0,0,0.0,0.0,0.0
1915,ThanksKilling,0,3500,-3500,0.0,3557.4015194373296,-3557.4015194373296
1916,Jim Jefferies: I Swear to God,0,0,0,0.0,0.0,0.0
1917,Une semaine sur deux,0,0,0,0.0,0.0,0.0
1918,Circle of Eight,0,0,0,0.0,0.0,0.0
1919,Inception,825500000,160000000,665500000,825500000.0,160000000.0,665500000.0
1920,Iron Man 2,623933331,200000000,423933331,623933331.0,200000000.0,423933331.0
1921,Alice in Wonderland,1025467110,200000000,825467110,1025467110.0,200000000.0,825467110.0
1922,Black Swan,327803731,13000000,314803731,327803731.0,13000000.0,314803731.0
1923,Harry Potter and the Deathly Hallows: Part 1,954305868,250000000,704305868,954305868.0,250000000.0,704305868.0
1924,Despicable Me,543513985,69000000,474513985,543513985.0,69000000.0,474513985.0
1925,The Expendables,274470394,80000000,194470394,274470394.0,80000000.0,194470394.0
1926,How to Train Your Dragon,494878759,165000000,329878759,494878759.0,165000000.0,329878759.0
1927,Shutter Island,294804195,80000000,214804195,294804195.0,80000000.0,214804195.0
1928,TRON: Legacy,400062763,170000000,230062763,400062763.0,170000000.0,230062763.0
1929,Tangled,591794936,260000000,331794936,591794936.0,260000000.0,331794936.0
1930,Toy Story 3,1063171911,200000000,863171911,1063171911.0,200000000.0,863171911.0
1931,Salt,293329073,110000000,183329073,293329073.0,110000000.0,183329073.0
1932,127 Hours,35692920,18000000,17692920,35692920.0,18000000.0,17692920.0
1933,Easy A,74952305,8000000,66952305,74952305.0,8000000.0,66952305.0
1934,The Chronicles of Narnia: The Voyage of the Dawn Treader,415686217,155000000,260686217,415686217.0,155000000.0,260686217.0
1935,Kick-Ass,96188903,28000000,68188903,96188903.0,28000000.0,68188903.0
1936,The Tourist,278346189,100000000,178346189,278346189.0,100000000.0,178346189.0
1937,Prince of Persia: The Sands of Time,335154643,150000000,185154643,335154643.0,150000000.0,185154643.0
1938,Robin Hood,310669540,200000000,110669540,310669540.0,200000000.0,110669540.0
1939,True Grit,252276927,38000000,214276927,252276927.0,38000000.0,214276927.0
1940,Clash of the Titans,232713139,125000000,107713139,232713139.0,125000000.0,107713139.0
1941,The Sorcerer's Apprentice,215283742,150000000,65283742,215283742.0,150000000.0,65283742.0
1942,Letters to Juliet,0,30000000,-30000000,0.0,30000000.0,-30000000.0
1943,The Social Network,224920315,40000000,184920315,224920315.0,40000000.0,184920315.0
1944,Scott Pilgrim vs. the World,47664559,60000000,-12335441,47664559.0,60000000.0,-12335441.0
1945,Little Fockers,310650585,100000000,210650585,310650585.0,100000000.0,210650585.0
1946,Predators,126248813,40000000,86248813,126248813.0,40000000.0,86248813.0
1947,Percy Jackson & the Olympians: The Lightning Thief,226497209,95000000,131497209,226497209.0,95000000.0,131497209.0
1948,Unstoppable,167805466,100000000,67805466,167805466.0,100000000.0,67805466.0
1949,Shrek Forever After,752600867,165000000,587600867,752600867.0,165000000.0,587600867.0
1950,Dear John,114977104,25000000,89977104,114977104.0,25000000.0,89977104.0
1951,The A-Team,177238796,110000000,67238796,177238796.0,110000000.0,67238796.0
1952,RED,71664962,58000000,13664962,71664962.0,58000000.0,13664962.0
1953,Machete,31327899,20000000,11327899,31327899.0,20000000.0,11327899.0
1954,Grown Ups,271430189,80000000,191430189,271430189.0,80000000.0,191430189.0
1955,The Book of Eli,157107755,80000000,77107755,157107755.0,80000000.0,77107755.0
1956,Date Night,152263880,55000000,97263880,152263880.0,55000000.0,97263880.0
1957,The Town,154026136,37000000,117026136,154026136.0,37000000.0,117026136.0
1958,Remember Me,0,20000000,-20000000,0.0,20000000.0,-20000000.0
1959,The Twilight Saga: Eclipse,698491347,68000000,630491347,698491347.0,68000000.0,630491347.0
1960,Megamind,321885765,130000000,191885765,321885765.0,130000000.0,191885765.0
1961,The Last Airbender,318502923,150000000,168502923,318502923.0,150000000.0,168502923.0
1962,The Other Guys,170432927,100000000,70432927,170432927.0,100000000.0,70432927.0
1963,30 Days of Night: Dark Days,0,0,0,0.0,0.0,0.0
1964,Insidious,97009150,1500000,95509150,97009150.0,1500000.0,95509150.0
1965,Step Up 3D,159291809,30000000,129291809,159291809.0,30000000.0,129291809.0
1966,The King's Speech,414211549,15000000,399211549,414211549.0,15000000.0,399211549.0
1967,Love & Other Drugs,102820008,30000000,72820008,102820008.0,30000000.0,72820008.0
1968,The Way Back,20348249,30000000,-9651751,20348249.0,30000000.0,-9651751.0
1969,Repo Men,18409891,32000000,-13590109,18409891.0,32000000.0,-13590109.0
1970,Last Night,7644937,7000000,644937,7644937.0,7000000.0,644937.0
1971,Knight and Day,261930431,117000000,144930431,261930431.0,117000000.0,144930431.0
1972,Undisputed III: Redemption,0,3000000,-3000000,0.0,3000000.0,-3000000.0
1973,Eat Pray Love,204594016,60000000,144594016,204594016.0,60000000.0,144594016.0
1974,Blue Valentine,12355734,1000000,11355734,12355734.0,1000000.0,11355734.0
1975,The Bounty Hunter,136000000,40000000,96000000,136000000.0,40000000.0,96000000.0
1976,Leap Year,29922472,19000000,10922472,29922472.0,19000000.0,10922472.0
1977,Green Zone,94882889,100000000,-5117111,94882889.0,100000000.0,-5117111.0
1978,Gulliver's Travels,237382724,112000000,125382724,237382724.0,112000000.0,125382724.0
1979,The Back-Up Plan,77477008,35000000,42477008,77477008.0,35000000.0,42477008.0
1980,Charlie St. Cloud,48190704,44000000,4190704,48190704.0,44000000.0,4190704.0
1981,The Switch,49830607,19000000,30830607,49830607.0,19000000.0,30830607.0
1982,The Runaways,2995811,10000000,-7004189,2995811.0,10000000.0,-7004189.0
1983,Valentine's Day,216485654,52000000,164485654,216485654.0,52000000.0,164485654.0
1984,Don't Be Afraid of the Dark,36993168,25000000,11993168,36993168.0,25000000.0,11993168.0
1985,Tinker Bell and the Great Fairy Rescue,0,0,0,0.0,0.0,0.0
1986,Saw 3D,136150434,20000000,116150434,136150434.0,20000000.0,116150434.0
1987,The Karate Kid,357852395,40000000,317852395,357852395.0,40000000.0,317852395.0
1988,Due Date,211780824,65000000,146780824,211780824.0,65000000.0,146780824.0
1989,Wild Target,3453043,8000000,-4546957,3453043.0,8000000.0,-4546957.0
1990,From Paris with Love,52615806,52000000,615806,52615806.0,52000000.0,615806.0
1991,The Ghost Writer,60222298,45000000,15222298,60222298.0,45000000.0,15222298.0
1992,It's Kind of a Funny Story,6491240,8000000,-1508760,6491240.0,8000000.0,-1508760.0
1993,The Next Three Days,51148651,30000000,21148651,51148651.0,30000000.0,21148651.0
1994,A Nightmare on Elm Street,115664037,35000000,80664037,115664037.0,35000000.0,80664037.0
1995,The Losers,23580000,25000000,-1420000,23580000.0,25000000.0,-1420000.0
1996,The Fighter,9190869,25000000,-15809131,9190869.0,25000000.0,-15809131.0
1997,Get Him to the Greek,90029656,40000000,50029656,90029656.0,40000000.0,50029656.0
1998,Tucker and Dale vs Evil,0,0,0,0.0,0.0,0.0
1999,Jonah Hex,10539000,47000000,-36461000,10539000.0,47000000.0,-36461000.0
2000,Arthur 3: la guerre des deux mondes,0,65000000,-65000000,0.0,65000000.0,-65000000.0
2001,Stomp the Yard 2: Homecoming,0,0,0,0.0,0.0,0.0
2002,My Name Is Khan,0,22000000,-22000000,0.0,22000000.0,-22000000.0
2003,Vampires Suck,80547866,20000000,60547866,80547866.0,20000000.0,60547866.0
2004,Inside Job,7871522,2000000,5871522,7871522.0,2000000.0,5871522.0
2005,Killers,98159963,75000000,23159963,98159963.0,75000000.0,23159963.0
2006,Legion,67918658,26000000,41918658,67918658.0,26000000.0,41918658.0
2007,13,3317662,0,3317662,3317662.0,0.0,3317662.0
2008,Sex and the City 2,288347692,100000000,188347692,288347692.0,100000000.0,188347692.0
2009,You Again,32005248,20000000,12005248,32005248.0,20000000.0,12005248.0
2010,Nanny McPhee and the Big Bang,93246388,35000000,58246388,93246388.0,35000000.0,58246388.0
2011,Hot Tub Time Machine,64572262,36000000,28572262,64572262.0,36000000.0,28572262.0
2012,The Experiment,0,21800000,-21800000,0.0,21800000.0,-21800000.0
2013,Let Me In,24145613,20000000,4145613,24145613.0,20000000.0,4145613.0
2014,Flipped,1755212,14000000,-12244788,1755212.0,14000000.0,-12244788.0
2015,Legend of the Guardians: The Owls of Ga'Hoole,140073390,80000000,60073390,140073390.0,80000000.0,60073390.0
2016,Takers,69055695,32000000,37055695,69055695.0,32000000.0,37055695.0
2017,Burlesque,89519773,55000000,34519773,89519773.0,55000000.0,34519773.0
2018,The Company Men,4882577,15000000,-10117423,4882577.0,15000000.0,-10117423.0
2019,Going the Distance,42045846,32000000,10045846,42045846.0,32000000.0,10045846.0
2020,Faster,23081726,24000000,-918274,23081726.0,24000000.0,-918274.0
2021,La Rafle,0,20000000,-20000000,0.0,20000000.0,-20000000.0
2022,Paranormal Activity 2,177512032,3000000,174512032,177512032.0,3000000.0,174512032.0
2023,Never Let Me Go,9455232,15000000,-5544768,9455232.0,15000000.0,-5544768.0
2024,Batman: Under the Red Hood,6629178,0,6629178,6629178.0,0.0,6629178.0
2025,The American,65464324,20000000,45464324,65464324.0,20000000.0,45464324.0
2026,Kung Fu Panda Holiday,0,0,0,0.0,0.0,0.0
2027,Cop Out,55583804,30000000,25583804,55583804.0,30000000.0,25583804.0
2028,Mother's Day,0,11000000,-11000000,0.0,11000000.0,-11000000.0
2029,Monsters,4242978,500000,3742978,4242978.0,500000.0,3742978.0
2030,The Way,4430765,0,4430765,4430765.0,0.0,4430765.0
2031,Life as We Know It,105610124,38000000,67610124,105610124.0,38000000.0,67610124.0
2032,Centurion,6814789,12000000,-5185211,6814789.0,12000000.0,-5185211.0
2033,Beginners,5332926,3200000,2132926,5332926.0,3200000.0,2132926.0
2034,Minions: Home Makeover,0,0,0,0.0,0.0,0.0
2035,AÃ±o bisiesto,0,0,0,0.0,0.0,0.0
2036,Shelter,851517,22000000,-21148483,851517.0,22000000.0,-21148483.0
2037,Stone,9479718,22000000,-12520282,9479718.0,22000000.0,-12520282.0
2038,Diary of a Wimpy Kid,75700498,15000000,60700498,75700498.0,15000000.0,60700498.0
2039,I Spit on Your Grave,572809,2000000,-1427191,572809.0,2000000.0,-1427191.0
2040,Piranha 3D,83188165,24000000,59188165,83188165.0,24000000.0,59188165.0
2041,Morning Glory,58785180,40000000,18785180,58785180.0,40000000.0,18785180.0
2042,Conviction,6732980,12500000,-5767020,6732980.0,12500000.0,-5767020.0
2043,The Nutcracker: The Untold Story,16178959,90000000,-73821041,16178959.0,90000000.0,-73821041.0
2044,The Last Exorcism,67738090,1800000,65938090,67738090.0,1800000.0,65938090.0
2045,Tooth Fairy,112462508,48000000,64462508,112462508.0,48000000.0,64462508.0
2046,Beauty & the Briefcase,0,0,0,0.0,0.0,0.0
2047,Fair Game,24188922,22000000,2188922,24188922.0,22000000.0,2188922.0
2048,The Ward,498974,10000000,-9501026,498974.0,10000000.0,-9501026.0
2049,Planet Hulk,7000000,0,7000000,7000000.0,0.0,7000000.0
2050,Buried,19152480,1987650,17164830,19152480.0,1987650.0,17164830.0
2051,Dinner for Schmucks,86387857,69000000,17387857,86387857.0,69000000.0,17387857.0
2052,When in Rome,36699403,0,36699403,36699403.0,0.0,36699403.0
2053,Game of Death,0,13000000,-13000000,0.0,13000000.0,-13000000.0
2054,Waiting for Forever,0,0,0,0.0,0.0,0.0
2055,The Kids Are All Right,34705850,4000000,30705850,34705850.0,4000000.0,30705850.0
2056,The Search for Santa Paws,0,0,0,0.0,0.0,0.0
2057,Skyline,66821036,10000000,56821036,66821036.0,10000000.0,56821036.0
2058,The Debt,45636368,20000000,25636368,45636368.0,20000000.0,25636368.0
2059,Sammy's avonturen: De geheime doorgang,0,0,0,0.0,0.0,0.0
2060,Get Low,0,7500000,-7500000,0.0,7500000.0,-7500000.0
2061,Unthinkable,0,15000000,-15000000,0.0,15000000.0,-15000000.0
2062,Winter's Bone,13831503,2000000,11831503,13831503.0,2000000.0,11831503.0
2063,Gainsbourg (vie hÃ©roÃ¯que),0,0,0,0.0,0.0,0.0
2064,Ca$h,46488,7000000,-6953512,46488.0,7000000.0,-6953512.0
2065,Cats & Dogs 2 : The Revenge of Kitty Galore,112483764,85000000,27483764,112483764.0,85000000.0,27483764.0
2066,Camp Rock 2: The Final Jam,0,0,0,0.0,0.0,0.0
2067,MacGruber,6110000,10000000,-3890000,6110000.0,10000000.0,-3890000.0
2068,Ramona and Beezus,0,0,0,0.0,0.0,0.0
2069,The Wolfman,0,150000000,-150000000,0.0,150000000.0,-150000000.0
2070,Greenberg,6153967,0,6153967,6153967.0,0.0,6153967.0
2071,How Do You Know,48668907,120000000,-71331093,48668907.0,120000000.0,-71331093.0
2072,Jackass 3D,0,20000000,-20000000,0.0,20000000.0,-20000000.0
2073,Minions: Banana,0,0,0,0.0,0.0,0.0
2074,Avalon High,0,0,0,0.0,0.0,0.0
2075,Senna,8212430,0,8212430,8212430.0,0.0,8212430.0
2076,Nude Nuns With Big Guns,0,0,0,0.0,0.0,0.0
2077,Rubber,98017,500000,-401983,98017.0,500000.0,-401983.0
2078,Sinners and Saints,3826,0,3826,3826.0,0.0,3826.0
2079,The Spy Next Door,45236543,28000000,17236543,45236543.0,28000000.0,17236543.0
2080,She's Out of My League,49779728,20000000,29779728,49779728.0,20000000.0,29779728.0
2081,Black Death,265318,0,265318,265318.0,0.0,265318.0
2082,All Good Things,0,0,0,0.0,0.0,0.0
2083,Henry's Crime,204940,12000000,-11795060,204940.0,12000000.0,-11795060.0
2084,The Killer Inside Me,0,13000000,-13000000,0.0,13000000.0,-13000000.0
2085,London Boulevard,4644108,25000000,-20355892,4644108.0,25000000.0,-20355892.0
2086,Hereafter,105197635,50000000,55197635,105197635.0,50000000.0,55197635.0
2087,Gun,0,10000000,-10000000,0.0,10000000.0,-10000000.0
2088,My Soul to Take,19829957,25000000,-5170043,19829957.0,25000000.0,-5170043.0
2089,TEKKEN,967000,30000000,-29033000,967000.0,30000000.0,-29033000.0
2091,The Conspirator,15478800,25000000,-9521200,15478800.0,25000000.0,-9521200.0
2092,The Heavy,0,4500000,-4500000,0.0,4500000.0,-4500000.0
2093,Death at a Funeral,49050886,21000000,28050886,49050886.0,21000000.0,28050886.0
2094,Mirrors 2,0,0,0,0.0,0.0,0.0
2095,Crazy on the Outside,88335,0,88335,88335.0,0.0,88335.0
2096,Hesher,382946,7000000,-6617054,382946.0,7000000.0,-6617054.0
2097,Animal Kingdom,1000000,5000000,-4000000,1000000.0,5000000.0,-4000000.0
2098,Marmaduke,83761844,50000000,33761844,83761844.0,50000000.0,33761844.0
2099,Cave of Forgotten Dreams,6467348,0,6467348,6467348.0,0.0,6467348.0
2100,Jack Goes Boating,538000,0,538000,538000.0,0.0,538000.0
2101,Red Hill,0,0,0,0.0,0.0,0.0
2102,Frozen,3065860,0,3065860,3065860.0,0.0,3065860.0
2103,Wall Street: Money Never Sleeps,134748021,70000000,64748021,134748021.0,70000000.0,64748021.0
2104,The Whistleblower,0,0,0,0.0,0.0,0.0
2105,Legend of the BoneKnapper Dragon,0,0,0,0.0,0.0,0.0
2106,Please Give,0,3000000,-3000000,0.0,3000000.0,-3000000.0
2107,Carlos,871279,18000000,-17128721,871279.0,18000000.0,-17128721.0
2108,Jack and the Beanstalk,0,0,0,0.0,0.0,0.0
2109,Shanghai,0,50000000,-50000000,0.0,50000000.0,-50000000.0
2110,The Bang Bang Club,0,0,0,0.0,0.0,0.0
2111,Wrecked,8020,0,8020,8020.0,0.0,8020.0
2112,The Tortured,0,8500000,-8500000,0.0,8500000.0,-8500000.0
2113,The Last Song,0,0,0,0.0,0.0,0.0
2114,The Human Centipede 2 (Full Sequence),0,0,0,0.0,0.0,0.0
2115,Another Year,18124262,8000000,10124262,18124262.0,8000000.0,10124262.0
2116,Barbie: A Fashion Fairytale,0,0,0,0.0,0.0,0.0
2117,Everything Must Go,2614773,5000000,-2385227,2614773.0,5000000.0,-2385227.0
2118,Sherlock Holmes,0,0,0,0.0,0.0,0.0
2119,The Crazies,54956140,20000000,34956140,54956140.0,20000000.0,34956140.0
2120,Chatroom,0,0,0,0.0,0.0,0.0
2121,The Client List,0,0,0,0.0,0.0,0.0
2122,í¬í™” ì†ìœ¼ë¡œ,0,10000,-10000,0.0,10000.0,-10000.0
2123,Rabbit Hole,5129058,5000000,129058,5129058.0,5000000.0,129058.0
2124,Somewhere,0,8000000,-8000000,0.0,8000000.0,-8000000.0
2125,Alpha and Omega,39300000,20000000,19300000,39300000.0,20000000.0,19300000.0
2126,You Will Meet a Tall Dark Stranger,0,22000000,-22000000,0.0,22000000.0,-22000000.0
2127,You Don't Know Jack,0,0,0,0.0,0.0,0.0
2128,Scooby-Doo! Curse of the Lake Monster,0,0,0,0.0,0.0,0.0
2129,Open Season 3,0,0,0,0.0,0.0,0.0
2130,Dog Pound,430041,0,430041,430041.0,0.0,430041.0
2131,16 Wishes,0,0,0,0.0,0.0,0.0
2132,StarStruck,0,0,0,0.0,0.0,0.0
2133,Operation: Endgame,0,0,0,0.0,0.0,0.0
2134,Yogi Bear,201584141,80000000,121584141,201584141.0,80000000.0,121584141.0
2135,Flicka 2,0,0,0,0.0,0.0,0.0
2136,Friendship!,0,0,0,0.0,0.0,0.0
2137,StreetDance 3D,18144030,5773100,12370930,18144030.0,5773100.0,12370930.0
2138,Scared Shrekless,0,0,0,0.0,0.0,0.0
2139,The 41â€“Yearâ€“Old Virgin Who Knocked Up Sarah Marshall and Felt Superbad About It,0,0,0,0.0,0.0,0.0
2140,Just Wright,21520719,0,21520719,21520719.0,0.0,21520719.0
2141,Superman/Batman: Apocalypse,0,3500000,-3500000,0.0,3500000.0,-3500000.0
2142,Super,324138,2500000,-2175862,324138.0,2500000.0,-2175862.0
2143,The Tempest,346594,20000000,-19653406,346594.0,20000000.0,-19653406.0
2144,PiÃ¨ce MontÃ©e,0,0,0,0.0,0.0,0.0
2145,Burning Palms,0,5800000,-5800000,0.0,5800000.0,-5800000.0
2146,Sound of Noise,0,4466000,-4466000,0.0,4466000.0,-4466000.0
2147,Bloomington,0,0,0,0.0,0.0,0.0
2148,Womb,0,3100000,-3100000,0.0,3100000.0,-3100000.0
2149,Donkey's Christmas Shrektacular,0,0,0,0.0,0.0,0.0
2150,My Girlfriend's Boyfriend,0,1400000,-1400000,0.0,1400000.0,-1400000.0
2151,Every Day,18000,0,18000,18000.0,0.0,18000.0
2152,Sintel,0,550000,-550000,0.0,550000.0,-550000.0
2153,BloodRayne: The Third Reich,0,10000000,-10000000,0.0,10000000.0,-10000000.0
2154,Firebreather,0,0,0,0.0,0.0,0.0
2155,Going Postal,0,0,0,0.0,0.0,0.0
2156,Superman/Shazam!: The Return of Black Adam,0,0,0,0.0,0.0,0.0
2157,Titanic II,0,0,0,0.0,0.0,0.0
2158,Country Strong,20529194,15000000,5529194,20529194.0,15000000.0,5529194.0
2159,YellowBrickRoad,0,500000,-500000,0.0,500000.0,-500000.0
2160,Justice League: Crisis on Two Earths,0,0,0,0.0,0.0,0.0
2161,Exit Through the Gift Shop,4790751,0,4790751,4790751.0,0.0,4790751.0
2162,Mr. Nice,850994,0,850994,850994.0,0.0,850994.0
2163,Kongen av BastÃ¸y,0,10000000,-10000000,0.0,10000000.0,-10000000.0
2164,"Tomorrow, When the War Began",16504936,27000000,-10495064,16504936.0,27000000.0,-10495064.0
2165,Sint,0,0,0,0.0,0.0,0.0
2166,Into the Universe with Stephen Hawking,0,0,0,0.0,0.0,0.0
2167,GÃ´ruden suranbÃ¢,0,0,0,0.0,0.0,0.0
2168,And Soon the Darkness,0,0,0,0.0,0.0,0.0
2169,Lottery Ticket,0,0,0,0.0,0.0,0.0
2170,The Pillars of the Earth,0,0,0,0.0,0.0,0.0
2171,Extraordinary Measures,15134293,31000000,-15865707,15134293.0,31000000.0,-15865707.0
2172,Family Guy Presents: It's a Trap!,0,0,0,0.0,0.0,0.0
2173,Devil,33583175,10000000,23583175,33583175.0,10000000.0,23583175.0
2174,Kaboom,539957,0,539957,539957.0,0.0,539957.0
2175,Welcome to the Rileys,42145,0,42145,42145.0,0.0,42145.0
2176,Boy Wonder,0,0,0,0.0,0.0,0.0
2177,HÃ¦vnen,0,15000000,-15000000,0.0,15000000.0,-15000000.0
2178,Sundays at Tiffany's,0,0,0,0.0,0.0,0.0
2179,Day & Night,0,0,0,0.0,0.0,0.0
2180,Cyrus,0,7000000,-7000000,0.0,7000000.0,-7000000.0
2181,Smokin' Aces 2: Assassins' Ball,0,8000000,-8000000,0.0,8000000.0,-8000000.0
2182,Daydream Nation,0,0,0,0.0,0.0,0.0
2183,Atrocious,0,0,0,0.0,0.0,0.0
2184,The Bunny Game,0,0,0,0.0,0.0,0.0
2185,Inception: The Cobol Job,0,0,0,0.0,0.0,0.0
2186,Happy People: A Year in the Taiga,338987,0,338987,338987.0,0.0,338987.0
2187,Our Family Wedding,21409028,14000000,7409028,21409028.0,14000000.0,7409028.0
2188,ì˜í˜•ì œ,0,0,0,0.0,0.0,0.0
2189,"Ultramarines: A Warhammer 40,000 Movie",0,0,0,0.0,0.0,0.0
2190,Double Wedding,0,104002432,-104002432,0.0,104002432.0,-104002432.0
2191,Halo Legends,1000000,100000,900000,1000000.0,100000.0,900000.0
2192,Free Willy: Escape From Pirate's Cove,0,0,0,0.0,0.0,0.0
2193,Barney's Version,8454301,30000000,-21545699,8454301.0,30000000.0,-21545699.0
2194,Frankie & Alice,693181,0,693181,693181.0,0.0,693181.0
2195,The People vs. George Lucas,0,0,0,0.0,0.0,0.0
2196,Edge of Darkness,74901339,80000000,-5098661,74901339.0,80000000.0,-5098661.0
2197,Altitude,0,0,0,0.0,0.0,0.0
2198,The Reef,0,0,0,0.0,0.0,0.0
2199,The Clinic,0,0,0,0.0,0.0,0.0
2200,En ganske snill mann,0,0,0,0.0,0.0,0.0
2201,4.3.2.1,1163967,4600000,-3436033,1163967.0,4600000.0,-3436033.0
2202,Dirty Girl,55125,4000000,-3944875,55125.0,4000000.0,-3944875.0
2203,The Tree,0,0,0,0.0,0.0,0.0
2204,Bereavement,0,2000000,-2000000,0.0,2000000.0,-2000000.0
2205,Minions: Orientation Day,0,0,0,0.0,0.0,0.0
2206,The Chosen One,0,0,0,0.0,0.0,0.0
2207,Catfish,3045943,30000,3015943,3045943.0,30000.0,3015943.0
2208,Furry Vengeance,39340177,35000000,4340177,39340177.0,35000000.0,4340177.0
2209,Casino Jack,1083683,12500000,-11416317,1083683.0,12500000.0,-11416317.0
2210,Kites,0,0,0,0.0,0.0,0.0
2211,Quantum Apocalypse,0,2500000,-2500000,0.0,2500000.0,-2500000.0
2212,Hatchet II,52604,2500000,-2447396,52604.0,2500000.0,-2447396.0
2213,The First Grader,0,0,0,0.0,0.0,0.0
2214,The Pacific,0,120000000,-120000000,0.0,120000000.0,-120000000.0
2215,Chun sing gai bei,0,0,0,0.0,0.0,0.0
2216,Lake Placid 3,0,2500000,-2500000,0.0,2500000.0,-2500000.0
2217,The Myth of the American Sleepover,0,0,0,0.0,0.0,0.0
2218,Harriet the Spy: Blog Wars,0,0,0,0.0,0.0,0.0
2219,Brotherhood,0,0,0,0.0,0.0,0.0
2220,Dylan Dog: Dead of Night,4634062,20000000,-15365938,4634062.0,20000000.0,-15365938.0
2221,Scott Pilgrim vs. the Animation,0,0,0,0.0,0.0,0.0
2222,Ben Hur,0,0,0,0.0,0.0,0.0
2223,Road Train,0,0,0,0.0,0.0,0.0
2224,Lying to Be Perfect,0,0,0,0.0,0.0,0.0
2225,Third Star,0,0,0,0.0,0.0,0.0
2226,Milf,0,500000,-500000,0.0,500000.0,-500000.0
2227,Howl,617000,30000,587000,617000.0,30000.0,587000.0
2228,Freakonomics,103735,3000000,-2896265,103735.0,3000000.0,-2896265.0
2229,Tiny Furniture,0,65000,-65000,0.0,65000.0,-65000.0
2230,The Perfect Game,3878993,12500000,-8621007,3878993.0,12500000.0,-8621007.0
2231,Happythankyoumoreplease,215576,0,215576,215576.0,0.0,215576.0
2232,Scrat's Continental Crack-Up,0,0,0,0.0,0.0,0.0
2233,The Prince & Me 4: The Elephant Adventure,0,2500000,-2500000,0.0,2500000.0,-2500000.0
2234,Jesse Stone: No Remorse,0,0,0,0.0,0.0,0.0
2235,Dead Space: Aftermath,0,2500000,-2500000,0.0,2500000.0,-2500000.0
2236,Prowl,0,0,0,0.0,0.0,0.0
2237,Stake Land,33245,650000,-616755,33245.0,650000.0,-616755.0
2238,DC Showcase: Jonah Hex,0,0,0,0.0,0.0,0.0
2239,Super Hybrid,0,13000000,-13000000,0.0,13000000.0,-13000000.0
2240,Bill Burr: Let It Go,0,0,0,0.0,0.0,0.0
2241,Red White & Blue,0,0,0,0.0,0.0,0.0
2242,Pregnancy Pact,0,0,0,0.0,0.0,0.0
2243,Restrepo,1422910,0,1422910,1422910.0,0.0,1422910.0
2244,The Warrior's Way,11087569,425000000,-413912431,11087569.0,425000000.0,-413912431.0
2245,Hubble 3D,0,0,0,0.0,0.0,0.0
2246,Burke & Hare,4349187,10000000,-5650813,4349187.0,10000000.0,-5650813.0
2247,Abandoned,0,0,0,0.0,0.0,0.0
2248,Beautiful Boy,63931,0,63931,63931.0,0.0,63931.0
2249,Scooby-Doo! Abracadabra-Doo,0,0,0,0.0,0.0,0.0
2250,Space Chimps 2: Zartog Strikes Back,0,0,0,0.0,0.0,0.0
2251,Lost Boys: The Thirst,0,4400000,-4400000,0.0,4400000.0,-4400000.0
2252,Elektra Luxx,10,0,10,10.0,0.0,10.0
2253,The Traveler,0,0,0,0.0,0.0,0.0
2254,Inhale,55089,10000000,-9944911,55089.0,10000000.0,-9944911.0
2255,Four Lions,4270000,967686,3302314,4270000.0,967686.0,3302314.0
2256,Les 7 jours du talion,0,0,0,0.0,0.0,0.0
2257,Beneath Hill 60,0,7347125,-7347125,0.0,7347125.0,-7347125.0
2258,2010: Moby Dick,0,0,0,0.0,0.0,0.0
2259,Brighton Rock,0,0,0,0.0,0.0,0.0
2260,X,0,0,0,0.0,0.0,0.0
2261,Exorcismus,0,0,0,0.0,0.0,0.0
2262,Cemetery Junction,0,0,0,0.0,0.0,0.0
2263,Aziz Ansari: Intimate Moments for a Sensual Evening,0,0,0,0.0,0.0,0.0
2264,Gekijouban Trigun: Badlands Rumble,0,0,0,0.0,0.0,0.0
2265,Winnebago Man,178174,0,178174,178174.0,0.0,178174.0
2266,ExTerminators,0,0,0,0.0,0.0,0.0
2267,NEDs,0,0,0,0.0,0.0,0.0
2268,Les MisÃ©rables in Concert - The 25th Anniversary,0,0,0,0.0,0.0,0.0
2269,Life Cycles,0,0,0,0.0,0.0,0.0
2270,"Montevideo, Bog te video!",0,0,0,0.0,0.0,0.0
2271,The Four-Faced Liar,0,2000000,-2000000,0.0,2000000.0,-2000000.0
2272,I'm Still Here,0,0,0,0.0,0.0,0.0
2273,An Invisible Sign,1279,0,1279,1279.0,0.0,1279.0
2274,Father of Invention,0,0,0,0.0,0.0,0.0
2275,Waste Land,187716,1500000,-1312284,187716.0,1500000.0,-1312284.0
2276,WikiRebels: The Documentary,0,0,0,0.0,0.0,0.0
2277,The Extra Man,453079,7000000,-6546921,453079.0,7000000.0,-6546921.0
2278,Cheerleader Camp,0,0,0,0.0,0.0,0.0
2279,The Final,0,0,0,0.0,0.0,0.0
2280,Mega Shark vs. Crocosaurus,0,0,0,0.0,0.0,0.0
2281,Submarino,0,0,0,0.0,0.0,0.0
2282,Riverworld,0,0,0,0.0,0.0,0.0
2283,The Romantics,123820,4500000,-4376180,123820.0,4500000.0,-4376180.0
2284,Nine Dead,0,2000000,-2000000,0.0,2000000.0,-2000000.0
2285,Wonders of the Solar System,0,0,0,0.0,0.0,0.0
2286,"Bo Burnham: Words, Words, Words",0,0,0,0.0,0.0,0.0
2287,Robot Chicken: Star Wars Episode III,0,0,0,0.0,0.0,0.0
2288,Repeaters,0,0,0,0.0,0.0,0.0
2289,Captifs,0,0,0,0.0,0.0,0.0
2290,Across the Line: The Exodus of Charlie Wright,0,0,0,0.0,0.0,0.0
2291,Arctic Blast,0,5000000,-5000000,0.0,5000000.0,-5000000.0
2292,Scooby-Doo! Camp Scare,0,0,0,0.0,0.0,0.0
2293,Hunt to Kill,0,2300000,-2300000,0.0,2300000.0,-2300000.0
2294,Bal,0,0,0,0.0,0.0,0.0
2295,For Colored Girls,37000000,0,37000000,37000000.0,0.0,37000000.0
2296,The Cutting Edge: Fire & Ice,0,0,0,0.0,0.0,0.0
2297,Territories,0,0,0,0.0,0.0,0.0
2298,Slow Torture Puke Chamber,0,0,0,0.0,0.0,0.0
2299,Oranges and Sunshine,0,0,0,0.0,0.0,0.0
2300,Waiting for 'Superman',0,0,0,0.0,0.0,0.0
2301,The Trip,951179,0,951179,951179.0,0.0,951179.0
2302,The Presence,0,0,0,0.0,0.0,0.0
2303,Balada triste de trompeta,3218666,7000000,-3781334,3218666.0,7000000.0,-3781334.0
2304,Comme les 5 doigts de la main,0,0,0,0.0,0.0,0.0
2305,The Shrine,0,0,0,0.0,0.0,0.0
2306,Zwart Water,0,0,0,0.0,0.0,0.0
2307,F,0,1300000,-1300000,0.0,1300000.0,-1300000.0
2308,Primal,0,0,0,0.0,0.0,0.0
2309,Elena Undone,0,0,0,0.0,0.0,0.0
2310,Temple Grandin,0,0,0,0.0,0.0,0.0
2311,Peep World,10967,0,10967,10967.0,0.0,10967.0
2312,Sharktopus,0,0,0,0.0,0.0,0.0
2313,Tick Tock Tale,0,0,0,0.0,0.0,0.0
2314,Five Minarets in New York,0,12000000,-12000000,0.0,12000000.0,-12000000.0
2315,Listen to Your Heart,0,0,0,0.0,0.0,0.0
2316,è‰‹èˆº,0,0,0,0.0,0.0,0.0
2317,Meek's Cutoff,876302,0,876302,876302.0,0.0,876302.0
2318,Barbie in A Mermaid Tale,0,0,0,0.0,0.0,0.0
2319,Ceremony,22270,0,22270,22270.0,0.0,22270.0
2320,à¸ªà¸´à¹ˆà¸‡à¹€à¸¥à¹‡à¸à¹€à¸¥à¹‡à¸à¸—à¸µà¹ˆà¹€à¸£à¸µà¸¢à¸à¸§à¹ˆà¸²...à¸£à¸±à¸,0,0,0,0.0,0.0,0.0
2321,Shank,0,0,0,0.0,0.0,0.0
2322,Astral City: A Spiritual Journey,0,0,0,0.0,0.0,0.0
2323,Made in Dagenham,0,7200000,-7200000,0.0,7200000.0,-7200000.0
2324,The Dead,0,0,0,0.0,0.0,0.0
2325,Mega Piranha,0,0,0,0.0,0.0,0.0
2326,Prep & Landing Stocking Stuffer: Operation: Secret Santa,0,0,0,0.0,0.0,0.0
2327,Twelve,0,0,0,0.0,0.0,0.0
2328,Mortal Kombat: Rebirth,0,0,0,0.0,0.0,0.0
2329,Dante's Inferno: An Animated Epic,0,0,0,0.0,0.0,0.0
2330,DMT: The Spirit Molecule,0,0,0,0.0,0.0,0.0
2331,Chain Letter,0,0,0,0.0,0.0,0.0
2332,Essential Killing,0,3167000,-3167000,0.0,3167000.0,-3167000.0
2333,Is It Just Me?,0,0,0,0.0,0.0,0.0
2334,Rush: Beyond the Lighted Stage,0,0,0,0.0,0.0,0.0
2335,The Perfect Host,14870,0,14870,14870.0,0.0,14870.0
2336,Triple Dog,0,0,0,0.0,0.0,0.0
2337,Legendary,0,0,0,0.0,0.0,0.0
2338,Why Did I Get Married Too?,60072596,20000000,40072596,60072596.0,20000000.0,40072596.0
2339,The Boy Who Cried Werewolf,0,0,0,0.0,0.0,0.0
2340,180Â° South,0,0,0,0.0,0.0,0.0
2341,The Frankenstein Syndrome,0,0,0,0.0,0.0,0.0
2342,Toast,0,0,0,0.0,0.0,0.0
2343,Resident Evil: Afterlife,296221663,60000000,236221663,296221663.0,60000000.0,236221663.0
2344,Growth,0,300000,-300000,0.0,300000.0,-300000.0
2345,ProtÃ©ger et servir,0,0,0,0.0,0.0,0.0
2346,Revenge of the Bridesmaids,0,0,0,0.0,0.0,0.0
2347,High School,0,0,0,0.0,0.0,0.0
2348,Beyond the Black Rainbow,0,1100000,-1100000,0.0,1100000.0,-1100000.0
2349,American Grindhouse,0,0,0,0.0,0.0,0.0
2350,Peacock,0,0,0,0.0,0.0,0.0
2351,BÃ©bÃ©s,0,0,0,0.0,0.0,0.0
2352,A Little Help,0,0,0,0.0,0.0,0.0
2353,Letters to God,0,0,0,0.0,0.0,0.0
2354,Alien vs. Ninja,0,0,0,0.0,0.0,0.0
2355,Cosa voglio di piÃ¹,0,0,0,0.0,0.0,0.0
2356,Devil's Playground,0,2400000,-2400000,0.0,2400000.0,-2400000.0
2357,Chico & Rita,0,0,0,0.0,0.0,0.0
2358,Parked,0,0,0,0.0,0.0,0.0
2359,Vanishing on 7th Street,1068682,10000000,-8931318,1068682.0,10000000.0,-8931318.0
2360,Te presento a Laura,0,0,0,0.0,0.0,0.0
2361,Li Xiao Long,0,0,0,0.0,0.0,0.0
2362,Yes or No: à¸­à¸¢à¸²à¸à¸£à¸±à¸ à¸à¹‡à¸£à¸±à¸à¹€à¸¥à¸¢,0,0,0,0.0,0.0,0.0
2363,The Rig,0,3000000,-3000000,0.0,3000000.0,-3000000.0
2364,All About Evil,0,0,0,0.0,0.0,0.0
2365,Holy Rollers,0,0,0,0.0,0.0,0.0
2366,Break Ke Baad,427628,0,427628,427628.0,0.0,427628.0
2367,Gasland,0,0,0,0.0,0.0,0.0
2368,"Fat, Sick & Nearly Dead",0,0,0,0.0,0.0,0.0
2369,The Two Escobars,0,0,0,0.0,0.0,0.0
2370,Freshman Father,0,0,0,0.0,0.0,0.0
2371,600 kilos d'or pur,0,0,0,0.0,0.0,0.0
2372,The Encounter,0,0,0,0.0,0.0,0.0
2373,Birdemic: Shock and Terror,0,0,0,0.0,0.0,0.0
2374,Kevin Hart: Seriously Funny,0,0,0,0.0,0.0,0.0
2375,BearCity,5980,0,5980,5980.0,0.0,5980.0
2376,Doctor Who: A Christmas Carol,0,0,0,0.0,0.0,0.0
2377,ê³ ì‚¬ ë‘ ë²ˆì§¸ ì´ì•¼ê¸°: êµìƒì‹¤ìŠµ,0,0,0,0.0,0.0,0.0
2378,Action Replayy,5000000,10000000,-5000000,5000000.0,10000000.0,-5000000.0
2379,Veer,0,1250000,-1250000,0.0,1250000.0,-1250000.0
2380,Christmas Cupid,0,0,0,0.0,0.0,0.0
2381,Once Upon a Time in Mumbaai,0,10,-10,0.0,10.0,-10.0
2382,Une Petite zone de turbulences,0,0,0,0.0,0.0,0.0
2383,The Drawn Together Movie: The Movie!,0,0,0,0.0,0.0,0.0
2384,FRED: The Movie,0,0,0,0.0,0.0,0.0
2385,Strapped,0,0,0,0.0,0.0,0.0
2386,Lemmy,0,0,0,0.0,0.0,0.0
2387,Secretariat,60251371,35000000,25251371,60251371.0,35000000.0,25251371.0
2388,What if...,0,0,0,0.0,0.0,0.0
2389,Bill Cunningham New York,1339650,0,1339650,1339650.0,0.0,1339650.0
2390,DC Showcase: Green Arrow,0,0,0,0.0,0.0,0.0
2391,I Hate Luv Storys,0,0,0,0.0,0.0,0.0
2392,Tabloid,0,0,0,0.0,0.0,0.0
2393,Never Sleep Again: The Elm Street Legacy,0,0,0,0.0,0.0,0.0
2394,Louis C.K.: Hilarious,0,0,0,0.0,0.0,0.0
2395,Burakku Rokku ShÅ«tÄ,0,0,0,0.0,0.0,0.0
2396,The American Matrix - Age Of Deception,0,5000,-5000,0.0,5000.0,-5000.0
2397,The Making of The Walking Dead,0,0,0,0.0,0.0,0.0
2398,Boy,43,3,40,43.0,3.0,40.0
2399,Cropsey,35456,0,35456,35456.0,0.0,35456.0
2400,Il reste du jambon ?,0,0,0,0.0,0.0,0.0
2401,Opeth: In Live Concert At The Royal Albert Hall,0,0,0,0.0,0.0,0.0
2402,I'm Here,0,0,0,0.0,0.0,0.0
2403,Yu-Gi-Oh! 3D: Bonds Beyond Time,0,0,0,0.0,0.0,0.0
2404,A Horrible Way to Die,0,0,0,0.0,0.0,0.0
2405,Into Eternity,0,900000,-900000,0.0,900000.0,-900000.0
2406,As Melhores Coisas do Mundo,0,0,0,0.0,0.0,0.0
2407,Joan Rivers: A Piece of Work,0,0,0,0.0,0.0,0.0
2408,æ’•ç¥¨é¢¨é›²,0,0,0,0.0,0.0,0.0
2409,Fight Club,100853753,63000000,37853753,132022892.45436999,82470329.3354423,49552563.11892769
2410,The Matrix,463517383,63000000,400517383,606768749.6621,82470329.3354423,524298420.32665765
2411,American Beauty,356296601,15000000,341296601,466411079.77093095,19635792.6989148,446775287.0720161
2412,Star Wars: Episode I - The Phantom Menace,924317558,115000000,809317558,1209980530.45701,150541077.358347,1059439453.0986631
2413,The Mummy,415885488,80000000,335885488,544416081.923668,104724227.727545,439691854.196123
2414,The Green Mile,284600000,60000000,224600000,372556440.140744,78543170.7956593,294013269.34508467
2415,The Sixth Sense,672806292,40000000,632806292,880738991.74917,52362113.863772795,828376877.8853972
2416,The World Is Not Enough,361832400,135000000,226832400,473657733.210055,176722134.29023302,296935598.919822
2417,Cruel Intentions,75902208,10500000,65402208,99360001.4451943,13745054.889240302,85614946.55595401
2418,Sleepy Hollow,206071502,100000000,106071502,269758486.295067,130905284.65943201,138853201.63563502
2419,Tarzan,0,0,0,0.0,0.0,0.0
2420,American Pie,235483004,11000000,224483004,308259696.710782,14399581.3125375,293860115.3982445
2421,Entrapment,212404396,66000000,146404396,278048579.212947,86397487.8752252,191651091.33772182
2422,Toy Story 2,485015179,90000000,395015179,634910500.711404,117814756.19348899,517095744.517915
2423,10 Things I Hate About You,53478166,16000000,37478166,70005745.4329437,20944845.5455091,49060899.8874346
2424,Notting Hill,363889678,42000000,321889678,476350818.832191,54980219.5569615,421370599.2752295
2425,Austin Powers: The Spy Who Shagged Me,310940086,33000000,277940086,407037004.698583,43198743.9376126,363838260.7609704
2426,Boys Don't Cry,11540607,2000000,9540607,15107264.4447763,2618105.69318864,12489158.751587661
2427,The Insider,60289912,90000000,-29710088,78922680.92452121,117814756.19348899,-38892075.26896778
2428,Galaxy Quest,90683916,45000000,45683916,118710038.38012,58907378.09674449,59802660.2833755
2429,Eyes Wide Shut,162091208,65000000,97091208,212185957.240312,85088435.02863091,127097522.2116811
2430,Being John Malkovich,22863596,13000000,9863596,29929655.427182503,17017687.0057261,12911968.421456404
2431,Analyze This,176885658,80000000,96885658,231552674.126609,104724227.727545,126828446.399064
2432,Stuart Little,300135367,133000000,167135367,392893056.534981,174104028.597044,218789027.93793702
2433,The Bone Collector,151493655,73000000,78493655,198313200.318728,95560857.80138549,102752342.51734251
2434,Wild Wild West,222104681,170000000,52104681,290746764.904973,222538983.92103398,68207780.98393899
2435,The 13th Warrior,61698899,160000000,-98301101,80767119.3676855,209448455.455091,-128681336.0874055
2436,End of Days,211989043,100000000,111989043,277504860.185956,130905284.65943201,146599575.526524
2437,The Cider House Rules,88545092,24000000,64545092,115910204.734556,31417268.318263695,84492936.41629231
2438,The Iron Giant,23159305,70000000,-46840695,30316754.1353961,91633699.2616025,-61316945.126206405
2439,Deep Blue Sea,73648228,60000000,13648228,96409422.51002759,78543170.7956593,17866251.714368284
2440,"South Park: Bigger, Longer & Uncut",0,21000000,-21000000,0.0,27490109.7784807,-27490109.7784807
2441,Payback,161626121,90000000,71626121,211577133.779048,117814756.19348899,93762377.58555901
2442,Runaway Bride,309457509,70000000,239457509,405096233.05643797,91633699.2616025,313462533.79483545
2443,She's All That,103166989,10000000,93166989,135051040.625015,13090528.465943199,121960512.15907179
2444,Double Jeopardy,177841558,70000000,107841558,232803997.742669,91633699.2616025,141170298.48106647
2445,The Boondock Saints,30471,6000000,-5969529,39888.1492885755,7854317.07956593,-7814428.930277355
2446,Office Space,12827813,10000000,2827813,16792285.1232296,13090528.465943199,3701756.657286402
2447,The Virgin Suicides,10409377,6000000,4409377,13626424.5931234,7854317.07956593,5772107.51355747
2448,Bicentennial Man,93700000,100000000,-6300000,122658251.72588798,130905284.65943201,-8247032.933544025
2449,The Blair Witch Project,248000000,25000,247975000,324645105.955391,32726.321164857996,324612379.63422614
2450,The Ninth Gate,58401898,38000000,20401898,76451170.82341121,49744008.1705842,26707162.65282701
2451,The Hurricane,73956241,50000000,23956241,96812627.8044657,65452642.3297161,31359985.474749595
2452,The Thirteenth Floor,18564088,16000000,2564088,24301372.2408275,20944845.5455091,3356526.695318401
2453,Big Daddy,234801895,34200000,200601895,307368089.035491,44769607.3535258,262598481.68196517
2454,Bringing Out the Dead,0,32000000,-32000000,0.0,41889691.0910183,-41889691.0910183
2455,8MM,96618699,40000000,56618699,126478982.96018998,52362113.863772795,74116869.09641719
2456,Dogma,30652890,10000000,20652890,40126252.910842605,13090528.465943199,27035724.444899406
2457,"Girl, Interrupted",0,40000000,-40000000,0.0,52362113.863772795,-52362113.863772795
2458,Mickey's Once Upon a Christmas,0,0,0,0.0,0.0,0.0
2459,The Haunting,91188905,80000000,11188905,119371095.66806899,104724227.727545,14646867.940523997
2460,Forces of Nature,93888180,75000000,18888180,122904589.29056,98178963.4945741,24725625.795985907
2461,Blast from the Past,40263020,35000000,5263020,52706420.9434841,45816849.6308012,6889571.312682897
2462,Edtv,0,80000000,-80000000,0.0,104724227.727545,-104724227.727545
2463,Message in a Bottle,118880016,80000000,38880016,155620223.347978,104724227.727545,50895995.620433
2464,The General's Daughter,149705852,60000000,89705852,195972871.712428,78543170.7956593,117429700.9167687
2465,Stigmata,50041732,29000000,21041732,65507271.72311011,37962532.551235296,27544739.171874814
2466,Stir of Echoes,21133087,12000000,9133087,27664327.694675397,15708634.159131799,11955693.535543598
2467,Election,0,0,0,0.0,0.0,0.0
2468,Inspector Gadget,0,75000000,-75000000,0.0,98178963.4945741,-98178963.4945741
2469,Magnolia,48451803,37000000,11451803,63425970.639777295,48434955.3239899,14991015.315787397
2470,The Bachelor,36911617,51000000,-14088383,48319257.3062493,66761695.1763104,-18442437.8700611
2471,Virus,14010690,75000000,-60989310,18340733.6272506,98178963.4945741,-79838229.8673235
2472,The Talented Mr. Ripley,128798265,40000000,88798265,168603735.434659,52362113.863772795,116241621.57088621
2473,Lake Placid,56870414,27000000,29870414,74446377.3336976,35344426.8580467,39101950.4756509
2474,Detroit Rock City,4217115,34000000,-29782885,5520426.39516561,44507796.7842069,-38987370.38904129
2475,Mystery Men,29762011,68000000,-38237989,38960045.2199215,89015593.5684139,-50055548.3484924
2476,Ghost Dog: The Way of the Samurai,0,0,0,0.0,0.0,0.0
2477,Fantasia 2000,90874570,80000000,10874570,118959614.541535,104724227.727545,14235386.813990012
2478,Go,28451622,6500000,21951622,37244676.76932561,8508843.50286309,28735833.266462516
2479,Never Been Kissed,84565230,25000000,59565230,110700355.054403,32726321.164858002,77974033.88954501
2480,Instinct,0,80,-80,0.0,104.724227727545,-104.724227727545
2481,October Sky,0,0,0,0.0,0.0,0.0
2482,Three Kings,108000000,75000000,33000000,141377707.432186,98178963.4945741,43198743.93761191
2483,Man on the Moon,47434430,82000000,-34565570,62094175.6180791,107342333.420734,-45248157.8026549
2484,Brokedown Palace,13000000,25000000,-12000000,17017687.0057261,32726321.164858002,-15708634.159131903
2485,Annie,0,0,0,0.0,0.0,0.0
2486,House on Haunted Hill,40846082,19000000,21846082,53469679.9143251,24872004.0852921,28597675.829033002
2487,From Dusk Till Dawn 2: Texas Blood Money,0,5000000,-5000000,0.0,6545264.23297161,-6545264.23297161
2488,Best Laid Plans,0,0,0,0.0,0.0,0.0
2489,A Christmas Carol,0,0,0,0.0,0.0,0.0
2490,The Thomas Crown Affair,124305181,48000000,76305181,162722051.034472,62834536.63652739,99887514.3979446
2491,Random Hearts,74608570,64000000,10608570,97666560.9388317,83779382.1820366,13887178.756795108
2492,eXistenZ,2856712,15000000,-12143288,3739586.97550016,19635792.6989148,-15896205.72341464
2493,The End of the Affair,10827816,23000000,-12172184,14174183.3571995,30108215.4716694,-15934032.114469899
2494,Blue Streak,117758500,65000000,52758500,154152099.635677,85088435.02863091,69063664.6070461
2495,The Rage: Carrie 2,17762705,21000000,-3237295,23252319.543465197,27490109.7784807,-4237790.235015504
2496,Arlington Road,0,21500000,-21500000,0.0,28144636.201777898,-28144636.201777898
2497,Black and White,5241315,10000000,-4758685,6861158.32064752,13090528.465943199,-6229370.145295679
2498,Introducing Dorothy Dandridge,0,0,0,0.0,0.0,0.0
2499,Three to Tango,0,20000000,-20000000,0.0,26181056.931886397,-26181056.931886397
2500,The Corruptor,15156200,25000000,-9843800,19840266.753552802,32726321.164858002,-12886054.4113052
2501,Anna and the King,0,75000000,-75000000,0.0,98178963.4945741,-98178963.4945741
2502,Titus,0,0,0,0.0,0.0,0.0
2503,K-911,0,0,0,0.0,0.0,0.0
2504,Universal Soldier: The Return,10667893,45000000,-34332107,13964835.698813599,58907378.09674449,-44942542.39793089
2505,Mickey Blue Eyes,0,0,0,0.0,0.0,0.0
2506,Candyman: Day of the Dead,0,0,0,0.0,0.0,0.0
2507,The Mating Habits of the Earthbound Human,0,0,0,0.0,0.0,0.0
2508,Joan of Arc,0,20000000,-20000000,0.0,26181056.931886397,-26181056.931886397
2509,Pushing Tin,0,33000000,-33000000,0.0,43198743.9376126,-43198743.9376126
2510,From Dusk Till Dawn 3: The Hangman's Daughter,0,5000000,-5000000,0.0,6545264.23297161,-6545264.23297161
2511,Chill Factor,11263966,70000000,-58736034,14745126.7562416,91633699.2616025,-76888572.5053609
2512,Sunshine,0,0,0,0.0,0.0,0.0
2513,Life,73345029,80000000,-6654971,96012518.9959931,104724227.727545,-8711708.7315519
2514,Anywhere But Here,18653615,23000000,-4346385,24418567.8150245,30108215.4716694,-5689647.656644899
2515,The Astronaut's Wife,19598588,75000000,-55401412,25655587.4106293,98178963.4945741,-72523376.0839448
2516,My Favorite Martian,36850101,65000000,-28149899,48238729.6113382,85088435.02863091,-36849705.417292714
2517,A Midsummer Night's Dream,0,11000000,-11000000,0.0,14399581.3125375,-14399581.3125375
2518,The Limey,3193102,10000000,-6806898,4179939.26256602,13090528.465943199,-8910589.20337718
2519,Angela's Ashes,13,25,-12,17.0176870057261,32.726321164858,-15.7086341591319
2520,The Story of Us,58900031,50000000,8900031,77103253.2450438,65452642.3297161,11650610.915327698
2521,Drive Me Crazy,17843379,8000000,9843379,23357926.0728113,10472422.7727545,12885503.300056802
2522,Fortress 2,0,11000000,-11000000,0.0,14399581.3125375,-14399581.3125375
2523,An American Tail 4: The Mystery of the Night Monster,0,0,0,0.0,0.0,0.0
2524,Muppets from Space,16290976,24000000,-7709024,21325748.5065997,31417268.318263695,-10091519.811663996
2525,The Straight Story,0,10000000,-10000000,0.0,13090528.465943199,-13090528.465943199
2526,An Ideal Husband,18535191,14000000,4535191,24263544.540719397,18326739.8523205,5936804.688398898
2527,Dak ging san yan lui,0,0,0,0.0,0.0,0.0
2528,Jakob the Liar,0,0,0,0.0,0.0,0.0
2529,Deuce Bigalow: Male Gigolo,65535067,17000000,48535067,85788866.0080996,22253898.3921034,63534967.6159962
2530,The Jack Bull,0,0,0,0.0,0.0,0.0
2531,Idle Hands,4152230,25000000,-20847770,5435488.50121434,32726321.164858002,-27290832.663643662
2532,Any Given Sunday,100230832,55000000,45230832,131207455.946117,71997906.56268771,59209549.38342929
2533,The Deep End of the Ocean,28121100,38000000,-9878900,36812006.0043636,49744008.1705842,-12932002.166220605
2534,Inferno,0,15000000,-15000000,0.0,19635792.6989148,-19635792.6989148
2535,Human Traffic,4000000,600000,3400000,5236211.38637729,785431.707956593,4450779.678420696
2536,In Too Deep,14011454,7000000,7011454,18341733.7436254,9163369.92616025,9178363.817465149
2537,Bowfinger,0,55000000,-55000000,0.0,71997906.56268771,-71997906.56268771
2538,Teaching Mrs. Tingle,8946237,13000000,-4053763,11711097.0111574,17017687.0057261,-5306589.994568698
2539,Holy Smoke,0,0,0,0.0,0.0,0.0
2540,Summer of Sam,0,0,0,0.0,0.0,0.0
2541,Varsity Blues,0,0,0,0.0,0.0,0.0
2542,Rogue Trader,0,0,0,0.0,0.0,0.0
2543,Wing Commander,0,30000000,-30000000,0.0,39271585.3978296,-39271585.3978296
2544,The War Zone,0,0,0,0.0,0.0,0.0
2545,But I'm a Cheerleader,0,0,0,0.0,0.0,0.0
2546,At First Sight,0,0,0,0.0,0.0,0.0
2547,Superstar,0,0,0,0.0,0.0,0.0
2548,True Crime,0,0,0,0.0,0.0,0.0
2549,Pirates of Silicon Valley,0,0,0,0.0,0.0,0.0
2550,Drop Dead Gorgeous,10571408,10000000,571408,13838531.7349099,13090528.465943199,748003.2689667009
2551,Sweet and Lowdown,0,0,0,0.0,0.0,0.0
2552,Snow Falling on Cedars,0,0,0,0.0,0.0,0.0
2553,The Best Man,34573780,9000000,25573780,45258905.1265258,11781475.6193489,33477429.5071769
2554,Simply Irresistible,4398989,6000000,-1601011,5758509.07258711,7854317.07956593,-2095808.00697882
2555,Music of the Heart,14859394,27000000,-12140606,19451732.0143665,35344426.8580467,-15892694.843680203
2556,Bartok the Magnificent,0,0,0,0.0,0.0,0.0
2557,Two Hands,0,0,0,0.0,0.0,0.0
2558,Buena Vista Social Club,0,0,0,0.0,0.0,0.0
2559,For Love of the Game,0,50000000,-50000000,0.0,65452642.3297161,-65452642.3297161
2560,"Mystery, Alaska",8888143,28000000,-19111857,11635048.8950874,36653479.704641,-25018430.8095536
2561,The Mod Squad,13260050,50000000,-36739950,17358106.198482998,65452642.3297161,-48094536.1312331
2562,Alice in Wonderland,0,21000000,-21000000,0.0,27490109.7784807,-27490109.7784807
2563,The Wood,25059640,6000000,19059640,32804393.0766289,7854317.07956593,24950075.99706297
2564,Mansfield Park,0,0,0,0.0,0.0,0.0
2565,200 Cigarettes,6852450,6000000,852450,8970219.17864526,7854317.07956593,1115902.0990793305
2566,Ravenous,0,12000000,-12000000,0.0,15708634.159131799,-15708634.159131799
2567,The Out-of-Towners,29000000,75000000,-46000000,37962532.551235296,98178963.4945741,-60216430.943338804
2568,Cookie's Fortune,0,10000000,-10000000,0.0,13090528.465943199,-13090528.465943199
2569,American Movie,0,0,0,0.0,0.0,0.0
2570,Eye of the Beholder,0,15000000,-15000000,0.0,19635792.6989148,-19635792.6989148
2571,Joan of Arc,66976317,60000000,6976317,87675538.4232537,78543170.7956593,9132367.627594396
2572,The Other Sister,0,35000000,-35000000,0.0,45816849.6308012,-45816849.6308012
2573,Don't Look Under the Bed,0,0,0,0.0,0.0,0.0
2574,Smart House,0,0,0,0.0,0.0,0.0
2575,The Devil's Arithmetic,0,0,0,0.0,0.0,0.0
2576,Beowulf,1531251,20000000,-18468749,2004488.4804003998,26181056.931886397,-24176568.451486
2577,Play It to the Bone,8434146,24000000,-15565854,11040742.829892099,31417268.318263695,-20376525.488371596
2578,Animal Farm,0,23000000,-23000000,0.0,30108215.4716694,-30108215.4716694
2579,The Magical Legend of the Leprechauns,0,0,0,0.0,0.0,0.0
2580,"Happy, Texas",1943649,1700000,243649,2544339.2562302,2225389.83921034,318949.41701986035
2581,Journey to the Center of the Earth,0,0,0,0.0,0.0,0.0
2582,Eddie Izzard: Dress to Kill,0,0,0,0.0,0.0,0.0
2583,Mumford,0,0,0,0.0,0.0,0.0
2584,Ride with the Devil,635096,38000000,-37364904,831374.226660667,49744008.1705842,-48912633.94392353
2585,Better Than Chocolate,0,0,0,0.0,0.0,0.0
2586,Jawbreaker,3076820,3000000,76820,4027719.97945834,3927158.53978296,100561.43967538001
2587,Bats,0,0,0,0.0,0.0,0.0
2588,Topsy-Turvy,0,0,0,0.0,0.0,0.0
2589,Dick,27500000,13000000,14500000,35998953.281343795,17017687.0057261,18981266.275617696
2590,Flawless,4488529,0,4488529,5875721.66447116,0.0,5875721.66447116
2591,The King and I,12000000,25000000,-13000000,15708634.159131799,32726321.164858002,-17017687.005726203
2592,Babylon 5: A Call to Arms,0,0,0,0.0,0.0,0.0
2593,A Walk on the Moon,0,14000000,-14000000,0.0,18326739.8523205,-18326739.8523205
2594,Resurrection,0,10000000,-10000000,0.0,13090528.465943199,-13090528.465943199
2595,Terror Firmer,0,0,0,0.0,0.0,0.0
2596,Outside Providence,7292175,7000000,292175,9545842.44161395,9163369.92616025,382472.5154537
2597,Passport to Paris,0,0,0,0.0,0.0,0.0
2598,Hum Dil De Chuke Sanam,0,0,0,0.0,0.0,0.0
2599,Children of the Corn 666: Isaac's Return,0,0,0,0.0,0.0,0.0
2600,Breakfast of Champions,0,12000000,-12000000,0.0,15708634.159131799,-15708634.159131799
2601,In Dreams,0,0,0,0.0,0.0,0.0
2602,Body Shots,239894,0,239894,314033.92358089803,0.0,314033.92358089803
2603,Rang-e khoda,0,0,0,0.0,0.0,0.0
2604,Blackadder Back & Forth,0,4250000,-4250000,0.0,5563474.59802587,-5563474.59802587
2605,Wishmaster 2: Evil Never Dies,0,2500000,-2500000,0.0,3272632.1164857997,-3272632.1164857997
2606,Dudley Do-Right,0,70000000,-70000000,0.0,91633699.2616025,-91633699.2616025
2607,Doug's 1st Movie,0,0,0,0.0,0.0,0.0
2608,Ratcatcher,0,0,0,0.0,0.0,0.0
2609,Chris Rock: Bigger & Blacker,0,0,0,0.0,0.0,0.0
2610,Trick,2049595,450000,1599595,2683028.16911549,589073.780967445,2093954.3881480447
2611,Baby Geniuses,36450736,12000000,24450736,47715939.7212581,15708634.159131799,32007305.562126298
2612,Komodo,0,0,0,0.0,0.0,0.0
2613,Plunkett & MacLeane,0,0,0,0.0,0.0,0.0
2614,David Copperfield,0,0,0,0.0,0.0,0.0
2615,Batman Beyond: The Movie,0,0,0,0.0,0.0,0.0
2616,The Thirteenth Year,0,0,0,0.0,0.0,0.0
2617,East Is East,28200000,3800000,24400000,36915290.27395979,4974400.81705842,31940889.45690137
2618,Lost & Found,100,1,99,130.905284659432,1.30905284659432,129.5962318128377
2619,Walking with Dinosaurs,0,9210000,-9210000,0.0,12056376.717133699,-12056376.717133699
2620,Johnny Tsunami,0,0,0,0.0,0.0,0.0
2621,Switching Goals,0,0,0,0.0,0.0,0.0
2622,Bad ma ra khahad bord,0,0,0,0.0,0.0,0.0
2623,Guest House Paradiso,0,0,0,0.0,0.0,0.0
2624,Tea with Mussolini,21001563,12000000,9001563,27492155.82808,15708634.159131799,11783521.6689482
2625,"Sabrina, Down Under",0,0,0,0.0,0.0,0.0
2626,George Carlin: You Are All Diseased,0,0,0,0.0,0.0,0.0
2627,Come te nessuno mai,0,0,0,0.0,0.0,0.0
2628,æˆé¾çš„ç‰¹æŠ€,0,0,0,0.0,0.0,0.0
2629,Scooby-Doo! and the Witch's Ghost,0,0,0,0.0,0.0,0.0
2630,Storm of the Century,0,0,0,0.0,0.0,0.0
2631,Mulholland Dr.,0,0,0,0.0,0.0,0.0
2632,Sarfarosh,0,0,0,0.0,0.0,0.0
2633,The Lord of the Rings: The Fellowship of the Ring,871368364,93000000,778368364,1073079785.52895,114528394.85252701,958551390.676423
2634,Harry Potter and the Philosopher's Stone,976475550,125000000,851475550,1202518036.06708,153936014.58673,1048582021.48035
2635,Mulholland Drive,20117339,15000000,5117339,24774263.918001603,18472321.750407603,6301942.167594001
2636,Donnie Darko,1270522,6000000,-4729478,1564632.74499809,7388928.70016306,-5824295.95516497
2637,"Monsters, Inc.",562816256,115000000,447816256,693101531.1461201,141621133.419792,551480397.7263281
2638,A.I. Artificial Intelligence,235926552,100000000,135926552,290540745.200552,123148811.669384,167391933.53116798
2639,Shrek,484409218,60000000,424409218,596544195.5839571,73889287.00163059,522654908.5823265
2640,Bridget Jones's Diary,281929795,25000000,256929795,347193192.284431,30787202.917346,316405989.367085
2641,Ocean's Eleven,450717150,85000000,365717150,555052814.215116,104676489.918976,450376324.29614
2642,Pearl Harbor,449220945,140000000,309220945,553210255.537478,172408336.337138,380801919.20034
2643,The Mummy Returns,433013274,98000000,335013274,533250701.30169505,120685835.435996,412564865.86569905
2644,Atlantis: The Lost Empire,186053725,120000000,66053725,229122951.40412402,147778574.003261,81344377.40086302
2645,Lara Croft: Tomb Raider,274703340,115000000,159703340,338293898.826108,141621133.419792,196672765.40631598
2646,A Beautiful Mind,313542341,60000000,253542341,386123667.021868,73889287.00163059,312234380.0202374
2647,American Pie 2,287553595,30000000,257553595,354118835.15509397,36944643.500815295,317174191.6542787
2648,The Princess Diaries,165335153,37000000,128335153,203608276.191258,45565060.31767221,158043215.87358582
2649,Moulin Rouge!,179213434,52500000,126713434,220699214.322896,64653126.12642671,156046088.1964693
2650,Planet of the Apes,362211740,100000000,262211740,446059453.53699994,123148811.669384,322910641.86761594
2651,The Royal Tenenbaums,71441250,21000000,50441250,87979050.416754,25861250.4505707,62117799.966183305
2652,Blow,83282296,53000000,30282296,102561157.85497901,65268870.184773706,37292287.6702053
2653,Enemy at the Gates,96976270,70000000,26976270,119425124.106293,86204168.168569,33220955.937723994
2654,Black Hawk Down,172989651,92000000,80989651,213034699.517515,113296906.735833,99737792.781682
2655,Legally Blonde,141774679,18000000,123774679,174593832.436584,22166786.100489102,152427046.3360949
2656,A Knight's Tale,117487473,65000000,52487473,144684426.859888,80046727.58509979,64637699.2747882
2657,Zoolander,60780981,28000000,32780981,74851055.8224943,34481667.2674276,40369388.5550667
2658,Not Another Teen Movie,66468332,16000000,50468332,81854960.99446109,19703809.867101397,62151151.12735969
2659,Scary Movie 2,141220678,45000000,96220678,173911586.788447,55416965.2512229,118494621.53722408
2660,Rush Hour 2,347325802,90000000,257325802,427727597.784158,110833930.502445,316893667.281713
2661,Training Day,104876233,45000000,59876233,129153834.663114,55416965.2512229,73736869.4118911
2662,The Others,209947037,17000000,192947037,258547281.20058197,20935297.9837953,237611983.21678668
2663,Jimmy Neutron: Boy Genius,80936232,25000000,55936232,99672007.917976,30787202.917346,68884805.00063
2664,Jay and Silent Bob Strike Back,33788161,22000000,11788161,41609718.7564383,27092738.567264497,14516980.189173803
2665,Serendipity,77516304,28000000,49516304,95460407.2260274,34481667.2674276,60978739.9585998
2666,Cats & Dogs,93375151,60000000,33375151,114990388.85099299,73889287.00163059,41101101.8493624
2667,Vanilla Sky,203388341,68000000,135388341,250470325.015575,83741191.9351813,166729133.08039367
2668,Mike's New Car,0,0,0,0.0,0.0,0.0
2669,Kiss of the Dragon,64437847,25000000,39437847,79354442.845836,30787202.917346,48567239.92849
2670,Spy Game,143049560,92000000,51049560,176163833.238282,113296906.735833,62866926.50244899
2671,Swordfish,147080413,102000000,45080413,181127780.807922,125611787.902772,55515992.90515001
2672,Shallow Hal,141069860,40000000,101069860,173725856.213664,49259524.667753704,124466331.5459103
2673,Barbie in the Nutcracker,0,0,0,0.0,0.0,0.0
2674,Lady and the Tramp II: Scamp's Adventure,0,0,0,0.0,0.0,0.0
2675,AntiTrust,17833000,30000000,-12167000,21961127.5850013,36944643.500815295,-14983515.915813994
2676,Final Fantasy: The Spirits Within,85131830,137000000,-51868170,104838836.9974,168713871.98705602,-63875034.989656016
2677,Waking Life,3176880,0,3176880,3912289.96816233,0.0,3912289.96816233
2678,Original Sin,35402320,42000000,-6597680,43597536.3833927,51722500.9011414,-8124964.517748699
2679,Dr. Dolittle 2,176104344,70000000,106104344,216870406.934164,86204168.168569,130666238.76559499
2680,Behind Enemy Lines,91753202,40000000,51753202,112992977.931609,49259524.667753704,63733453.2638553
2681,Jeepers Creepers,59217789,10000000,49217789,72926003.45038341,12314881.1669384,60611122.28344501
2682,Kate & Leopold,0,0,0,0.0,0.0,0.0
2683,America's Sweethearts,0,0,0,0.0,0.0,0.0
2684,From Hell,74558115,35000000,39558115,91817432.625593,43102084.0842845,48715348.54130851
2685,The Last Castle,27642707,72000000,-44357293,34041665.1837497,88667144.4019567,-54625479.21820701
2686,Along Came a Spider,105178561,60000000,45178561,129526148.002458,73889287.00163059,55636861.00082742
2687,Super Troopers,18492362,3000000,15492362,22773124.0526008,3694464.35008153,19078659.70251927
2688,The Wedding Planner,94728529,35000000,59728529,116657057.77538799,43102084.0842845,73554973.69110349
2689,Rat Race,85498534,48000000,37498534,105290428.615744,59111429.6013044,46178999.0144396
2690,Gosford Park,87754044,19800000,67954044,108068062.377828,24383464.7105381,83684597.6672899
2691,Jason X,16000000,11000000,5000000,19703809.867101397,13546369.283632198,6157440.583469199
2692,The Mexican,147845033,57000000,90845033,182069401.251709,70194822.651549,111874578.60016002
2693,Joy Ride,36642838,23000000,13642838,45125219.5589376,28324226.6839584,16800992.8749792
2694,I Am Sam,40270895,22000000,18270895,49593128.6411255,27092738.567264497,22500390.073861003
2695,The Hole,0,0,0,0.0,0.0,0.0
2696,Replicant,0,17000000,-17000000,0.0,20935297.9837953,-20935297.9837953
2697,Tremors 3: Back to Perfection,0,0,0,0.0,0.0,0.0
2698,One Night at McCool's,0,0,0,0.0,0.0,0.0
2699,Rock Star,16991902,57000000,-40008098,20925325.3930263,70194822.651549,-49269497.2585227
2700,Mickey's House of Villains,0,0,0,0.0,0.0,0.0
2701,K-PAX,50315140,48000000,2315140,61962496.999787,59111429.6013044,2851067.398482606
2702,Someone Like You...,0,23000000,-23000000,0.0,28324226.6839584,-28324226.6839584
2703,Blow Dry,637769,0,637769,785404.944695715,0.0,785404.944695715
2704,Don't Say a Word,100020092,50000000,50020092,123173554.728624,61574405.834692106,61599148.893931895
2705,Thir13en Ghosts,0,0,0,0.0,0.0,0.0
2706,Crocodile Dundee in Los Angeles,39438674,21150000,18288674,48568258.369162396,26045973.668074697,22522284.7010877
2707,Frailty,13110448,11000000,2110448,16145360.916532502,13546369.283632198,2598991.632900303
2708,Mickey's Magical Christmas: Snowed in at the House of Mouse,0,0,0,0.0,0.0,0.0
2709,Angel Eyes,29700000,53000000,-23300000,36575197.065807104,65268870.184773706,-28693673.1189666
2710,Life as a House,0,18000000,-18000000,0.0,22166786.100489102,-22166786.100489102
2711,The Shipping News,0,0,0,0.0,0.0,0.0
2712,Hearts in Atlantis,24185781,31000000,-6814219,29784501.8944597,38176131.6175091,-8391629.723049399
2713,Ghost World,0,0,0,0.0,0.0,0.0
2714,The Glass House,23619609,30000000,-6380391,29087267.8044549,36944643.500815295,-7857375.696360394
2715,15 Minutes,56359980,60000000,-3640020,69406645.6271026,73889287.00163059,-4482641.374527991
2716,O,16017403,0,16017403,19725241.454796303,0.0,19725241.454796303
2717,Hardball,40222729,32000000,8222729,49533812.7844968,39407619.7342029,10126193.0502939
2718,Evolution,98376292,80000000,18376292,121149234.56240301,98519049.33550741,22630185.2268956
2719,Get Over It,0,10000000,-10000000,0.0,12314881.1669384,-12314881.1669384
2720,Heartbreakers,0,35000000,-35000000,0.0,43102084.0842845,-43102084.0842845
2721,Ali,87713825,107000000,-19286175,108018533.157263,131769228.486241,-23750695.328978002
2722,Band of Brothers,125000000,0,125000000,153936014.58673,0.0,153936014.58673
2723,Session 9,373967,1500000,-1126033,460535.916535646,1847232.17504076,-1386696.2585051141
2724,The Score,71069884,68000000,3069884,87521717.60080992,83741191.9351813,3780525.665628612
2725,Monster's Ball,44909486,4000000,40909486,55305498.335828505,4925952.46677537,50379545.86905313
2726,Joe Dirt,30987695,17700000,13287695,38160978.15623321,21797339.665481,16363638.490752205
2727,The Land Before Time VIII: The Big Freeze,0,0,0,0.0,0.0,0.0
2728,Exit Wounds,79958599,50000000,29958599,98468064.4959882,61574405.834692106,36893658.6612961
2729,The Tailor of Panama,28008462,21000000,7008462,34492088.119871005,25861250.4505707,8630837.669300307
2730,Sweet November,65754228,40000000,25754228,80975550.4043776,49259524.667753704,31716025.73662389
2731,How High,31155435,12000000,19155435,38367547.9729274,14777857.4003261,23589690.5726013
2732,Down to Earth,0,0,0,0.0,0.0,0.0
2733,Tomcats,23430766,11000000,12430766,28854709.8940341,13546369.283632198,15308340.6104019
2734,Elling,0,0,0,0.0,0.0,0.0
2735,The Majestic,37317558,72000000,-34682442,45956129.2210332,88667144.4019567,-42711015.18092351
2736,3000 Miles to Graceland,18720175,62000000,-43279825,23053673.0549291,76352263.2350183,-53298590.1800892
2737,The Mists of Avalon,0,0,0,0.0,0.0,0.0
2738,Tape,490475,100000,390475,604014.134035412,123148.811669384,480865.322366028
2739,Wishmaster 3: Beyond the Gates of Hell,0,0,0,0.0,0.0,0.0
2740,What's the Worst That Could Happen?,0,45000000,-45000000,0.0,55416965.2512229,-55416965.2512229
2741,Dil Chahta Hai,4099000,2079000,2020000,5047869.79032806,2560263.7946065,2487605.9957215604
2742,Ghosts of Mars,14010832,28000000,-13989168,17254173.112993803,34481667.2674276,-17227494.154433798
2743,Saving Silverman,19351569,22000000,-2648431,23831227.2628809,27092738.567264497,-3261511.3043835983
2744,The Curse of the Jade Scorpion,0,0,0,0.0,0.0,0.0
2745,Riding in Cars with Boys,35743308,48000000,-12256692,44017459.053327896,59111429.6013044,-15093970.547976501
2746,Mimic 2,0,10000000,-10000000,0.0,12314881.1669384,-12314881.1669384
2747,Osmosis Jones,13596911,75000000,-61403089,16744434.320243802,92361608.75203821,-75617174.4317944
2748,The Man Who Wasn't There,0,0,0,0.0,0.0,0.0
2749,The One,0,49000000,-49000000,0.0,60342917.71799829,-60342917.71799829
2750,Buffalo Soldiers,0,15000000,-15000000,0.0,18472321.750407603,-18472321.750407603
2751,Head Over Heels,10424470,14000000,-3575530,12837610.9278314,17240833.6337138,-4403222.7058824
2752,Enigma,15705007,0,15705007,19340529.4930936,0.0,19340529.4930936
2753,The Fast and the Furious,207283925,38000000,169283925,255267690.41915697,46796548.434365995,208471141.98479098
2754,Human Nature,705308,6000000,-5294692,868578.420609101,7388928.70016306,-6520350.279553959
2755,Save the Last Dance,91038276,13000000,78038276,112112555.058294,16009345.517019901,96103209.5412741
2756,The Affair of the Necklace,0,0,0,0.0,0.0,0.0
2757,Bully,480811,0,480811,592113.0328756829,0.0,592113.0328756829
2758,Zebra Lounge,0,0,0,0.0,0.0,0.0
2759,In the Bedroom,0,1700000,-1700000,0.0,2093529.79837953,-2093529.79837953
2760,Spy Kids,147934180,35000000,112934180,182179184.722848,43102084.0842845,139077100.6385635
2761,The Pledge,29400000,35000000,-5600000,36205750.630798995,43102084.0842845,-6896333.453485504
2762,Hedwig and the Angry Inch,0,0,0,0.0,0.0,0.0
2763,Mean Machine,0,0,0,0.0,0.0,0.0
2764,Bandits,67631903,75000000,-7368097,83287884.8538907,92361608.75203821,-9073723.898147509
2765,The Animal,84772742,22000000,62772742,104396624.392553,27092738.567264497,77303885.8252885
2766,Knockaround Guys,12000000,15000000,-3000000,14777857.4003261,18472321.750407603,-3694464.3500815034
2767,The Matrix Revisited,0,0,0,0.0,0.0,0.0
2768,Just Visiting,0,0,0,0.0,0.0,0.0
2769,Crazy/Beautiful,16929123,13000000,3929123,20848013.800548397,16009345.517019901,4838668.283528496
2770,Prozac Nation,0,0,0,0.0,0.0,0.0
2771,Safar e Ghandehar,0,0,0,0.0,0.0,0.0
2772,Driven,54744738,94000000,-39255262,67417494.2985179,115759882.969221,-48342388.6707031
2773,Out Cold,14782676,24000000,-9217324,18204689.8269352,29555714.8006522,-11351024.973717
2774,Intimacy,0,0,0,0.0,0.0,0.0
2775,Citizen Toxie: The Toxic Avenger IV,0,500000,-500000,0.0,615744.058346921,-615744.058346921
2776,Princess of Thieves,0,0,0,0.0,0.0,0.0
2777,American Outlaws,13678913,35000000,-21321087,16845418.8087889,43102084.0842845,-26256665.2754956
2778,Hannibal,351692268,87000000,264692268,433104848.775106,107139466.152364,325965382.622742
2779,Domestic Disturbance,54249294,75000000,-20750706,66807360.900030605,92361608.75203821,-25554247.852007605
2780,The Unsaid,0,0,0,0.0,0.0,0.0
2781,Birthday Girl,0,13000000,-13000000,0.0,16009345.517019901,-16009345.517019901
2782,Recess: School's Out,44460850,10000000,34460850,54753008.4331074,12314881.1669384,42438127.266169
2783,Me Without You,0,0,0,0.0,0.0,0.0
2784,Impostor,0,40000000,-40000000,0.0,49259524.667753704,-49259524.667753704
2785,The Parole Officer,0,0,0,0.0,0.0,0.0
2786,Air Bud 3: World Pup,0,0,0,0.0,0.0,0.0
2787,Lantana,0,0,0,0.0,0.0,0.0
2788,Elvira's Haunted Hills,0,1500000,-1500000,0.0,1847232.17504076,-1847232.17504076
2789,Texas Rangers,0,0,0,0.0,0.0,0.0
2790,Prince Charming,0,0,0,0.0,0.0,0.0
2791,Charlotte Gray,741394,0,741394,913017.900788115,0.0,913017.900788115
2792,Beethoven's 4th,0,0,0,0.0,0.0,0.0
2793,Summer Catch,19693891,34000000,-14306109,24252792.7379638,41870595.9675906,-17617803.2296268
2794,Wet Hot American Summer,295206,5000000,-4704794,363542.68097672204,6157440.58346921,-5793897.902492488
2795,Valentine,0,0,0,0.0,0.0,0.0
2796,Ticker,0,7000000,-7000000,0.0,8620416.8168569,-8620416.8168569
2797,Heist,0,35000000,-35000000,0.0,43102084.0842845,-43102084.0842845
2798,Yamakasi - Les samouraÃ¯s des temps modernes,0,0,0,0.0,0.0,0.0
2799,Jack and the Beanstalk: The Real Story,0,0,0,0.0,0.0,0.0
2800,The Believer,416925,1500000,-1083075,513438.18305258,1847232.17504076,-1333793.9919881802
2801,Max Keeble's Big Move,17292381,12000000,5292381,21295361.710842397,14777857.4003261,6517504.310516298
2802,Monkeybone,5409517,75000000,-69590483,6661755.90255333,92361608.75203821,-85699852.84948488
2803,See Spot Run,0,0,0,0.0,0.0,0.0
2804,Storytelling,0,0,0,0.0,0.0,0.0
2805,Lovely & Amazing,4186931,250000,3936931,5156155.77191707,307872.02917346,4848283.74274361
2806,61*,0,0,0,0.0,0.0,0.0
2807,Attila,0,0,0,0.0,0.0,0.0
2808,Pootie Tang,0,0,0,0.0,0.0,0.0
2809,The Fourth Angel,0,0,0,0.0,0.0,0.0
2810,Corky Romano,23978402,11000000,12978402,29529117.1203078,13546369.283632198,15982747.836675601
2811,Joe Somebody,0,38000000,-38000000,0.0,46796548.434365995,-46796548.434365995
2812,To End All Wars,0,0,0,0.0,0.0,0.0
2813,Snow White,0,0,0,0.0,0.0,0.0
2814,Iris,0,0,0,0.0,0.0,0.0
2815,Uprising,0,0,0,0.0,0.0,0.0
2816,Black Knight,0,0,0,0.0,0.0,0.0
2817,The Man Who Sued God,0,0,0,0.0,0.0,0.0
2818,Wit,0,0,0,0.0,0.0,0.0
2819,Scooby-Doo and the Cyber Chase,0,0,0,0.0,0.0,0.0
2820,Jurassic Park III,368780809,93000000,275780809,454149183.948242,114528394.85252701,339620789.095715
2821,The Grey Zone,0,0,0,0.0,0.0,0.0
2822,Josie and the Pussycats,0,22000000,-22000000,0.0,27092738.567264497,-27092738.567264497
2823,Captain Corelli's Mandolin,62112895,57000000,5112895,76491292.0859524,70194822.651549,6296469.434403405
2824,The Body,0,0,0,0.0,0.0,0.0
2825,The Order,0,0,0,0.0,0.0,0.0
2826,Good Advice,0,0,0,0.0,0.0,0.0
2827,James Dean,0,0,0,0.0,0.0,0.0
2828,Freddy Got Fingered,0,0,0,0.0,0.0,0.0
2829,Epoch,0,0,0,0.0,0.0,0.0
2830,Shrek in the Swamp Karaoke Dance Party,0,0,0,0.0,0.0,0.0
2831,Zenon: The Zequel,0,0,0,0.0,0.0,0.0
2832,Kissing Jessica Stein,10013424,1000000,9013424,12331412.6634169,1231488.11669384,11099924.54672306
2833,Stanley Kubrick: A Life in Pictures,0,0,0,0.0,0.0,0.0
2834,Motocrossed,0,0,0,0.0,0.0,0.0
2835,Le vÃ©lo de Ghislain Lambert,0,0,0,0.0,0.0,0.0
2836,The Musketeer,27053815,40000000,-12946185,33316451.6837336,49259524.667753704,-15943072.984020103
2837,The Cat's Meow,3646994,7000000,-3353006,4491229.77265374,8620416.8168569,-4129187.0442031603
2838,The Forsaken,0,5000000,-5000000,0.0,6157440.58346921,-6157440.58346921
2839,The Lost Battalion,0,0,0,0.0,0.0,0.0
2840,L.I.E. Long Island Expressway,1667192,700000,967192,2053127.13624704,862041.68168569,1191085.45456135
2841,Say It Isn't So,0,25000000,-25000000,0.0,30787202.917346,-30787202.917346
2842,Bubble Boy,0,0,0,0.0,0.0,0.0
2843,The Blue Planet,0,0,0,0.0,0.0,0.0
2844,Conspiracy,0,0,0,0.0,0.0,0.0
2845,Novocaine,2025238,6000000,-3974762,2494056.5304767997,7388928.70016306,-4894872.16968626
2846,Sugar & Spice,13276953,11000000,2276953,16350409.8454026,13546369.283632198,2804040.561770402
2847,Winning London,0,0,0,0.0,0.0,0.0
2848,Rudolph the Red-Nosed Reindeer & the Island of Misfit Toys,0,0,0,0.0,0.0,0.0
2849,Bones,7316658,10000000,-2683342,9010377.38091294,12314881.1669384,-3304503.786025461
2850,Dogtown and Z-Boys,0,0,0,0.0,0.0,0.0
2851,CQ,0,0,0,0.0,0.0,0.0
2852,The Anniversary Party,0,0,0,0.0,0.0,0.0
2853,Vizontele,0,0,0,0.0,0.0,0.0
2854,The Wash,10229331,7000000,3229331,12597299.5682279,8620416.8168569,3976882.751371
2855,Down,163169,15000000,-14836831,200940.68451281698,18472321.750407603,-18271381.065894786
2856,Made,5476060,5000000,476060,6743702.81630248,6157440.58346921,586262.23283327
2857,Soul Survivors,0,0,0,0.0,0.0,0.0
2858,Dagon,0,4800000,-4800000,0.0,5911142.96013044,-5911142.96013044
2859,In the Time of the Butterflies,0,0,0,0.0,0.0,0.0
2860,Halloweentown II: Kalabar's Revenge,0,0,0,0.0,0.0,0.0
2861,Children of the Corn: Revelation,0,0,0,0.0,0.0,0.0
2862,Holiday in the Sun,0,0,0,0.0,0.0,0.0
2863,BelphÃ©gor - Le fantÃ´me du Louvre,0,0,0,0.0,0.0,0.0
2864,Lost and Delirious,0,0,0,0.0,0.0,0.0
2865,Baby Boy,29381649,16000000,13381649,36183151.592369504,19703809.867101397,16479341.725268107
2866,The Lost World,0,0,0,0.0,0.0,0.0
2867,Manic,0,0,0,0.0,0.0,0.0
2868,Chori Chori Chupke Chupke,0,0,0,0.0,0.0,0.0
2869,The Luck of the Irish,0,0,0,0.0,0.0,0.0
2870,Tanguy,0,0,0,0.0,0.0,0.0
2871,Double Take,0,0,0,0.0,0.0,0.0
2872,Rivers and Tides,0,0,0,0.0,0.0,0.0
2873,Little Secrets,0,0,0,0.0,0.0,0.0
2874,Slashers,0,165000,-165000,0.0,203195.53925448397,-203195.53925448397
2875,The Dark Knight,1001921825,185000000,816921825,1014733032.48168,187365527.254695,827367505.226985
2876,WALLÂ·E,521311860,180000000,341311860,527977683.854196,182301594.08565,345676089.768546
2877,Iron Man,585174222,140000000,445174222,592656630.491278,141790128.733283,450866501.757995
2878,Taken,226830568,25000000,201830568,229730967.409741,25319665.8452291,204411301.56451192
2879,Indiana Jones and the Kingdom of the Crystal Skull,786636033,185000000,601636033,796694459.895067,187365527.254695,609328932.640372
2880,Twilight,392616625,37000000,355616625,397636870.011266,37473105.4509392,360163764.5603268
2881,Quantum of Solace,586090727,200000000,386090727,593584854.505097,202557326.761833,391027527.743264
2882,Kung Fu Panda,631744560,130000000,501744560,639822446.349653,131662262.39519098,508160183.95446205
2883,Sex Drive,18755936,19000000,-244064,18995761.285380103,19242946.042374104,-247184.75699400157
2884,Mamma Mia!,609841637,52000000,557841637,617639458.6939019,52664904.9580767,564974553.7358252
2885,The Curious Case of Benjamin Button,333932083,150000000,183932083,338201950.26245296,151917995.071375,186283955.19107795
2886,The Mummy: Tomb of the Dragon Emperor,401128639,145000000,256128639,406257724.017262,146854061.902329,259403662.11493298
2887,The Incredible Hulk,163712074,150000000,13712074,165805400.340377,151917995.071375,13887405.26900199
2888,Gran Torino,269958228,33000000,236958228,273410085.005207,33421958.915702503,239988126.0895045
2889,Madagascar: Escape 2 Africa,603900354,150000000,453900354,611622206.6838241,151917995.071375,459704211.61244905
2890,Hellboy II: The Golden Army,160388063,85000000,75388063,162438886.428942,86086863.8737792,76352022.5551628
2891,Jumper,222231186,85000000,137231186,225072774.79635897,86086863.8737792,138985910.92257977
2892,Journey to the Center of the Earth,101702060,45000000,56702060,103002486.99885699,45575398.5214125,57427088.47744449
2893,Wanted,258270008,75000000,183270008,261572412.016186,75958997.5356875,185613414.4804985
2894,Tinker Bell,0,48000000,-48000000,0.0,48613758.42284,-48613758.42284
2895,Slumdog Millionaire,377910544,15000000,362910544,382742747.738751,15191799.5071375,367550948.2316135
2896,Transporter 3,108979549,30000000,78979549,110373030.585751,30383599.014275,79989431.571476
2897,Valkyrie,200276000,75000000,125276000,202836855.872764,75958997.5356875,126877858.33707649
2898,"10,000 BC",266000000,105000000,161000000,269401244.593238,106342596.549962,163058648.043276
2899,Hancock,624029371,150000000,474029371,632008606.053142,151917995.071375,480090610.98176694
2900,The Hurt Locker,42000000,15000000,27000000,42537038.619985,15191799.5071375,27345239.1128475
2901,What Happens in Vegas,170000000,35000000,135000000,172173727.747558,35447532.1833208,136726195.5642372
2902,The Chronicles of Narnia: Prince Caspian,419651413,225000000,194651413,425017341.94553,227876992.607062,197140349.338468
2903,Tropic Thunder,188072649,92000000,96072649,190477465.092283,93176370.3104434,97301094.78183961
2904,Eagle Eye,178066569,80000000,98066569,180343441.011457,81022930.70473342,99320510.30672358
2905,The Boy in the Striped Pyjamas,20416563,12500000,7916563,20677622.1147228,12659832.9226145,8017789.1921083
2906,Rambo,113244290,50000000,63244290,114692303.26720901,50639331.6904583,64052971.57675071
2907,Death Race,73762516,45000000,28762516,74705690.2809348,45575398.5214125,29130291.759522296
2908,Step Up 2: The Streets,150816700,23000000,127816700,152745137.915207,23294092.577610802,129451045.3375962
2909,The Day the Earth Stood Still,233093859,80000000,153093859,236074344.818198,81022930.70473342,155051414.1134646
2910,Starship Troopers 3: Marauder,0,9000000,-9000000,0.0,9115079.7042825,-9115079.7042825
2911,Seven Pounds,168167691,55000000,113167691,170317989.68335,55703264.8595042,114614724.8238458
2912,Cloverfield,170764026,25000000,145764026,172947523.068241,25319665.8452291,147627857.2230119
2913,Bolt,309979994,150000000,159979994,313943594.671445,151917995.071375,162025599.60007
2914,Forgetting Sarah Marshall,105173115,30000000,75173115,106517925.108074,30383599.014275,76134326.093799
2915,Australia,49554002,130000000,-80445998,50187630.87735271,131662262.39519098,-81474631.51783827
2916,Yes Man,225990978,70000000,155990978,228880641.879861,70895064.3666417,157985577.5132193
2917,Marley & Me,244082376,60000000,184082376,247203367.961183,60767198.02855,186436169.932633
2918,Body of Lies,113280098,70000000,43280098,114728569.130992,70895064.3666417,43833504.764350295
2919,Burn After Reading,163720069,37000000,126720069,165813497.56951398,37473105.4509392,128340392.11857477
2920,27 Dresses,160259319,30000000,130259319,162308496.226559,30383599.014275,131924897.21228401
2921,Inkheart,57490374,60000000,-2509626,58225482.35989,60767198.02855,-2541715.66866
2922,21,69823199,35000000,34823199,70716002.6769976,35447532.1833208,35268470.493676804
2923,The Bank Job,64822796,20000000,44822796,65651661.35493829,20255732.676183302,45395928.678754985
2924,Step Brothers,128107642,65000000,63107642,129745707.506409,65831131.1975958,63914576.30881321
2925,"Definitely, Maybe",55447968,0,55447968,56156960.862278394,0.0,56156960.862278394
2926,Fool's Gold,111231041,70000000,41231041,112653311.589479,70895064.3666417,41758247.2228373
2927,Never Back Down,41627431,20000000,21627431,42159705.7166133,20255732.676183302,21903973.04043
2928,Pineapple Express,101624843,27000000,74624843,102924282.653355,27345239.1128475,75579043.5405075
2929,The Wrestler,44703995,6000000,38703995,45275608.6138718,6076719.802855,39198888.8110168
2930,Bedtime Stories,212874442,80000000,132874442,215596389.537184,81022930.70473342,134573458.83245057
2931,Punisher: War Zone,10089373,20500000,-10410627,10218382.1179151,20762125.9930879,-10543743.8751728
2932,Max Payne,85416905,35000000,50416905,86509099.68534741,35447532.1833208,51061567.50202661
2933,Mirrors,72436439,35000000,37436439,73362657.2199331,35447532.1833208,37915125.036612295
2934,Vantage Point,151161491,40000000,111161491,153094337.63146397,40511465.35236671,112582872.27909726
2935,Zack and Miri Make a Porno,42105111,24000000,18105111,42643493.635851294,24306879.21142,18336614.424431294
2936,Get Smart,230685453,80000000,150685453,233635143.41261202,81022930.70473342,152612212.7078786
2937,Role Models,92380927,28000000,64380927,93562168.0845004,28358025.746656604,65204142.3378438
2938,The Scorpion King: Rise of a Warrior,0,0,0,0.0,0.0,0.0
2939,Frost/Nixon,0,0,0,0.0,0.0,0.0
2940,High School Musical 3: Senior Year,0,0,0,0.0,0.0,0.0
2941,The Reader,0,32000000,-32000000,0.0,32409172.281893298,-32409172.281893298
2942,Babylon A.D.,72108608,70000000,2108608,73030634.3649848,70895064.3666417,2135569.998343095
2943,Diario de una ninfÃ³mana,0,0,0,0.0,0.0,0.0
2944,In Bruges,32002538,15000000,17002538,32411742.734369896,15191799.5071375,17219943.227232397
2945,Changeling,113020255,55000000,58020255,114465403.613703,55703264.8595042,58762138.7541988
2946,The Spiderwick Chronicles,162839667,90000000,72839667,164921838.191535,91150797.042825,73771041.14871
2947,Harold & Kumar Escape from Guantanamo Bay,43493123,12000000,31493123,44049253.637018,12153439.60571,31895814.031308003
2948,The Accidental Husband,22707064,0,22707064,22997410.9122493,0.0,22997410.9122493
2949,Wild Child,0,0,0,0.0,0.0,0.0
2950,Felon,0,2900000,-2900000,0.0,2937081.23804658,-2937081.23804658
2951,Snow Buddies,0,0,0,0.0,0.0,0.0
2952,Kung Fu Panda: Secrets of the Furious Five,0,0,0,0.0,0.0,0.0
2953,Street Kings,65569869,20000000,45569869,66408286.903818004,20255732.676183302,46152554.2276347
2954,Nick and Norah's Infinite Playlist,32973937,9000000,23973937,33395562.657665502,9115079.7042825,24280482.953383002
2955,Four Christmases,163733697,80000000,83733697,165827299.82576,81022930.70473342,84804369.12102659
2956,Another Cinderella Story,0,5000000,-5000000,0.0,5063933.16904583,-5063933.16904583
2957,Stargate: The Ark of Truth,8900000,7000000,1900000,9013801.04090159,7089506.43666417,1924294.6042374205
2958,The House Bunny,70442940,25000000,45442940,71343668.0782211,25319665.8452291,46024002.23299199
2959,Presto,0,0,0,0.0,0.0,0.0
2960,Star Wars: The Clone Wars,68282844,8500000,59782844,69155951.7216765,8608686.38737792,60547265.33429858
2961,Saw V,113857533,10800000,103057533,115313387.580886,10938095.645139,104375291.93574701
2962,The Love Guru,41819064,62000000,-20180936,42353789.0576101,62792771.2961683,-20438982.238558196
2963,Speed Racer,93945766,120000000,-26054234,95147016.10776371,121534396.0571,-26387379.94933629
2964,Vicky Cristina Barcelona,96408652,15000000,81408652,97641394.1291594,15191799.5071375,82449594.62202191
2965,Horton Hears a Who!,297138014,85000000,212138014,300937408.975801,86086863.8737792,214850545.1020218
2966,The Duchess,0,0,0,0.0,0.0,0.0
2967,Happy-Go-Lucky,18130888,0,18130888,18362721.025491,0.0,18362721.025491
2968,The Forbidden Kingdom,127906624,55000000,72906624,129542119.162854,55703264.8595042,73838854.3033498
2969,Che: Part One,0,30000000,-30000000,0.0,30383599.014275,-30383599.014275
2970,BURNâ€¢E,0,0,0,0.0,0.0,0.0
2971,Righteous Kill,73174566,60000000,13174566,74110222.37958671,60767198.02855,13343024.351036713
2972,Transsiberian,5926410,15000000,-9073590,6002188.83447298,15191799.5071375,-9189610.67266452
2973,Traitor,23530831,22000000,1530831,23831711.1192224,22281305.9438016,1550405.1754207984
2974,You Don't Mess With the Zohan,201596308,90000000,111596308,204174046.167676,91150797.042825,113023249.124851
2975,Defiance,51155219,32000000,19155219,51809322.0527807,32409172.281893298,19400149.770887405
2976,Management,2434658,0,2434658,2465789.08029656,0.0,2465789.08029656
2977,Untraceable,32483410,35000000,-2516590,32898763.468543,35447532.1833208,-2548768.7147777975
2978,The Good Witch,0,0,0,0.0,0.0,0.0
2979,LOL (Laughing Out Loud),0,0,0,0.0,0.0,0.0
2980,The Strangers,82391145,9000000,73391145,83444650.400233,9115079.7042825,74329570.69595051
2981,Stargate: Continuum,0,7000000,-7000000,0.0,7089506.43666417,-7089506.43666417
2982,Milk,54586584,20000000,34586584,55284562.660501294,20255732.676183302,35028829.98431799
2983,Outlander,7033683,50000000,-42966317,7123620.12885076,50639331.6904583,-43515711.56160754
2984,The X Files: I Want to Believe,68369434,30000000,38369434,69243648.916298,30383599.014275,38860049.902023
2985,Doubt,50907234,20000000,30907234,51558166.1593956,20255732.676183302,31302433.483212296
2986,Rachel Getting Married,0,0,0,0.0,0.0,0.0
2987,A Matter of Loaf and Death,0,0,0,0.0,0.0,0.0
2988,City of Ember,17869048,55000000,-37130952,18097532.973294396,55703264.8595042,-37605731.8862098
2989,Made of Honor,84601681,40000000,44601681,85683451.714587,40511465.35236671,45171986.362220295
2990,The Other Boleyn Girl,0,35000000,-35000000,0.0,35447532.1833208,-35447532.1833208
2991,The Lazarus Project,558000,0,558000,565134.941665515,0.0,565134.941665515
2992,Deception,17741298,25000000,-7258702,17968149.4808253,25319665.8452291,-7351516.364403799
2993,RockNRolla,25739015,18000000,7739015,26068130.3594136,18230159.408565,7837970.950848602
2994,The Eye,56309766,12000000,44309766,57029778.3577219,12153439.60571,44876338.7520119
2995,Elegy,14894347,13000000,1894347,15084795.5609156,13166226.239519099,1918569.3213965017
2996,Bangkok Dangerous,42487390,45000000,-2512610,43030660.697437204,45575398.5214125,-2544737.823975295
2997,Meet the Spartans,84646831,30000000,54646831,85729179.0311034,30383599.014275,55345580.0168284
2998,Stop-Loss,11207130,25000000,-13792870,11350431.4673617,25319665.8452291,-13969234.3778674
2999,Drillbit Taylor,0,40000000,-40000000,0.0,40511465.35236671,-40511465.35236671
3000,"Synecdoche, New York",0,21000000,-21000000,0.0,21268519.3099925,-21268519.3099925
3001,My Sassy Girl,0,0,0,0.0,0.0,0.0
3002,Blindness,19844979,25000000,-5155021,20098729.4794236,25319665.8452291,-5220936.365805499
3003,The Spirit,39031337,60000000,-20968663,39530416.4133012,60767198.02855,-21236781.6152488
3004,Sleepwalking,204660,0,204660,207276.912475384,0.0,207276.912475384
3005,Nothing But the Truth,186702,11500000,-11313298,189089.290105439,11647046.288805401,-11457956.998699961
3006,Eden Lake,3983997,0,3983997,4034938.91073582,0.0,4034938.91073582
3007,Appaloosa,20211394,20000000,211394,20469829.6938508,20255732.676183302,214097.01766749844
3008,The Informers,382174,18000000,-17617826,387060.718989384,18230159.408565,-17843098.689575616
3009,The Happening,163403799,60000000,103403799,165493183.540839,60767198.02855,104725985.51228899
3010,Doomsday,22211426,30000000,-7788574,22495435.370641395,30383599.014275,-7888163.643633604
3011,The Secret of Moonacre,7070330,12000000,-4929670,7160735.72061997,12153439.60571,-4992703.88509003
3012,Joy Ride 2: Dead Ahead,0,5000000,-5000000,0.0,5063933.16904583,-5063933.16904583
3013,Bronson,0,0,0,0.0,0.0,0.0
3014,Vals Im Bashir,11125849,2000000,9125849,11268111.156979,2025573.26761833,9242537.88936067
3015,Max Manus,0,8,-8,0.0,8.102293070473339,-8.102293070473339
3016,Dr. Dolittle: Tail to the Chief,0,0,0,0.0,0.0,0.0
3017,Sex and the City,415252786,65000000,350252786,420562471.312818,65831131.1975958,354731340.1152222
3018,The Rocker,8762890,15000000,-6237110,8874937.86554001,15191799.5071375,-6316861.641597489
3019,Barbie Mariposa and Her Butterfly Fairy Friends,0,0,0,0.0,0.0,0.0
3020,The Tale of Despereaux,50877145,60000000,-9122855,51527692.422370896,60767198.02855,-9239505.606179103
3021,Zombie Strippers!,0,0,0,0.0,0.0,0.0
3022,Niko: LentÃ¤jÃ¤n poika,0,6100000,-6100000,0.0,6177998.46623592,-6177998.46623592
3023,Superhero Movie,25871834,35000000,-9128166,26202647.6673295,35447532.1833208,-9244884.515991297
3024,The Secret Life of Bees,38105395,11000000,27105395,38592634.732018605,11140652.9719008,27451981.760117806
3025,100 Feet,0,10000000,-10000000,0.0,10127866.3380916,-10127866.3380916
3026,The Other Man,1143856,15000000,-13856144,1158482.06780241,15191799.5071375,-14033317.43933509
3027,Beverly Hills Chihuahua,149281606,20000000,129281606,151190415.230366,20255732.676183302,130934682.5541827
3028,The Burning Plain,0,20000000,-20000000,0.0,20255732.676183302,-20255732.676183302
3029,Revolutionary Road,75225693,35000000,40225693,76187576.3894318,35447532.1833208,40740044.20611101
3030,Be Kind Rewind,0,0,0,0.0,0.0,0.0
3031,Sunshine Cleaning,16174377,5000000,11174377,16381192.8357904,5063933.16904583,11317259.66674457
3032,Futurama: The Beast with a Billion Backs,0,0,0,0.0,0.0,0.0
3033,The Andromeda Strain,0,0,0,0.0,0.0,0.0
3034,The Ruins,0,8000000,-8000000,0.0,8102293.07047334,-8102293.07047334
3035,Camp Rock,0,0,0,0.0,0.0,0.0
3036,Ghost Town,0,0,0,0.0,0.0,0.0
3037,Hunger,2724474,0,2724474,2759310.85136059,0.0,2759310.85136059
3038,Fifty Dead Men Walking,0,0,0,0.0,0.0,0.0
3039,Dead Space: Downfall,0,0,0,0.0,0.0,0.0
3040,The Art of War II: Betrayal,0,0,0,0.0,0.0,0.0
3041,Futurama: Bender's Game,0,0,0,0.0,0.0,0.0
3042,Ong Bak 2,8936663,8500000,436663,9050932.83725693,8608686.38737792,442246.44987901114
3043,Miss Pettigrew Lives for a Day,16051363,0,16051363,16256605.900819,0.0,16256605.900819
3044,Pride and Glory,31148328,30000000,1148328,31546610.263903804,30383599.014275,1163011.2496288046
3045,Splinter,124191,0,124191,125778.984839394,0.0,125778.984839394
3046,Robot Chicken: Star Wars Episode II,0,0,0,0.0,0.0,0.0
3047,"Surfer, Dude",69497,6000000,-5930503,70385.63268983571,6076719.802855,-6006334.170165164
3048,Baby Mama,63833449,30000000,33833449,64649663.9371391,30383599.014275,34266064.9228641
3049,The Colour of Magic,0,0,0,0.0,0.0,0.0
3050,College,6230276,7000000,-769724,6309940.25774204,7089506.43666417,-779566.1789221298
3051,The Stoning of Soraya M.,0,0,0,0.0,0.0,0.0
3052,Fireflies in the Garden,0,0,0,0.0,0.0,0.0
3053,Brideshead Revisited,13204291,20000000,-6795709,13373129.4337266,20255732.676183302,-6882603.2424567025
3054,Shutter,0,0,0,0.0,0.0,0.0
3055,College Road Trip,68397662,0,68397662,69272237.8573972,0.0,69272237.8573972
3056,The Brothers Bloom,5530764,20000000,-14469236,5601483.85395292,20255732.676183302,-14654248.822230382
3057,Meet Dave,50650079,60000000,-9349921,51297723.0125784,60767198.02855,-9469475.015971601
3058,War Games: The Dead Code,0,0,0,0.0,0.0,0.0
3059,Quarantine,40855419,12000000,28855419,41377822.2818731,12153439.60571,29224382.6761631
3060,Chaos Theory,240476,0,240476,243550.878551893,0.0,243550.878551893
3061,Justice League: The New Frontier,5231128,3500000,1731128,5298016.51814488,3544753.21833208,1753263.2998128003
3062,Pathology,0,8000000,-8000000,0.0,8102293.07047334,-8102293.07047334
3063,One Missed Call,0,20000000,-20000000,0.0,20255732.676183302,-20255732.676183302
3064,Deadgirl,0,0,0,0.0,0.0,0.0
3065,"Angus, Thongs and Perfect Snogging",0,1,-1,0.0,1.01278663380916,-1.01278663380916
3066,Towelhead,367638,0,367638,372338.852480334,0.0,372338.852480334
3067,The Escapist,0,0,0,0.0,0.0,0.0
3068,Camille,0,6000000,-6000000,0.0,6076719.802855,-6076719.802855
3069,Mad Money,0,0,0,0.0,0.0,0.0
3070,Barbie and the Diamond Castle,0,0,0,0.0,0.0,0.0
3071,9to5: Days in Porn,0,0,0,0.0,0.0,0.0
3072,Open Season 2,0,0,0,0.0,0.0,0.0
3073,The Cottage,0,0,0,0.0,0.0,0.0
3074,Batman: Gotham Knight,0,3500000,-3500000,0.0,3544753.21833208,-3544753.21833208
3075,Two Lovers,3148182,12000000,-8851818,3188436.65039861,12153439.60571,-8965002.95531139
3076,Passengers,2000000,25000000,-23000000,2025573.26761833,25319665.8452291,-23294092.577610772
3077,The Sisterhood of the Traveling Pants 2,44352417,27000000,17352417,44919535.114730395,27345239.1128475,17574296.001882896
3078,The Express,9793496,40000000,-30206504,9918721.84706354,40511465.35236671,-30592743.505303167
3079,Strange Wilderness,6575282,0,6575282,6659357.72312601,0.0,6659357.72312601
3080,Surveillance,1115493,3500000,-2384507,1129756.40050768,3544753.21833208,-2414996.8178244
3081,The Women,50007546,16000000,34007546,50646974.178397104,16204586.1409466,34442388.03745051
3082,Gong fu guan lan,22896728,10000000,12896728,23189500.076364104,10127866.3380916,13061633.738272503
3083,Picture This,0,0,0,0.0,0.0,0.0
3084,Killshot,2960993,0,2960993,2998854.1332025,0.0,2998854.1332025
3085,ÐÐ´Ð¼Ð¸Ñ€Ð°Ð»ÑŠ,38135878,2000000,36135878,38623507.506977,2025573.26761833,36597934.23935867
3086,Alien Raiders,0,0,0,0.0,0.0,0.0
3087,Nights in Rodanthe,84375061,0,84375061,85453934.00763309,0.0,85453934.00763309
3088,Over Her Dead Body,0,10000000,-10000000,0.0,10127866.3380916,-10127866.3380916
3089,Space Chimps,63800345,37000000,26800345,64616136.6484135,37473105.4509392,27143031.1974743
3090,The Promotion,0,0,0,0.0,0.0,0.0
3091,Lakeview Terrace,27640028,20000000,7640028,27993450.916511104,20255732.676183302,7737718.240327802
3092,Journey to the Edge of the Universe,0,0,0,0.0,0.0,0.0
3093,Frozen River,0,0,0,0.0,0.0,0.0
3094,Soul Men,0,0,0,0.0,0.0,0.0
3095,The Echo,0,0,0,0.0,0.0,0.0
3096,Birds of America,0,0,0,0.0,0.0,0.0
3097,Big Buck Bunny,0,150000,-150000,0.0,151917.995071375,-151917.995071375
3098,Day of the Dead,0,18000000,-18000000,0.0,18230159.408565,-18230159.408565
3099,Boogeyman 3,0,0,0,0.0,0.0,0.0
3100,Bathory,0,0,0,0.0,0.0,0.0
3101,Pulse 2: Afterlife,0,0,0,0.0,0.0,0.0
3102,Lost Boys: The Tribe,0,0,0,0.0,0.0,0.0
3103,Barbie in 'A Christmas Carol',4496912,0,4496912,4554412.36701605,0.0,4554412.36701605
3104,20 Years After,0,1000000,-1000000,0.0,1012786.63380916,-1012786.63380916
3105,The Oxford Murders,0,14100000,-14100000,0.0,14280291.536709199,-14280291.536709199
3106,Next Avengers: Heroes of Tomorrow,3800000,0,3800000,3848589.20847483,0.0,3848589.20847483
3107,Easy Virtue,0,0,0,0.0,0.0,0.0
3108,Restraint,0,0,0,0.0,0.0,0.0
3109,Ben 10: Race Against Time,0,0,0,0.0,0.0,0.0
3110,Jodhaa Akbar,13000000,8376800,4623200,13166226.239519099,8483911.07409263,4682315.1654264685
3111,Prom Night,14796236,0,14796236,14985430.051485999,0.0,14985430.051485999
3112,Far Cry,0,30000000,-30000000,0.0,30383599.014275,-30383599.014275
3113,Clubbed,0,0,0,0.0,0.0,0.0
3114,Choke,3830137,3000000,830137,3879111.55925794,3038359.9014275,840751.65783044
3115,Vinyan,0,0,0,0.0,0.0,0.0
3116,"War, Inc.",1296184,5000000,-3703816,1312757.8301573,5063933.16904583,-3751175.33888853
3117,The Wackness,2899975,6000000,-3100025,2937055.91838074,6076719.802855,-3139663.88447426
3118,What Just Happened,6673422,25000000,-18326578,6758752.60336804,25319665.8452291,-18560913.24186106
3119,Hell Ride,194287,0,194287,196771.276722881,0.0,196771.276722881
3120,What Doesn't Kill You,44872,0,44872,45445.7618322849,0.0,45445.7618322849
3121,The Librarian: The Curse of the Judas Chalice,0,0,0,0.0,0.0,0.0
3122,Pour elle,0,10000000,-10000000,0.0,10127866.3380916,-10127866.3380916
3123,Franklyn,0,12000000,-12000000,0.0,12153439.60571,-12153439.60571
3124,The Poker House,0,0,0,0.0,0.0,0.0
3125,Pistol Whipped,0,10000000,-10000000,0.0,10127866.3380916,-10127866.3380916
3126,Recount,0,0,0,0.0,0.0,0.0
3127,First Sunday,38804615,0,38804615,39300795.4021107,0.0,39300795.4021107
3128,Afterwards,0,15400000,-15400000,0.0,15596914.1606611,-15596914.1606611
3129,Cadillac Records,0,12000000,-12000000,0.0,12153439.60571,-12153439.60571
3130,Pinocchio,0,0,0,0.0,0.0,0.0
3131,Meet the Browns,41939392,0,41939392,42475655.6476831,0.0,42475655.6476831
3132,2012 Doomsday,0,250000,-250000,0.0,253196.658452291,-253196.658452291
3133,Assassination of a High School President,69564,11500000,-11430436,70453.4893943009,11647046.288805401,-11576592.7994111
3134,Disaster Movie,14109284,25000000,-10890716,14289694.2478175,25319665.8452291,-11029971.5974116
3135,Man on Wire,2957978,0,2957978,2995800.58150157,0.0,2995800.58150157
3136,The Onion Movie,0,0,0,0.0,0.0,0.0
3137,Miracle at St. Anna,9323833,45000000,-35676167,9443053.43826883,45575398.5214125,-36132345.08314367
3138,The Prince & Me 3: A Royal Honeymoon,0,0,0,0.0,0.0,0.0
3139,"Food, Inc.",0,0,0,0.0,0.0,0.0
3140,The Shepherd: Border Patrol,0,0,0,0.0,0.0,0.0
3141,Generation Kill,0,0,0,0.0,0.0,0.0
3142,Amusement,0,6000000,-6000000,0.0,6076719.802855,-6076719.802855
3143,My Best Friend's Girl,36620508,20000000,16620508,37088761.0257016,20255732.676183302,16833028.349518295
3144,Paris,23550000,19000000,4550000,23851125.2262058,19242946.042374104,4608179.1838316955
3145,The Children,0,0,0,0.0,0.0,0.0
3146,Breathing Room,0,0,0,0.0,0.0,0.0
3147,The Midnight Meat Train,3533227,15000000,-11466773,3578405.07981366,15191799.5071375,-11613394.42732384
3148,Repo! The Genetic Opera,188126,0,188126,190531.498271983,0.0,190531.498271983
3149,Mutant Chronicles,2033165,8000000,-5966835,2059162.33632861,8102293.07047334,-6043130.7341447305
3150,The Objective,0,0,0,0.0,0.0,0.0
3151,ä¸‰å›½ä¹‹è§é¾™å¸ç”²,0,0,0,0.0,0.0,0.0
3152,Einstein and Eddington,0,0,0,0.0,0.0,0.0
3153,Anaconda 3: Offspring,0,0,0,0.0,0.0,0.0
3154,I Can't Think Straight,0,0,0,0.0,0.0,0.0
3155,Major Movie Star,0,0,0,0.0,0.0,0.0
3156,No Man's Land: The Rise of Reeker,0,2000000,-2000000,0.0,2025573.26761833,-2025573.26761833
3157,Religulous,0,0,0,0.0,0.0,0.0
3158,Swing Vote,17600000,21000000,-3400000,17825044.7550413,21268519.3099925,-3443474.5549511984
3159,Flashbacks of a Fool,1107542,0,1107542,1121703.73398227,0.0,1121703.73398227
3160,All the Boys Love Mandy Lane,0,750000,-750000,0.0,759589.975356875,-759589.975356875
3161,The Meerkats,0,0,0,0.0,0.0,0.0
3162,Insanitarium,0,0,0,0.0,0.0,0.0
3163,Dance of the Dead,0,0,0,0.0,0.0,0.0
3164,The Lucky Ones,0,0,0,0.0,0.0,0.0
3165,$5 a Day,0,0,0,0.0,0.0,0.0
3166,Winged Creatures,0,0,0,0.0,0.0,0.0
3167,Flash of Genius,0,0,0,0.0,0.0,0.0
3168,Pontypool,0,1500000,-1500000,0.0,1519179.95071375,-1519179.95071375
3169,A Film with Me in It,0,0,0,0.0,0.0,0.0
3170,Babysitter Wanted,0,0,0,0.0,0.0,0.0
3171,The Assassination of Jesse James: Death Of An Outlaw,0,0,0,0.0,0.0,0.0
3172,Henry Poole Is Here,1829917,0,1829917,1853315.47858017,0.0,1853315.47858017
3173,Ãšltima Parada 174,0,4700000,-4700000,0.0,4760097.17890308,-4760097.17890308
3174,Les Femmes de l'ombre,0,0,0,0.0,0.0,0.0
3175,Gigantic,165888,0,165888,168009.149109335,0.0,168009.149109335
3176,W.,29506464,25100000,4406464,29883752.3501713,25420944.5086101,4462807.841561202
3177,My Mom's New Boyfriend,0,0,0,0.0,0.0,0.0
3178,The Edge of Love,0,0,0,0.0,0.0,0.0
3179,Dorothy Mills,0,500000,-500000,0.0,506393.31690458296,-506393.31690458296
3180,Fireproof,33456317,500000,32956317,33884110.6740824,506393.31690458296,33377717.357177816
3181,The Other End of the Line,0,14000000,-14000000,0.0,14179012.873328302,-14179012.873328302
3182,Chris Rock: Kill the Messenger,0,0,0,0.0,0.0,0.0
3183,Smart People,10569964,7000000,3569964,10705118.259044,7089506.43666417,3615611.822379831
3184,æ±äº¬æ®‹é…·è­¦å¯Ÿ,0,0,0,0.0,0.0,0.0
3185,Forever Strong,0,0,0,0.0,0.0,0.0
3186,L'Heure d'Ã©tÃ©,0,0,0,0.0,0.0,0.0
3187,Charlie Bartlett,0,12000000,-12000000,0.0,12153439.60571,-12153439.60571
3188,Kong saan mei yan,0,0,0,0.0,0.0,0.0
3189,Fly Me to the Moon,0,0,0,0.0,0.0,0.0
3190,Redbelt,0,7000000,-7000000,0.0,7089506.43666417,-7089506.43666417
3191,Johnny Mad Dog,0,0,0,0.0,0.0,0.0
3192,Pranzo di ferragosto,0,0,0,0.0,0.0,0.0
3193,Nim's Island,100076342,37000000,63076342,101355981.53811501,37473105.4509392,63882876.08717581
3194,Vacancy 2: The First Cut,0,0,0,0.0,0.0,0.0
3195,15 ans et demi,0,0,0,0.0,0.0,0.0
3196,Make It Happen,0,0,0,0.0,0.0,0.0
3197,Another Gay Sequel: Gays Gone Wild!,0,0,0,0.0,0.0,0.0
3198,Igor,30000000,25000000,5000000,30383599.014275,25319665.8452291,5063933.169045899
3199,Extreme Movie,0,0,0,0.0,0.0,0.0
3200,Boot Camp,0,14000000,-14000000,0.0,14179012.873328302,-14179012.873328302
3201,Lost in Austen,0,0,0,0.0,0.0,0.0
3202,Adulthood,0,0,0,0.0,0.0,0.0
3203,Semi-Pro,33472850,0,33472850,33900855.0754991,0.0,33900855.0754991
3204,The Haunting of Molly Hartley,0,0,0,0.0,0.0,0.0
3205,Last Chance Harvey,14879423,0,14879423,15069680.7331927,0.0,15069680.7331927
3206,How to Lose Friends & Alienate People,17286299,27000000,-9713701,17507332.5752287,27345239.1128475,-9837906.537618801
3207,The Ramen Girl,0,0,0,0.0,0.0,0.0
3208,Dream Boy,0,0,0,0.0,0.0,0.0
3209,House,0,0,0,0.0,0.0,0.0
3210,Blackout,0,0,0,0.0,0.0,0.0
3211,I Sell The Dead,0,0,0,0.0,0.0,0.0
3212,Krabat,0,8000000,-8000000,0.0,8102293.07047334,-8102293.07047334
3213,Solstice,0,0,0,0.0,0.0,0.0
3214,Train,0,0,0,0.0,0.0,0.0
3215,Oorlogswinter,530048,4000000,-3469952,536825.529677281,4051146.53523667,-3514321.005559389
3216,NYC: Tornado Terror,0,0,0,0.0,0.0,0.0
3217,While She Was Out,391410,6000000,-5608590,396414.816339246,6076719.802855,-5680304.986515754
3218,Wendy and Lucy,0,200000,-200000,0.0,202557.326761833,-202557.326761833
3219,The BrÃ¸ken,0,6700000,-6700000,0.0,6785670.44652142,-6785670.44652142
3220,24: Redemption,0,0,0,0.0,0.0,0.0
3221,Pulse 3,0,0,0,0.0,0.0,0.0
3222,J'ai toujours rÃªvÃ© d'Ãªtre un gangster,0,0,0,0.0,0.0,0.0
3223,La Fille de Monaco,0,0,0,0.0,0.0,0.0
3224,John Mayer: Where the Light Is Live in Los Angeles,0,0,0,0.0,0.0,0.0
3225,Welcome Home Roscoe Jenkins,43650785,35000000,8650785,44208931.603277706,35447532.1833208,8761399.419956908
3226,Lymelife,0,1500000,-1500000,0.0,1519179.95071375,-1519179.95071375
3227,Jeff Dunham: Jeff Dunham's Very Special Christmas Special,0,0,0,0.0,0.0,0.0
3228,Dark Floors,0,4300000,-4300000,0.0,4354982.52537942,-4354982.52537942
3229,The Cutting Edge 3: Chasing the Dream,0,0,0,0.0,0.0,0.0
3230,Snow Angels,414404,0,414404,419702.832197054,0.0,419702.832197054
3231,Center Stage : Turn It Up,0,0,0,0.0,0.0,0.0
3232,Kit Kittredge: An American Girl,0,0,0,0.0,0.0,0.0
3233,Minutemen,0,0,0,0.0,0.0,0.0
3234,Bo chi tung wah,0,5750000,-5750000,0.0,5823523.14440271,-5823523.14440271
3235,Ghajini,76000000,9100000,66900000,76971784.1694967,9216358.36766342,67755425.80183327
3236,XIII,0,21000000,-21000000,0.0,21268519.3099925,-21268519.3099925
3237,August,0,0,0,0.0,0.0,0.0
3238,Young @ Heart,0,0,0,0.0,0.0,0.0
3239,Dr. Horrible's Sing-Along Blog,3,200000,-199997,3.0383599014275005,202557.326761833,-202554.28840193158
3240,Little Ashes,0,2500000,-2500000,0.0,2531966.58452291,-2531966.58452291
3241,$9.99,0,0,0,0.0,0.0,0.0
3242,Kill Theory,0,0,0,0.0,0.0,0.0
3243,Jaane Tu... Ya Jaane Na,11100000,2300000,8800000,11241931.635281699,2329409.25776108,8912522.377520619
3244,VeggieTales: The Pirates Who Don't Do Anything,0,0,0,0.0,0.0,0.0
3245,The Hottie & The Nottie,0,0,0,0.0,0.0,0.0
3246,Batman Unmasked: The Psychology of the Dark Knight,0,0,0,0.0,0.0,0.0
3247,Tomb Raider: Ascension,0,20000,-20000,0.0,20255.7326761833,-20255.7326761833
3248,Tunnel Rats,0,8000000,-8000000,0.0,8102293.07047334,-8102293.07047334
3249,Eldorado,0,0,0,0.0,0.0,0.0
3250,MR 73,0,0,0,0.0,0.0,0.0
3251,Afterschool,0,0,0,0.0,0.0,0.0
3252,Jerusalema,0,0,0,0.0,0.0,0.0
3253,Red,0,2500000,-2500000,0.0,2531966.58452291,-2531966.58452291
3254,Front of the Class,0,0,0,0.0,0.0,0.0
3255,Hero Wanted,0,0,0,0.0,0.0,0.0
3256,Autopsy,0,15000000,-15000000,0.0,15191799.5071375,-15191799.5071375
3257,Bottle Shock,4040588,5000000,-959412,4092253.51912971,5063933.16904583,-971679.6499161203
3258,Bouquet final,0,0,0,0.0,0.0,0.0
3259,Kill Switch,0,10000000,-10000000,0.0,10127866.3380916,-10127866.3380916
3260,Keith,0,0,0,0.0,0.0,0.0
3261,Hamlet 2,0,0,0,0.0,0.0,0.0
3262,Get Smart's Bruce and Lloyd Out of Control,0,0,0,0.0,0.0,0.0
3263,Seventh Moon,0,0,0,0.0,0.0,0.0
3264,"Otto; or, Up with Dead People",11295,0,11295,11439.425028874499,0.0,11439.425028874499
3265,Faubourg 36,850575,0,850575,861450.991052232,0.0,861450.991052232
3266,The Crew,0,3600000,-3600000,0.0,3646031.8817129997,-3646031.8817129997
3267,Donkey Punch,0,0,0,0.0,0.0,0.0
3268,Long nga,0,515788,-515788,0.0,522383.19227916206,-522383.19227916206
3269,Gardens of the Night,0,0,0,0.0,0.0,0.0
3270,Global Metal,0,0,0,0.0,0.0,0.0
3271,Bad Biology,0,0,0,0.0,0.0,0.0
3272,Julia,1300000,6000000,-4700000,1316622.62395191,6076719.802855,-4760097.17890309
3273,Where in the World Is Osama Bin Laden?,0,0,0,0.0,0.0,0.0
3274,Red Mist,0,0,0,0.0,0.0,0.0
3275,Gonzo: The Life and Work of Dr. Hunter S. Thompson,0,0,0,0.0,0.0,0.0
3276,Kismat Konnection,11000000,4180000,6820000,11140652.9719008,4233448.12932232,6907204.84257848
3277,La JournÃ©e de la jupe,0,0,0,0.0,0.0,0.0
3278,The Great Buck Howard,900689,0,900689,912205.780418945,0.0,912205.780418945
3279,ì•„ê¸°ì™€ ë‚˜,0,0,0,0.0,0.0,0.0
3280,The Black Balloon,0,0,0,0.0,0.0,0.0
3281,Miss Austen Regrets,0,0,0,0.0,0.0,0.0
3282,Comme les autres,0,0,0,0.0,0.0,0.0
3283,Parlami D'Amore,9,0,9,9.115079704282499,0.0,9.115079704282499
3284,Visioneers,0,0,0,0.0,0.0,0.0
3285,Tropic Thunder: Rain of Madness,0,0,0,0.0,0.0,0.0
3286,Jolene,0,0,0,0.0,0.0,0.0
3287,Race,0,0,0,0.0,0.0,0.0
3288,Shine a Light,0,0,0,0.0,0.0,0.0
3289,Deux jours Ã  tuer,0,0,0,0.0,0.0,0.0
3290,Doctor Who: The Next Doctor,0,0,0,0.0,0.0,0.0
3291,Sleep Dealer,107559,2500000,-2392441,108934.31754588,2531966.58452291,-2423032.26697703
3292,Signs,0,0,0,0.0,0.0,0.0
3293,One-Eyed Monster,0,0,0,0.0,0.0,0.0
3294,Food Matters,0,0,0,0.0,0.0,0.0
3295,Alone in the Dark 2,0,4600000,-4600000,0.0,4658818.51552217,-4658818.51552217
3296,The Yellow Handkerchief,317000,15000000,-14683000,321053.362917506,15191799.5071375,-14870746.144219995
3297,Witless Protection,0,0,0,0.0,0.0,0.0
3298,MamÃ¡,0,0,0,0.0,0.0,0.0
3299,Mulligans,0,0,0,0.0,0.0,0.0
3300,Le Silence de Lorna,0,0,0,0.0,0.0,0.0
3301,Parasomnia,0,0,0,0.0,0.0,0.0
3302,Sita Sings the Blues,0,0,0,0.0,0.0,0.0
3303,Go Fast,0,0,0,0.0,0.0,0.0
3304,Bigger Stronger Faster*,307811,0,307811,311746.866539433,0.0,311746.866539433
3305,Life After People,0,0,0,0.0,0.0,0.0
3306,Until the Light Takes Us,0,0,0,0.0,0.0,0.0
3307,Feast II: Sloppy Seconds,0,2000000,-2000000,0.0,2025573.26761833,-2025573.26761833
3308,La Misma Luna,23311391,0,23311391,23609465.2202993,0.0,23609465.2202993
3309,The Clique,0,0,0,0.0,0.0,0.0
3310,Dear Zachary: A Letter to a Son About His Father,0,0,0,0.0,0.0,0.0
3311,It's Alive,15500000,11000000,4500000,15698192.824042002,11140652.9719008,4557539.8521412015
3312,Fire and Ice: The Dragon Chronicles,0,3000000,-3000000,0.0,3038359.9014275,-3038359.9014275
3313,Hush,0,0,0,0.0,0.0,0.0
3314,Vilaine,0,0,0,0.0,0.0,0.0
3315,April Fool's Day,0,5000000,-5000000,0.0,5063933.16904583,-5063933.16904583
3316,Deal,0,0,0,0.0,0.0,0.0
3317,Asylum,0,22000000,-22000000,0.0,22281305.9438016,-22281305.9438016
3318,Miss Conception,0,0,0,0.0,0.0,0.0
3319,Good,0,0,0,0.0,0.0,0.0
3320,Harold,0,0,0,0.0,0.0,0.0
3321,Mum & Dad,0,170000,-170000,0.0,172173.727747558,-172173.727747558
3322,Incendiary,0,10000000,-10000000,0.0,10127866.3380916,-10127866.3380916
3323,"Merry Christmas, Drake and Josh",0,0,0,0.0,0.0,0.0
3324,Louis C.K.: Chewed Up,0,0,0,0.0,0.0,0.0
3325,Dead Set,0,0,0,0.0,0.0,0.0
3326,The Burrowers,0,7000000,-7000000,0.0,7089506.43666417,-7089506.43666417
3327,Good Dick,0,0,0,0.0,0.0,0.0
3328,Were The World Mine,119563,0,119563,121091.808298125,0.0,121091.808298125
3329,"Grande, grosso e Verdone",0,0,0,0.0,0.0,0.0
3330,Not Quite Hollywood,0,0,0,0.0,0.0,0.0
3331,The Family That Preys,0,0,0,0.0,0.0,0.0
3332,Anvil! The Story of Anvil,0,0,0,0.0,0.0,0.0
3333,Coco Chanel,0,0,0,0.0,0.0,0.0
3334,Princess,0,0,0,0.0,0.0,0.0
3335,Baby Blues,0,0,0,0.0,0.0,0.0
3336,Fab Five: The Texas Cheerleader Scandal,0,0,0,0.0,0.0,0.0
3337,iCarly: iGo to Japan,0,0,0,0.0,0.0,0.0
3338,Strictly Sexual,0,0,0,0.0,0.0,0.0
3339,Zeitgeist: Addendum,0,0,0,0.0,0.0,0.0
3340,Expelled: No Intelligence Allowed,7700000,3500000,4200000,7798457.08033059,3544753.21833208,4253703.86199851
3341,Chiko,0,0,0,0.0,0.0,0.0
3342,Somers Town,0,0,0,0.0,0.0,0.0
3343,Flirting with Forty,0,0,0,0.0,0.0,0.0
3344,Lake Mungo,0,0,0,0.0,0.0,0.0
3345,George Carlin: It's Bad for Ya!,0,0,0,0.0,0.0,0.0
3346,Home Movie,0,0,0,0.0,0.0,0.0
3347,Passchendaele,0,0,0,0.0,0.0,0.0
3348,Maradona by Kusturica,0,0,0,0.0,0.0,0.0
3349,The Horribly Slow Murderer with the Extremely Inefficient Weapon,0,0,0,0.0,0.0,0.0
3350,The Black Hole,0,0,0,0.0,0.0,0.0
3351,One Week,0,0,0,0.0,0.0,0.0
3352,Meu Nome NÃ£o Ã‰ Johnny,0,0,0,0.0,0.0,0.0
3353,"Coluche, L'histoire d'un Mec",0,0,0,0.0,0.0,0.0
3354,The Wrecking Crew,0,0,0,0.0,0.0,0.0
3355,Tokyo Mater,0,0,0,0.0,0.0,0.0
3356,John Adams,0,0,0,0.0,0.0,0.0
3357,Bill Burr: Why Do I Do This?,0,0,0,0.0,0.0,0.0
3358,Phoebe in Wonderland,0,0,0,0.0,0.0,0.0
3359,The Cheetah Girls: One World,0,0,0,0.0,0.0,0.0
3360,Disgrace,0,0,0,0.0,0.0,0.0
3361,Era Uma Vez...,0,0,0,0.0,0.0,0.0
3362,The Little Mermaid: Ariel's Beginning,0,0,0,0.0,0.0,0.0
3363,Dante 01,0,8000000,-8000000,0.0,8102293.07047334,-8102293.07047334
3364,Si puÃ² fare,0,0,0,0.0,0.0,0.0
3365,Foo Fighters: Live at Wembley Stadium,0,0,0,0.0,0.0,0.0
3366,More Than a Game,887029,0,887029,898371.115001112,0.0,898371.115001112
3367,Hannah Montana & Miley Cyrus: Best of Both Worlds Concert,0,0,0,0.0,0.0,0.0
3368,How to Be,0,500000,-500000,0.0,506393.31690458296,-506393.31690458296
3369,Wizards On Deck With Hannah Montana,0,0,0,0.0,0.0,0.0
3370,Fuera de carta,0,0,0,0.0,0.0,0.0
3371,Underworld: Endless War,0,0,0,0.0,0.0,0.0
3372,Captain America: The First Avenger,370569774,140000000,230569774,359229613.559164,135715725.96280602,223513887.59635797
3373,Drive,76175166,15000000,61175166,73844056.81448041,14540970.638872,59303086.17560841
3374,Harry Potter and the Deathly Hallows: Part 2,1327817822,125000000,1202817822,1287183997.5648699,121174755.323934,1166009242.2409358
3375,Pirates of the Caribbean: On Stranger Tides,1021683000,380000000,641683000,990417500.348983,368371256.18475896,622046244.1642241
3376,Rise of the Planet of the Apes,482860185,93000000,389860185,468083718.184356,90154017.96100691,377929700.2233491
3377,Thor,444115007,150000000,294115007,430524218.471298,145409706.38872,285114512.08257794
3378,In Time,173930596,40000000,133930596,168607979.30916798,38775921.7036588,129832057.60550919
3379,Drive Angry,28931401,50000000,-21068599,28046043.4988289,48469902.129573606,-20423858.630744707
3380,The Mechanic,51070807,40000000,11070807,49507940.33936679,38775921.7036588,10732018.635707997
3381,Source Code,147332697,32000000,115332697,142824028.081522,31020737.362927098,111803290.7185949
3382,Mission: Impossible - Ghost Protocol,694713380,145000000,549713380,673453790.734105,140562716.17576298,532891074.558342
3383,"Crazy, Stupid, Love.",142851197,50000000,92851197,138479670.753648,48469902.129573606,90009768.6240744
3384,The Girl with the Dragon Tattoo,232617430,90000000,142617430,225498881.31465802,87245823.83323249,138253057.48142552
3385,Limitless,161849455,27000000,134849455,156896544.871496,26173747.1499697,130722797.7215263
3386,Kung Fu Panda 2,665692281,150000000,515692281,645320794.169652,145409706.38872,499911087.78093195
3387,Just Go With It,214918407,80000000,134918407,208341483.062677,77551843.4073177,130789639.6553593
3388,Horrible Bosses,117000000,35000000,82000000,113419570.983202,33928931.490701504,79490639.49250048
3389,Real Steel,299268508,110000000,189268508,290110305.86447,106633784.685061,183476521.17940903
3390,Friends with Benefits,150483765,35000000,115483765,145878667.232795,33928931.490701504,111949735.7420935
3391,Bad Teacher,216197492,20000000,196197492,209581425.557985,19387960.8518294,190193464.7061556
3392,Sherlock Holmes: A Game of Shadows,334615000,125000000,209615000,324375126.021745,121174755.323934,203200370.697811
3393,Cars 2,559852396,200000000,359852396,542719816.822545,193879608.518294,348840208.3042511
3394,Green Lantern,219851172,200000000,19851172,213123295.798241,193879608.518294,19243687.279946983
3395,The Hangover Part II,254455986,80000000,174455986,246669134.754083,77551843.4073177,169117291.3467653
3396,No Strings Attached,147780440,25000000,122780440,143258069.269306,24234951.064786803,119023118.2045192
3397,The Adventures of Tintin,371940071,130000000,241940071,360557976.788733,126021745.536891,234536231.25184202
3398,Bridesmaids,288383523,32500000,255883523,279558422.711832,31505436.3842228,248052986.32760918
3399,Hall Pass,83160734,36000000,47160734,80615852.76007009,34898329.533293,45717523.226777084
3400,Super 8,260095987,50000000,210095987,252136540.68369702,48469902.129573606,203666638.5541234
3401,Sucker Punch,89792502,82000000,7792502,87044675.6781908,79490639.49250071,7554036.18569009
3402,Red Riding Hood,89162162,42000000,47162162,86433625.3160237,40714717.7888418,45718907.52718191
3403,The Twilight Saga: Breaking Dawn - Part 1,712171856,110000000,602171856,690378003.1951361,106633784.685061,583744218.5100751
3404,Shame,17693675,6500000,11193675,17152213.9112496,6301087.27684457,10851126.63440503
3405,Ice Age: A Mammoth Christmas,0,0,0,0.0,0.0,0.0
3406,Mr. Popper's Penguins,187361754,55000000,132361754,181628117.584104,53316892.3425309,128311225.2415731
3407,The Tree of Life,54674226,32000000,22674226,53001087.6646037,31020737.362927098,21980350.301676605
3408,I Am Number Four,144492830,50000000,94492830,140071066.570502,48469902.129573606,91601164.4409284
3409,Rio,484635760,90000000,394635760,469804957.11383,87245823.83323249,382559133.28059745
3410,The Artist,133432856,15000000,118432856,129349549.423789,14540970.638872,114808578.784917
3411,Zookeeper,169852759,80000000,89852759,164654932.103361,77551843.4073177,87103088.69604331
3412,Cowboys & Aliens,174822325,163000000,11822325,169472419.65629,158011880.94241002,11460538.713879973
3413,Pixie Hollow Games,0,0,0,0.0,0.0,0.0
3414,War Horse,177584879,66000000,111584879,172150434.096443,63980270.8110371,108170163.2854059
3415,50/50,39187783,8000000,31187783,37988560.1336993,7755184.34073177,30233375.792967528
3416,Rango,245724603,135000000,110724603,238204949.164766,130868735.749848,107336213.41491802
3417,The Change-Up,75450437,52000000,23450437,73141505.9404712,50408698.2147565,22732807.7257147
3418,Hugo,185770160,170000000,15770160,180085229.47590402,164797667.24055,15287562.235354006
3419,The Lincoln Lawyer,85412898,40000000,45412898,82799096.133265,38775921.7036588,44023174.42960621
3420,Ghost Rider: Spirit of Vengeance,149217355,57000000,92217355,144651011.857676,55255688.4277139,89395323.4299621
3421,One Day,59389433,15000000,44389433,57572000.1008174,14540970.638872,43031029.4619454
3422,Killer Elite,57777106,66000000,-8222894,56009013.463,63980270.8110371,-7971257.348037101
3423,The Rite,96047633,37000000,59047633,93108387.42574409,35867727.5758844,57240659.849859685
3424,Winnie the Pooh,14460000,30000000,-15540000,14017495.695872597,29081941.277744103,-15064445.581871506
3425,The Three Musketeers,132274484,75000000,57274484,128226625.874397,72704853.1943604,55521772.68003659
3426,Page Eight,0,0,0,0.0,0.0,0.0
3427,Chalet Girl,1749457,8000000,-6250543,1695920.19139794,7755184.34073177,-6059264.14933383
3428,Wrong Turn 4: Bloody Beginnings,0,0,0,0.0,0.0,0.0
3429,Midnight in Paris,151119219,30000000,121119219,146494675.096552,29081941.277744103,117412733.81880791
3430,Priest,78309131,60000000,18309131,75912718.30843921,58163882.555488296,17748835.752950914
3431,Arthur Christmas,0,0,0,0.0,0.0,0.0
3432,Young Adult,22939027,12000000,10939027,22237047.872752897,11632776.5110976,10604271.361655297
3433,Warrior,23057115,25000000,-1942885,22351522.1488064,24234951.064786803,-1883428.9159804024
3434,Abduction,82087155,35000000,47087155,79575127.3789028,33928931.490701504,45646195.88820129
3435,Unknown,130786397,30000000,100786397,126784077.24939099,29081941.277744103,97702135.97164689
3436,The Adjustment Bureau,127869379,50200000,77669379,123956325.70998701,48663781.7380919,75292543.97189511
3437,Immortals,226904017,75000000,151904017,219960309.935942,72704853.1943604,147255456.7415816
3438,Like Crazy,3542353,250000,3292353,3433950.06436803,242349.510647868,3191600.5537201623
3439,Larry Crowne,36160375,30000000,6160375,35053796.744373605,29081941.277744103,5971855.466629501
3440,Paul,97552050,40000000,57552050,94566766.3207854,38775921.7036588,55790844.61712661
3441,Catch .44,0,7000000,-7000000,0.0,6785786.2981403,-6785786.2981403
3442,The Inbetweeners Movie,88025781,0,88025781,85332019.7989856,0.0,85332019.7989856
3443,Colombiana,60965854,40000000,20965854,59100179.532517396,38775921.7036588,20324257.8288586
3444,Battle: Los Angeles,202466756,70000000,132466756,196270876.956245,67857862.98140301,128413013.974842
3445,Final Destination 5,157887643,47000000,110887643,153055972.073581,45561708.0017992,107494264.07178181
3446,Machine Gun Preacher,2527904,30000000,-27472096,2450545.18945915,29081941.277744103,-26631396.088284954
3447,Jack and Jill,149673788,79000000,70673788,145093477.114451,76582445.36472629,68511031.7497247
3448,What's Your Number?,30426096,20000000,10426096,29494997.906100202,19387960.8518294,10107037.054270804
3449,Season of the Witch,88100000,40000000,48100000,85403967.55230871,38775921.7036588,46628045.84864991
3450,My Week with Marilyn,35057696,6400000,28657696,33984861.88016681,6204147.47258542,27780714.407581385
3451,Hostel: Part III,0,6000000,-6000000,0.0,5816388.25554883,-5816388.25554883
3452,We Bought a Zoo,120081841,50000000,70081841,116407101.61618,48469902.129573606,67937199.48660639
3453,10 Years,201146,0,201146,194990.53867510398,0.0,194990.53867510398
3454,The Darkest Hour,64626786,30000000,34626786,62649079.8473779,29081941.277744103,33567138.5696338
3455,The Help,124272124,25000000,99272124,120469153.75428401,24234951.064786803,96234202.6894972
3456,The Grey,77278331,25000000,52278331,74913462.80613591,24234951.064786803,50678511.7413491
3457,Moneyball,110206216,50000000,60206216,106833690.071813,48469902.129573606,58363787.942239396
3458,We Need to Talk About Kevin,6038942,7000000,-961058,5854138.55412343,6785786.2981403,-931647.7440168709
3459,The Roommate,40492759,16000000,24492759,39253601.313728206,15510368.6814635,23743232.632264704
3460,Puss in Boots,554987477,130000000,424987477,538003773.866579,126021745.536891,411982028.3296881
3461,Tinker Tailor Soldier Spy,0,30000000,-30000000,0.0,29081941.277744103,-29081941.277744103
3462,The Green Hornet,227817248,120000000,107817248,220845594.27977598,116327765.110976,104517829.16879998
3463,Something Borrowed,59901913,35000000,24901913,58068797.20968461,33928931.490701504,24139865.718983106
3464,Conan the Barbarian,48795021,90000000,-41204979,47301797.8456097,87245823.83323249,-39944025.98762279
3465,A Cinderella Story: Once Upon a Song,0,0,0,0.0,0.0,0.0
3466,Johnny English Reborn,160078586,45000000,115078586,155179867.92921,43622911.9166162,111556956.0125938
3467,Contagion,135458097,60000000,75458097,131312814.08496499,58163882.555488296,73148931.5294767
3468,Dragons: Gift of the Night Fury,0,0,0,0.0,0.0,0.0
3469,The Big Year,7448385,41000000,-33551615,7220449.83946768,39745319.7462503,-32524869.90678262
3470,Beastly,43165571,17000000,26165571,41844620.0347432,16479766.724055,25364853.310688198
3471,A Very Harold & Kumar Christmas,35387212,19000000,16387212,34304294.0455694,18418562.8092379,15885731.236331496
3472,The Thing,28128670,35000000,-6871330,27267877.638701398,33928931.490701504,-6661053.852000106
3473,Tower Heist,152930623,75000000,77930623,148250646.588494,72704853.1943604,75545793.3941336
3474,New Year's Eve,142044638,56000000,86044638,137697794.037814,54286290.3851224,83411503.65269159
3475,Your Highness,26121638,49900000,-23778362,25322264.746482998,48372962.325314395,-23050697.578831397
3476,All Star Superman,0,3500000,-3500000,0.0,3392893.14907015,-3392893.14907015
3477,Samsara,0,4000000,-4000000,0.0,3877592.17036588,-3877592.17036588
3478,Tom and Jerry & The Wizard of Oz,0,0,0,0.0,0.0,0.0
3479,Honey 2,0,0,0,0.0,0.0,0.0
3480,Apollo 18,25562924,5000000,20562924,24780648.488514498,4846990.21295736,19933658.275557138
3481,Fright Night,24922237,17000000,7922237,24159567.764800698,16479766.724055,7679801.040745698
3482,Happy Feet Two,150406466,130000000,20406466,145803733.7335,126021745.536891,19781988.196609005
3483,Scream 4,97138686,40000000,57138686,94166052.0683076,38775921.7036588,55390130.3646488
3484,Mars Needs Moms,38992758,150000000,-111007242,37799503.28044289,145409706.38872,-107610203.10827711
3485,Attack the Block,3964682,14350531,-10385849,3843354.97029764,13911376.6615482,-10068021.691250559
3486,Diary of a Wimpy Kid: Rodrick Rules,72417394,21000000,51417394,70201279.9931754,20357358.8944209,49843921.0987545
3487,Puss in Boots: The Three Diablos,0,0,0,0.0,0.0,0.0
3488,Extremely Loud & Incredibly Close,55247881,40000000,15247881,53557187.698726505,38775921.7036588,14781265.995067708
3489,Battle of Los Angeles,0,0,0,0.0,0.0,0.0
3490,Alvin and the Chipmunks: Chipwrecked,342695435,75000000,267695435,332208283.894033,72704853.1943604,259503430.6996726
3491,The Beaver,970816,21000000,-20029184,941107.130116482,20357358.8944209,-19416251.764304418
3492,Straw Dogs,10324441,25000000,-14675559,10008492.896251101,24234951.064786803,-14226458.168535702
3493,The Best Exotic Marigold Hotel,136836156,10000000,126836156,132648701.78214099,9693980.42591472,122954721.35622627
3494,The Smurfs,563749323,110000000,453749323,546497490.228467,106633784.685061,439863705.543406
3495,Perfect Sense,908000,0,908000,880213.4226730571,0.0,880213.4226730571
3496,Hanna,63782078,30000000,33782078,61830221.5656166,29081941.277744103,32748280.287872497
3497,Hodejegerne,15699707,0,15699707,15219265.2350596,0.0,15219265.2350596
3498,Puncture,68945,0,68945,66835.14804646901,0.0,66835.14804646901
3499,A Few Best Men,29007412,12468389,16539023,28119728.4134443,12086831.890869,16032896.522575298
3500,Sleeping Beauty,0,10000000,-10000000,0.0,9693980.42591472,-9693980.42591472
3501,Submarine,864659,0,864659,838198.742109099,0.0,838198.742109099
3502,Flypaper,3142154,5000000,-1857846,3045997.93712096,4846990.21295736,-1800992.2758363998
3503,Margin Call,19504039,3500000,16004039,18907177.2292277,3392893.14907015,15514284.080157548
3504,Gnomeo & Juliet,189712432,36000000,153712432,183906860.236067,34898329.533293,149008530.702774
3505,Blitz,741875,15774948,-15033073,719172.1728475479,15292203.7131822,-14573031.540334651
3506,Cedar Rapids,6861102,0,6861102,6651138.84882043,0.0,6651138.84882043
3507,The Descendants,177243185,20000000,157243185,171819196.601678,19387960.8518294,152431235.7498486
3508,Hop,183953723,63000000,120953723,178324379.003613,61072076.683262706,117252302.32035029
3509,The Rum Diary,24000000,45000000,-21000000,23265553.022195302,43622911.9166162,-20357358.8944209
3510,Detention,0,10000000,-10000000,0.0,9693980.42591472,-9693980.42591472
3511,The Guard,19560274,6000000,13560274,18961691.3281528,5816388.25554883,13145303.07260397
3512,Sniper: Reloaded,0,0,0,0.0,0.0,0.0
3513,Our Idiot Brother,17273593,10000000,7273593,16744987.242721697,9693980.42591472,7051006.816806978
3514,The Ledge,610986,10000000,-9389014,592288.6324507929,9693980.42591472,-9101691.793463927
3515,Footloose,63543328,24000000,39543328,61598777.7829479,23265553.022195302,38333224.760752596
3516,A Little Bit of Heaven,1296937,0,1296937,1257248.18916445,0.0,1257248.18916445
3517,Trespass,9612469,36000000,-26387531,9318308.633071199,34898329.533293,-25580020.900221802
3518,Carnage,27603069,25000000,2603069,26758361.0581173,24234951.064786803,2523409.9933304973
3519,Another Earth,1776935,100000,1676935,1722557.31081227,96939.8042591472,1625617.5065531228
3520,The Ides of March,75993061,12500000,63493061,73667524.5839343,12117475.532393401,61550049.051540904
3521,Beverly Hills Chihuahua 2,12000000,0,12000000,11632776.5110976,0.0,11632776.5110976
3522,Transformers: Dark of the Moon,1123746996,195000000,928746996,1089358138.29044,189032618.305337,900325519.9851031
3523,Paranormal Activity 3,205703818,5000000,200703818,199408878.52279198,4846990.21295736,194561888.30983463
3524,Intruders,0,13000000,-13000000,0.0,12602174.5536891,-12602174.5536891
3525,The Dilemma,67112664,70000000,-2887336,65058885.114699095,67857862.98140301,-2798977.8667039126
3526,Take Me Home Tonight,6928068,19000000,-12071932,6716055.55814061,18418562.8092379,-11702507.251097292
3527,Hysteria,9504139,0,9504139,9213293.74311727,0.0,9213293.74311727
3528,Passion Play,0,15000000,-15000000,0.0,14540970.638872,-14540970.638872
3529,You're Next,14347000,0,14347000,13907953.717059802,0.0,13907953.717059802
3530,A Lonely Place to Die,25345000,4000000,21345000,24569393.389480803,3877592.17036588,20691801.219114922
3531,The Muppets,165184237,45000000,120184237,160129276.014765,43622911.9166162,116506364.0981488
3532,Spy Kids: All the Time in the World,85564310,27000000,58564310,82945874.6296899,26173747.1499697,56772127.479720205
3533,Trust,120000,9500000,-9380000,116327.76511097599,9209281.40461898,-9092953.639508005
3534,The Son of No One,0,15000000,-15000000,0.0,14540970.638872,-14540970.638872
3535,A Good Old Fashioned Orgy,0,0,0,0.0,0.0,0.0
3536,Jane Eyre,34710627,0,34710627,33648413.8709227,0.0,33648413.8709227
3537,Seeking Justice,12355798,17000000,-4644202,11977686.3958556,16479766.724055,-4502080.3281994
3538,Barbie: A Fairy Secret,0,0,0,0.0,0.0,0.0
3539,Arthur,45735397,40000000,5735397,44335804.32894389,38775921.7036588,5559882.6252850965
3540,The Smurfs: A Christmas Carol,0,0,0,0.0,0.0,0.0
3541,Marley & Me: The Puppy Years,0,0,0,0.0,0.0,0.0
3542,Jackass 3.5,0,0,0,0.0,0.0,0.0
3543,The Eagle,27122040,25000000,2122040,26292052.4870876,24234951.064786803,2057101.422300797
3544,The Sitter,34942188,25000000,9942188,33872888.651063204,24234951.064786803,9637937.5862764
3545,Rundskop,42070,2000000,-1957930,40782.5756518232,1938796.08518294,-1898013.5095311166
3546,Violet & Daisy,0,0,0,0.0,0.0,0.0
3547,W.E.,868439,15000000,-14131561,841863.066710095,14540970.638872,-13699107.572161904
3548,La luna,0,0,0,0.0,0.0,0.0
3549,Butter,175706,0,175706,170329.052471577,0.0,170329.052471577
3550,11/11/11,0,0,0,0.0,0.0,0.0
3551,Geek Charming,0,0,0,0.0,0.0,0.0
3552,The Hit List,0,6000000,-6000000,0.0,5816388.25554883,-5816388.25554883
3553,The Innkeepers,78396,750000,-671604,75996.928947001,727048.5319436041,-651051.6029966031
3554,Restless,163265,8000000,-7836735,158268.771423696,7755184.34073177,-7596915.569308074
3555,Freerunner,0,5000000,-5000000,0.0,4846990.21295736,-4846990.21295736
3556,A Princess for Christmas,0,0,0,0.0,0.0,0.0
3557,Coriolanus,1072602,7700000,-6627398,1039778.27927969,7464364.92795433,-6424586.64867464
3558,J. Edgar,84606030,35000000,49606030,82016919.8734354,33928931.490701504,48087988.38273389
3559,Sanctum,108609310,30000000,78609310,105285652.52121,29081941.277744103,76203711.2434659
3560,The Sunset Limited,0,0,0,0.0,0.0,0.0
3561,I Don't Know How She Does It,30551495,24000000,6551495,29616559.451243103,23265553.022195302,6351006.429047801
3562,A Dangerous Method,27462041,15000000,12462041,26621648.7909667,14540970.638872,12080678.152094701
3563,Soul Surfer,47088990,18000000,29088990,45647974.7336094,17449164.7666465,28198809.9669629
3564,30 Minutes or Less,40547440,28000000,12547440,39306608.9680951,27143145.1925612,12163463.7755339
3565,The Awakening,209696,4798235,-4588539,203278.89193926103,4651399.61689389,-4448120.724954629
3566,Hoodwinked Too! Hood VS. Evil,13521829,30000000,-16478171,13108034.5648566,29081941.277744103,-15973906.712887503
3567,Detachment,72689,0,72689,70464.5743179315,0.0,70464.5743179315
3568,Carjacked,0,0,0,0.0,0.0,0.0
3569,Foster,0,0,0,0.0,0.0,0.0
3570,Batman: Year One,0,0,0,0.0,0.0,0.0
3571,Blue Crush 2,0,7000000,-7000000,0.0,6785786.2981403,-6785786.2981403
3572,Hick,0,0,0,0.0,0.0,0.0
3573,5 Days of War,17479,20000000,-19982521,16944.108386456297,19387960.8518294,-19371016.74344294
3574,2012: Ice Age,0,0,0,0.0,0.0,0.0
3575,Assassination Games,0,8000000,-8000000,0.0,7755184.34073177,-7755184.34073177
3576,Water for Elephants,114156230,38000000,76156230,110662825.91162099,36837125.6184759,73825700.29314509
3577,Dream House,38502340,50000000,-11497660,37324093.0311913,48469902.129573606,-11145809.09838231
3578,A Better Life,1759252,10000000,-8240748,1705415.44522513,9693980.42591472,-7988564.98068959
3579,Mardi Gras: Spring Break,0,0,0,0.0,0.0,0.0
3580,Julia X,0,4000000,-4000000,0.0,3877592.17036588,-3877592.17036588
3581,"Love, Wedding, Marriage",1378,1,1377,1335.83050269104,0.9693980425914721,1334.8611046484486
3582,That's What I Am,0,0,0,0.0,0.0,0.0
3583,Rampart,972512,12000000,-11027488,942751.229196718,11632776.5110976,-10690025.281900883
3584,Martha Marcy May Marlene,3538446,0,3538446,3430162.62621562,0.0,3430162.62621562
3585,Take Shelter,3099314,5000000,-1900686,3004468.92497634,4846990.21295736,-1842521.2879810198
3586,Prom,10130000,8000000,2130000,9820002.17145161,7755184.34073177,2064817.8307198398
3587,Tyrannosaur,22321,0,22321,21637.9337086842,0.0,21637.9337086842
3588,Snowtown,8452,0,8452,8193.35225598312,0.0,8193.35225598312
3589,Pina,14624826,4317946,10306880,14177277.697640803,4185808.40041567,9991469.297225133
3590,Neverland,0,0,0,0.0,0.0,0.0
3591,Air Mater,0,0,0,0.0,0.0,0.0
3592,JÃ¤garna 2,0,0,0,0.0,0.0,0.0
3593,Megamind: The Button Of Doom,0,0,0,0.0,0.0,0.0
3594,Retreat,0,0,0,0.0,0.0,0.0
3595,Courageous,34522221,1000000,33522221,33465773.4633102,969398.042591472,32496375.42071873
3596,The Good Witch's Family,0,0,0,0.0,0.0,0.0
3597,Sound of My Voice,0,0,0,0.0,0.0,0.0
3598,Black Gold,5446000,40000000,-34554000,5279341.73995315,38775921.7036588,-33496579.963705648
3599,Born To Race,0,0,0,0.0,0.0,0.0
3600,Beethoven's Christmas Adventure,0,0,0,0.0,0.0,0.0
3601,Killer Joe,3665069,10000000,-6334931,3552910.71456268,9693980.42591472,-6141069.711352039
3602,Small Fry,0,0,0,0.0,0.0,0.0
3603,TRON: The Next Day,0,0,0,0.0,0.0,0.0
3604,"Big Mommas: Like Father, Like Son",83615414,32000000,51615414,81056618.6620756,31020737.362927098,50035881.2991485
3605,Grave Encounters,0,1000000,-1000000,0.0,969398.042591472,-969398.042591472
3606,Hellraiser: Revelations,0,350000,-350000,0.0,339289.314907015,-339289.314907015
3607,Green Lantern: Emerald Knights,0,3500000,-3500000,0.0,3392893.14907015,-3392893.14907015
3608,From Prada to Nada,2500000,93,2499907,2423495.10647868,90.15401796100691,2423404.952460719
3609,Juan de los Muertos,0,0,0,0.0,0.0,0.0
3610,Dolphin Tale,95404397,37000000,58404397,92484835.7064197,35867727.5758844,56617108.130535305
3611,Sharpay's Fabulous Adventure,0,0,0,0.0,0.0,0.0
3612,Mean Girls 2,0,0,0,0.0,0.0,0.0
3613,Salmon Fishing in the Yemen,34564651,0,34564651,33506905.0222573,0.0,33506905.0222573
3614,Urbanized,0,0,0,0.0,0.0,0.0
3615,Xin shao lin si,33662874,29000000,4662874,32632724.163603302,28112543.2351527,4520180.928450603
3616,Age of Heroes,0,0,0,0.0,0.0,0.0
3617,The Woman,0,0,0,0.0,0.0,0.0
3618,In the Name of the King 2: Two Worlds,0,4500000,-4500000,0.0,4362291.19166162,-4362291.19166162
3619,Fast Five,626137675,125000000,501137675,606976636.537775,121174755.323934,485801881.213841
3620,Judas Kiss,0,500000,-500000,0.0,484699.021295736,-484699.021295736
3621,Nuit Blanche,3358,2500000,-2496642,3255.23862702216,2423495.10647868,-2420239.867851658
3622,You May Not Kiss the Bride,0,0,0,0.0,0.0,0.0
3623,In the Land of Blood and Honey,303877,10000000,-9696123,294577.768988568,9693980.42591472,-9399402.656926151
3624,Phineas and Ferb the Movie: Across the 2nd Dimension,0,0,0,0.0,0.0,0.0
3625,Another Happy Day,355688,4000000,-3644312,344803.250973275,3877592.17036588,-3532788.919392605
3626,The Caller,0,0,0,0.0,0.0,0.0
3627,Le Skylab,0,0,0,0.0,0.0,0.0
3628,Jumping the Broom,37710610,6600000,31110610,36556591.5189304,6398027.08110371,30158564.437826686
3629,La Fille du puisatier,0,0,0,0.0,0.0,0.0
3630,Lemonade Mouth,0,0,0,0.0,0.0,0.0
3631,Silent House,13101672,2000000,11101672,12700735.191475501,1938796.08518294,10761939.10629256
3632,Kill the Irishman,1188194,0,1188194,1151832.93781893,0.0,1151832.93781893
3633,Trishna,0,0,0,0.0,0.0,0.0
3634,Too Big to Fail,0,0,0,0.0,0.0,0.0
3635,Beneath the Darkness,0,7300000,-7300000,0.0,7076605.71091774,-7076605.71091774
3636,Wuthering Heights,100915,8000000,-7899085,97826.80346811839,7755184.34073177,-7657357.537263651
3637,The Veteran,0,0,0,0.0,0.0,0.0
3638,African Cats,15240456,0,15240456,14774068.214601401,0.0,14774068.214601401
3639,Your Sister's Sister,3200000,125000,3075000,3102073.73629271,121174.755323934,2980898.980968776
3640,Elevator,0,5000000,-5000000,0.0,4846990.21295736,-4846990.21295736
3641,Recoil,0,0,0,0.0,0.0,0.0
3642,Monte Carlo,17425000,20000000,-2575000,16891760.8921564,19387960.8518294,-2496199.9596729986
3643,Win Win,10654385,10831173,-176788,10328339.9640159,10499717.9051696,-171377.9411537014
3644,Swamp Shark,0,0,0,0.0,0.0,0.0
3645,Setup,0,20000000,-20000000,0.0,19387960.8518294,-19387960.8518294
3646,Dark Horse,0,0,0,0.0,0.0,0.0
3647,Spooky Buddies,0,0,0,0.0,0.0,0.0
3648,The Resident,0,20000000,-20000000,0.0,19387960.8518294,-19387960.8518294
3649,Margaret,46495,14000000,-13953505,45072.1619902905,13571572.5962806,-13526500.43429031
3650,Blackthorn,623528,0,623528,604446.822700975,0.0,604446.822700975
3651,Horrid Henry: The Movie,0,0,0,0.0,0.0,0.0
3652,Killing Bono,0,0,0,0.0,0.0,0.0
3653,Barbie: Princess Charm School,0,0,0,0.0,0.0,0.0
3654,The Double,3696232,17000000,-13303768,3583120.06576396,16479766.724055,-12896646.65829104
3655,Private Romeo,0,0,0,0.0,0.0,0.0
3656,Marvel One-Shot: The Consultant,0,500000,-500000,0.0,484699.021295736,-484699.021295736
3657,The Tunnel,0,135000,-135000,0.0,130868.73574984801,-130868.73574984801
3658,What A Man,0,0,0,0.0,0.0,0.0
3659,L!fe Happens,30905,930000,-899095,29959.2465062894,901540.179610069,-871580.9331037797
3660,Terri,144633,0,144633,140206.947094132,0.0,140206.947094132
3661,The Iron Lady,114956699,13000000,101956699,111438798.993377,12602174.5536891,98836624.43968791
3662,Barbie: A Perfect Christmas,0,0,0,0.0,0.0,0.0
3663,The Day,0,0,0,0.0,0.0,0.0
3664,Red State,1104682,4000000,-2895318,1070876.56848603,3877592.17036588,-2806715.60187985
3665,Marvel One-Shot: A Funny Thing Happened on the Way to Thor's Hammer,0,500000,-500000,0.0,484699.021295736,-484699.021295736
3666,The Devil's Double,5728213,19100000,-13371787,5552918.46974702,18515502.6134971,-12962584.14375008
3667,Twixt,0,7000000,-7000000,0.0,6785786.2981403,-6785786.2981403
3668,God Bless America,122550,0,122550,118799.730119584,0.0,118799.730119584
3669,Bully,0,1100000,-1100000,0.0,1066337.84685061,-1066337.84685061
3670,Adele - Live at the Royal Albert Hall,0,0,0,0.0,0.0,0.0
3671,Tactical Force,0,8400000,-8400000,0.0,8142943.55776836,-8142943.55776836
3672,4:44 Last Day on Earth,17801,0,17801,17256.2545561708,0.0,17256.2545561708
3673,Ironclad,0,25000000,-25000000,0.0,24234951.064786803,-24234951.064786803
3674,The Music Never Stopped,253899,4000000,-3746101,246129.193615932,3877592.17036588,-3631462.9767499478
3675,The Task,0,0,0,0.0,0.0,0.0
3676,Don't Let Him In,0,1150000,-1150000,0.0,1114807.74898019,-1114807.74898019
3677,Friends with Kids,12186625,0,12186625,11813690.420796301,0.0,11813690.420796301
3678,Never Back Down 2: The Beatdown,0,3000000,-3000000,0.0,2908194.12777441,-2908194.12777441
3679,Forks Over Knives,664747,0,664747,644404.440618553,0.0,644404.440618553
3680,Shark Night,10126458,28000000,-17873542,9816568.56358475,27143145.1925612,-17326576.62897645
3681,Teen Spirit,0,0,0,0.0,0.0,0.0
3682,United,0,0,0,0.0,0.0,0.0
3683,Take Me Home,0,0,0,0.0,0.0,0.0
3684,Largo Winch II,0,41000000,-41000000,0.0,39745319.7462503,-39745319.7462503
3685,Hobo with a Shotgun,672648,3000000,-2327352,652063.654553068,2908194.12777441,-2256130.473221342
3686,Madea's Big Happy Family,53213633,25000000,28213633,51585191.669380896,24234951.064786803,27350240.604594093
3687,The Decoy Bride,0,0,0,0.0,0.0,0.0
3688,S.W.A.T.: Firefight,0,0,0,0.0,0.0,0.0
3689,Touchback,0,0,0,0.0,0.0,0.0
3690,The Art of Flight,0,0,0,0.0,0.0,0.0
3691,Atlas Shrugged Part I,4627375,15000000,-10372625,4485768.26733671,14540970.638872,-10055202.37153529
3692,The Moth Diaries,3838,0,3838,3720.5496874660707,0.0,3720.5496874660707
3693,Albatross,0,0,0,0.0,0.0,0.0
3694,The Reunion,0,6000000,-6000000,0.0,5816388.25554883,-5816388.25554883
3695,Faces in the Crowd,0,15000000,-15000000,0.0,14540970.638872,-14540970.638872
3696,Zombie Apocalypse,0,0,0,0.0,0.0,0.0
3697,"Guns, Girls and Gambling",0,0,0,0.0,0.0,0.0
3698,This Must Be the Place,11790979,25000000,-13209021,11430151.9628371,24234951.064786803,-12804799.101949703
3699,Street Kings 2: Motor City,0,0,0,0.0,0.0,0.0
3700,Hawaiian Vacation,0,0,0,0.0,0.0,0.0
3701,Love's Kitchen,0,0,0,0.0,0.0,0.0
3702,Red Dog,0,0,0,0.0,0.0,0.0
3703,51,0,1000000,-1000000,0.0,969398.042591472,-969398.042591472
3704,La femme du VÃ¨me,0,0,0,0.0,0.0,0.0
3705,Little Birds,0,0,0,0.0,0.0,0.0
3706,Hidden 3D,0,8000000,-8000000,0.0,7755184.34073177,-7755184.34073177
3707,Barely Legal,0,1000000,-1000000,0.0,969398.042591472,-969398.042591472
3708,The Phantom of the Opera at the Royal Albert Hall,0,0,0,0.0,0.0,0.0
3709,Book of Dragons,0,0,0,0.0,0.0,0.0
3710,Dawn of the Dragonslayer,0,0,0,0.0,0.0,0.0
3711,There Be Dragons,0,0,0,0.0,0.0,0.0
3712,Doomsday Prophecy,0,0,0,0.0,0.0,0.0
3713,The Howling: Reborn,0,0,0,0.0,0.0,0.0
3714,PrÃ©sumÃ© coupable,0,6965576,-6965576,0.0,6752415.73992213,-6752415.73992213
3715,Emergo,0,0,0,0.0,0.0,0.0
3716,Arena,0,10000000,-10000000,0.0,9693980.42591472,-9693980.42591472
3717,Albert Nobbs,5634828,8000000,-2365172,5462391.23353962,7755184.34073177,-2292793.1071921494
3718,TT3D: Closer to the Edge,0,0,0,0.0,0.0,0.0
3719,The Big Bang,0,17000000,-17000000,0.0,16479766.724055,-16479766.724055
3720,Texas Killing Fields,957240,0,957240,927946.5822902609,0.0,927946.5822902609
3721,In Darkness,5576725,0,5576725,5406066.29907092,0.0,5406066.29907092
3722,Baciato dalla fortuna,0,0,0,0.0,0.0,0.0
3723,Wild Bill,0,0,0,0.0,0.0,0.0
3724,"Cougars, Inc.",0,1000000,-1000000,0.0,969398.042591472,-969398.042591472
3725,Cat Run,0,25000000,-25000000,0.0,24234951.064786803,-24234951.064786803
3726,Girl Walks Into a Bar,0,1000000,-1000000,0.0,969398.042591472,-969398.042591472
3727,DC Showcase: Catwoman,0,0,0,0.0,0.0,0.0
3728,One Life,0,0,0,0.0,0.0,0.0
3729,Monster Brawl,0,0,0,0.0,0.0,0.0
3730,Assassin's Creed: Embers,0,100000,-100000,0.0,96939.8042591472,-96939.8042591472
3731,All Things Fall Apart,0,0,0,0.0,0.0,0.0
3732,The Art of Getting By,1406224,0,1406224,1363190.79304515,0.0,1363190.79304515
3733,Snow Flower and the Secret Fan,1332231,134005,1198226,1291462.12367967,129904.18469747,1161557.9389822
3734,I Melt with You,0,0,0,0.0,0.0,0.0
3735,A Christmas Kiss,0,0,0,0.0,0.0,0.0
3736,Absentia,0,70000,-70000,0.0,67857.862981403,-67857.862981403
3737,Lady Gaga - Presents The Monster Ball Tour at Madison Square Garden,0,0,0,0.0,0.0,0.0
3738,Love,0,500000,-500000,0.0,484699.021295736,-484699.021295736
3739,Pariah,0,0,0,0.0,0.0,0.0
3740,The Lady,3759582,0,3759582,3644531.43176213,0.0,3644531.43176213
3741,The Entitled,0,0,0,0.0,0.0,0.0
3742,Les bien-aimÃ©s,0,8978040,-8978040,0.0,8703294.40230794,-8703294.40230794
3743,The Future,0,1000000,-1000000,0.0,969398.042591472,-969398.042591472
3744,Cyberbully,0,0,0,0.0,0.0,0.0
3745,"Happiness Is a Warm Blanket, Charlie Brown",0,0,0,0.0,0.0,0.0
3746,Little Deaths,0,0,0,0.0,0.0,0.0
3747,The River Murders,0,0,0,0.0,0.0,0.0
3748,L'Apollonide : Souvenirs de la Maison Close,0,0,0,0.0,0.0,0.0
3749,Bucky Larson: Born to Be a Star,0,10000000,-10000000,0.0,9693980.42591472,-9693980.42591472
3750,Cassadaga,0,0,0,0.0,0.0,0.0
3751,Enter Nowhere,0,0,0,0.0,0.0,0.0
3752,The Good Doctor,5206,6000000,-5994794,5046.6862097312,5816388.25554883,-5811341.569339099
3753,Salvation Boulevard,0,8000000,-8000000,0.0,7755184.34073177,-7755184.34073177
3754,Alyce Kills,0,0,0,0.0,0.0,0.0
3755,Weekend,469947,8000,461947,455565.70192173397,7755.18434073177,447810.5175810022
3756,The Witches of Oz,0,0,0,0.0,0.0,0.0
3757,Burn Notice: The Fall of Sam Axe,0,0,0,0.0,0.0,0.0
3758,Kill List,171760,500000,-328240,166503.807795511,484699.021295736,-318195.213500225
3759,Zeitgeist: Moving Forward,0,0,0,0.0,0.0,0.0
3760,è³½å¾·å…‹Â·å·´èŠ (ä¸Š)  å¤ªé™½æ——,0,25000000,-25000000,0.0,24234951.064786803,-24234951.064786803
3761,Hideaways,0,0,0,0.0,0.0,0.0
3762,The Chaperone,0,0,0,0.0,0.0,0.0
3763,Red Faction: Origins,0,0,0,0.0,0.0,0.0
3764,The Suite Life Movie,0,0,0,0.0,0.0,0.0
3765,Death of a Superhero,0,3,-3,0.0,2.90819412777441,-2.90819412777441
3766,Justin Bieber: Never Say Never,98441954,13000000,85441954,95429437.5164797,12602174.5536891,82827262.96279061
3767,Fase 7,0,600000,-600000,0.0,581638.825554883,-581638.825554883
3768,Portal: No Escape,0,0,0,0.0,0.0,0.0
3769,Megan is Missing,0,0,0,0.0,0.0,0.0
3770,Bunraku,0,25000000,-25000000,0.0,24234951.064786803,-24234951.064786803
3771,Bag of Bones,0,15000000,-15000000,0.0,14540970.638872,-14540970.638872
3772,Wonders of the Universe,0,0,0,0.0,0.0,0.0
3773,Born to Be Wild,7732325,0,7732325,7495700.719681099,0.0,7495700.719681099
3774,Fastest,0,1000000,-1000000,0.0,969398.042591472,-969398.042591472
3775,Evidence,0,0,0,0.0,0.0,0.0
3776,Good Neighbours,0,0,0,0.0,0.0,0.0
3777,Prep & Landing: Naughty vs. Nice,0,0,0,0.0,0.0,0.0
3778,Woody Allen: A Documentary,0,0,0,0.0,0.0,0.0
3779,Jeff Dunham: Controlled Chaos,0,0,0,0.0,0.0,0.0
3780,La guerre est dÃ©clarÃ©e,0,0,0,0.0,0.0,0.0
3781,The Captains,0,0,0,0.0,0.0,0.0
3782,Panic Button,0,0,0,0.0,0.0,0.0
3783,Memorial Day,0,4200000,-4200000,0.0,4071471.77888418,-4071471.77888418
3784,247Â°F,0,650000,-650000,0.0,630108.7276844571,-630108.7276844571
3785,Bellflower,101236,17000,84236,98137.9802397903,16479.766724055,81658.21351573529
3786,"Jeff, Who Lives at Home",4417580,10000000,-5582420,4282393.40499123,9693980.42591472,-5411587.02092349
3787,The Ballad of Nessie,0,0,0,0.0,0.0,0.0
3788,The Divide,22000,3000000,-2978000,21326.7569370123,2908194.12777441,-2886867.370837398
3789,6 Days to Air: The Making of South Park,0,0,0,0.0,0.0,0.0
3790,Magic Beyond Words: The JK Rowling Story,0,0,0,0.0,0.0,0.0
3791,The Deep Blue Sea,1126525,0,1126525,1092051.12993035,0.0,1092051.12993035
3792,La Nouvelle Guerre des boutons,0,0,0,0.0,0.0,0.0
3793,Wake Wood,0,0,0,0.0,0.0,0.0
3794,"Toi, moi, les autres",0,0,0,0.0,0.0,0.0
3795,Cherry,0,0,0,0.0,0.0,0.0
3796,Project Nim,0,0,0,0.0,0.0,0.0
3797,The Lost Valentine,0,0,0,0.0,0.0,0.0
3798,Life in a Day,225861,45202,180659,218949.211297752,43818.7303212197,175130.48097653227
3799,Blood Out,0,0,0,0.0,0.0,0.0
3800,Hetjur Valhallar - ÃžÃ³r,0,0,0,0.0,0.0,0.0
3801,X-Men: First Class,344420111,160000000,184420111,333880181.432537,155103686.814635,178776494.617902
3802,The Speed of Thought,0,2000000,-2000000,0.0,1938796.08518294,-1938796.08518294
3803,The Pool Boys,0,0,0,0.0,0.0,0.0
3804,Anuvahood,0,1000000,-1000000,0.0,969398.042591472,-969398.042591472
3805,Christopher and His Kind,0,0,0,0.0,0.0,0.0
3806,Thin Ice,790421,0,790421,766232.5702231941,0.0,766232.5702231941
3807,Chillerama,0,0,0,0.0,0.0,0.0
3808,Burning Man,0,0,0,0.0,0.0,0.0
3809,Nova Zembla,0,0,0,0.0,0.0,0.0
3810,"Good Luck Charlie, It's Christmas!",0,0,0,0.0,0.0,0.0
3811,Choose,0,0,0,0.0,0.0,0.0
3812,Age of the Dragons,0,5000000,-5000000,0.0,4846990.21295736,-4846990.21295736
3813,House of the Rising Sun,0,1500000,-1500000,0.0,1454097.0638872,-1454097.0638872
3814,Jiro Dreams of Sushi,2550508,0,2550508,2472457.46281389,0.0,2472457.46281389
3815,Quarantine 2: Terminal,0,4000000,-4000000,0.0,3877592.17036588,-3877592.17036588
3816,Amanda Knox: Murder on Trial in Italy,0,0,0,0.0,0.0,0.0
3817,Salvando al Soldado Perez,0,0,0,0.0,0.0,0.0
3818,Louis C.K.: Live at the Beacon Theater,1000000,250000,750000,969398.042591472,242349.510647868,727048.531943604
3819,I Am,0,0,0,0.0,0.0,0.0
3820,The Oranges,366377,0,366377,355165.146650535,0.0,355165.146650535
3821,The Whisperer in Darkness,0,0,0,0.0,0.0,0.0
3822,Sand Sharks,0,0,0,0.0,0.0,0.0
3823,The Theatre Bizarre,0,0,0,0.0,0.0,0.0
3824,Inbred,0,0,0,0.0,0.0,0.0
3825,Scream of the Banshee,0,2000000,-2000000,0.0,1938796.08518294,-1938796.08518294
3826,Kill Bill: The Whole Bloody Affair,0,30000000,-30000000,0.0,29081941.277744103,-29081941.277744103
3827,Division III: Football's Finest,0,0,0,0.0,0.0,0.0
3828,Episode 50,0,1340000,-1340000,0.0,1298993.37707257,-1298993.37707257
3829,Poupoupidou,0,0,0,0.0,0.0,0.0
3830,Page One: Inside the New York Times,429766,0,429766,416614.319172366,0.0,416614.319172366
3831,Suing The Devil,0,97,-97,0.0,94.0316101313728,-94.0316101313728
3832,Glee: The Concert Movie,18663238,9000000,9663238,18092106.385618698,8724582.38332325,9367524.002295448
3833,"A Fairly Odd Movie: Grow Up, Timmy Turner!",0,0,0,0.0,0.0,0.0
3834,The Ouija Experiment,0,0,0,0.0,0.0,0.0
3835,George Harrison: Living in the Material World,0,0,0,0.0,0.0,0.0
3836,A Haunting in Salem,0,0,0,0.0,0.0,0.0
3837,Seconds Apart,0,0,0,0.0,0.0,0.0
3838,H2O Just Add Water - The Movie,0,0,0,0.0,0.0,0.0
3839,Husk,0,0,0,0.0,0.0,0.0
3840,Conan O'Brien Can't Stop,223959,0,223959,217105.416220743,0.0,217105.416220743
3841,Elephant White,0,10000000,-10000000,0.0,9693980.42591472,-9693980.42591472
3842,Eames: The Architect & The Painter,0,0,0,0.0,0.0,0.0
3843,Eating Out: Drama Camp,0,0,0,0.0,0.0,0.0
3844,ChromeSkull: Laid to Rest 2,0,0,0,0.0,0.0,0.0
3845,Thor - Tales of Asgard,3100000,0,3100000,3005133.93203356,0.0,3005133.93203356
3846,Undefeated,0,0,0,0.0,0.0,0.0
3847,Sacrifice,0,6800000,-6800000,0.0,6591906.68962201,-6591906.68962201
3848,Girl Model,0,0,0,0.0,0.0,0.0
3849,DeadHeads,0,0,0,0.0,0.0,0.0
3850,CafÃ©,0,0,0,0.0,0.0,0.0
3851,Lucky,0,0,0,0.0,0.0,0.0
3852,Poolboy - Drowning Out the Fury,0,0,0,0.0,0.0,0.0
3853,William & Kate,15,20,-5,14.540970638872,19.387960851829398,-4.846990212957397
3854,First Position,0,0,0,0.0,0.0,0.0
3855,La Guerre Des Boutons,0,0,0,0.0,0.0,0.0
3856,Vile,0,0,0,0.0,0.0,0.0
3857,Cell 213,0,0,0,0.0,0.0,0.0
3858,A Warrior's Heart,0,2500000,-2500000,0.0,2423495.10647868,-2423495.10647868
3859,A Holiday Engagement,0,0,0,0.0,0.0,0.0
3860,Miss Representation,0,750000,-750000,0.0,727048.5319436041,-727048.5319436041
3861,Talking Funny,0,0,0,0.0,0.0,0.0
3862,Desperately Seeking Santa,0,0,0,0.0,0.0,0.0
3863,Manborg,0,0,0,0.0,0.0,0.0
3864,Being Elmo: A Puppeteer's Journey,286201,0,286201,277442.689187722,0.0,277442.689187722
3865,The Devil's Rock,0,0,0,0.0,0.0,0.0
3866,Foo Fighters: Back and Forth,0,0,0,0.0,0.0,0.0
3867,Les tribulations d'une caissiÃ¨re,0,0,0,0.0,0.0,0.0
3868,Paradise Lost 3: Purgatory,0,0,0,0.0,0.0,0.0
3869,Steve Jobs: Billion Dollar Hippy,0,0,0,0.0,0.0,0.0
3870,96 Minutes,0,0,0,0.0,0.0,0.0
3871,Happy,0,700000,-700000,0.0,678578.62981403,-678578.62981403
3872,5 Broken Cameras,0,0,0,0.0,0.0,0.0
3873,Some Guy Who Kills People,0,300000,-300000,0.0,290819.41277744103,-290819.41277744103
3874,The Bling Ring,0,0,0,0.0,0.0,0.0
3875,My Future Boyfriend,0,0,0,0.0,0.0,0.0
3876,The Fantastic Flying Books of Mr Morris Lessmore,0,0,0,0.0,0.0,0.0
3877,The Amityville Haunting,0,0,0,0.0,0.0,0.0
3878,The Greatest Movie Ever Sold,621951,0,621951,602918.081987808,0.0,602918.081987808
3879,Griff the Invisible,0,2902660,-2902660,0.0,2813832.92230856,-2813832.92230856
3880,These Amazing Shadows,0,0,0,0.0,0.0,0.0
3881,Into the Abyss,0,0,0,0.0,0.0,0.0
3882,October Baby,5355847,0,5355847,5191947.59821941,0.0,5191947.59821941
3883,Chillar Party,0,0,0,0.0,0.0,0.0
3884,eCupid,0,0,0,0.0,0.0,0.0
3885,Hollow,0,0,0,0.0,0.0,0.0
3886,Mildred Pierce,0,20000000,-20000000,0.0,19387960.8518294,-19387960.8518294
3887,The Legend of Awesomest Maximus,0,0,0,0.0,0.0,0.0
3888,Fertile Ground,0,0,0,0.0,0.0,0.0
3889,Suburban Knights,0,0,0,0.0,0.0,0.0
3890,Elle: A Modern Cinderella Tale,0,250000,-250000,0.0,242349.510647868,-242349.510647868
3891,Scrat's Continental Crack-Up: Part 2,0,0,0,0.0,0.0,0.0
3892,Bobby Fischer Against the World,0,0,0,0.0,0.0,0.0
3893,We Were Here,0,0,0,0.0,0.0,0.0
3894,The Story of Film: An Odyssey,0,0,0,0.0,0.0,0.0
3895,Blinkyâ„¢,0,61733,-61733,0.0,59843.8493632993,-59843.8493632993
3896,Les Neiges du Kilimandjaro,0,0,0,0.0,0.0,0.0
3897,Donald Glover: Weirdo,0,0,0,0.0,0.0,0.0
3898,Kevin Hart: Laugh at My Pain,0,0,0,0.0,0.0,0.0
3899,Dear Santa,0,0,0,0.0,0.0,0.0
3900,Dhobi Ghat,0,0,0,0.0,0.0,0.0
3901,The Other F Word,0,0,0,0.0,0.0,0.0
3902,The Maker,0,0,0,0.0,0.0,0.0
3903,Une bouteille Ã  la mer,0,0,0,0.0,0.0,0.0
3904,You Instead,0,0,0,0.0,0.0,0.0
3905,Dreams of a Life,0,0,0,0.0,0.0,0.0
3906,Pearl Jam: Twenty,0,0,0,0.0,0.0,0.0
3907,There's Something Wrong with Aunt Diane,0,0,0,0.0,0.0,0.0
3908,August,0,0,0,0.0,0.0,0.0
3909,The Pill,0,0,0,0.0,0.0,0.0
3910,Steve Jobs: One Last Thing,0,0,0,0.0,0.0,0.0
3911,The Lord of the Rings: The Two Towers,926287400,79000000,847287400,1122902454.41715,95768650.0960232,1027133804.3211268
3912,Harry Potter and the Chamber of Secrets,876688482,100000000,776688482,1062775600.9604,121226139.362054,941549461.598346
3913,Ice Age,383257136,59000000,324257136,464607829.802379,71523422.2236122,393084407.5787668
3914,The Bourne Identity,214034224,60000000,154034224,259465426.668732,72735683.6172328,186729743.0514992
3915,Resident Evil,102441078,33000000,69441078,124185363.980271,40004625.989478,84180737.99079299
3916,Spider-Man,821708551,139000000,682708551,996125553.1851801,168504333.713256,827621219.4719241
3917,Star Wars: Episode II - Attack of the Clones,649398328,120000000,529398328,787240522.116133,145471367.234465,641769154.881668
3918,Catch Me If You Can,352114312,52000000,300114312,426854586.57886,63037592.468268394,363816994.1105916
3919,Men in Black II,441818803,140000000,301818803,535599877.852542,169716595.10687602,365883282.74566597
3920,The Pianist,120072577,35000000,85072577,145559349.52963,42429148.7767191,103130200.75291091
3921,Minority Report,358372926,102000000,256372926,434441662.708633,123650662.149295,310791000.559338
3922,Lilo & Stitch,145771527,80000000,65771527,176713194.47121498,96980911.48964371,79732282.98157127
3923,The Transporter,43928932,21000000,22928932,53253348.3265822,25457489.2660314,27795859.0605508
3924,xXx,277448382,70000000,207448382,336339962.221085,84858297.55343829,251481664.6676467
3925,Treasure Planet,109578115,140000000,-30421885,132837318.400212,169716595.10687602,-36879276.70666401
3926,Die Another Day,431971116,140000000,291971116,523661907.085983,169716595.10687602,353945311.97910696
3927,28 Days Later...,82719885,5000000,77719885,100278123.070231,6061306.96810273,94216816.10212828
3928,Maid in Manhattan,154906693,55000000,99906693,187787403.53733,66674376.64913,121113026.8882
3929,Blade II,155010032,54000000,101010032,187912677.417485,65462115.255509496,122450562.1619755
3930,Gangs of New York,193772504,100000000,93772504,234902925.744383,121226139.362054,113676786.382329
3931,Panic Room,196397415,48000000,148397415,238085004.01137203,58188546.89378621,179896457.11758584
3932,Stuart Little 2,169956806,120000000,49956806,206032074.49685702,145471367.234465,60560707.262392014
3933,National Lampoonâ€™s Van Wilder,38275483,5000000,33275483,46399890.363079496,6061306.96810273,40338583.394976765
3934,8 Mile,215000000,41000000,174000000,260636199.628417,49702717.138442405,210933482.4899746
3935,Mr. Deeds,171269535,50000000,121269535,207623445.183843,60613069.68102729,147010375.5028157
3936,Bend It Like Beckham,76578641,3500159,73078482,92833330.0602275,4243107.6272335,88590222.432994
3937,Cinderella II: Dreams Come True,0,5000000,-5000000,0.0,6061306.96810273,-6061306.96810273
3938,Two Weeks Notice,93354918,60000000,33354918,113170562.996011,72735683.6172328,40434879.378778204
3939,Signs,408247917,72000000,336247917,494903188.805105,87282820.3406793,407620368.4644257
3940,The Ring,249348933,48000000,201348933,302276085.01637596,58188546.89378621,244087538.12258977
3941,Home Alone 4,0,0,0,0.0,0.0,0.0
3942,A Walk to Remember,41227069,11000000,30227069,49977984.120830394,13334875.329826,36643108.7910044
3943,My Big Fat Greek Wedding,368744044,5000000,363744044,447014168.668716,6061306.96810273,440952861.70061326
3944,About a Boy,129000000,27000000,102000000,156381719.77705,32731057.6277547,123650662.14929529
3945,The Hunchback of Notre Dame II,0,0,0,0.0,0.0,0.0
3946,Collateral Damage,78382433,85000000,-6617567,95019997.4639491,103042218.457746,-8022220.9937969
3947,Phone Booth,97837138,13000000,84837138,118604185.259725,15759398.117067099,102844787.1426579
3948,Star Trek: Nemesis,67312826,60000000,7312826,81600740.25529741,72735683.6172328,8865056.638064608
3949,Equilibrium,5359645,20000000,-14640355,6497290.71701139,24245227.872410897,-17747937.15539951
3950,The Good Girl,16856124,8000000,8856124,20434028.3712807,9698091.14896437,10735937.22231633
3951,The Hours,108846072,25000000,83846072,131949890.93284199,30306534.8405136,101643356.09232838
3952,Road to Perdition,181001478,80000000,101001478,219421103.967658,96980911.48964371,122440192.4780143
3953,Austin Powers in Goldmember,296633907,63000000,233633907,359597833.494927,76372467.7980944,283225365.6968326
3954,The Santa Clause 2,172855065,65000000,107855065,209545521.99127,78796990.5853355,130748531.40593451
3955,Insomnia,113714830,46000000,67714830,137852098.291123,55764024.106545106,82088074.1845779
3956,Ghost Ship,68349884,35000000,33349884,82857925.6316427,42429148.7767191,40428776.8549236
3957,Scooby-Doo,275650703,84000000,191650703,334160705.37126297,101829957.064125,232330748.30713797
3958,The Tuxedo,0,0,0,0.0,0.0,0.0
3959,Spirit: Stallion of the Cimarron,122563539,80000000,42563539,148579046.595206,96980911.48964371,51598135.105562285
3960,D-Tox,6416302,55000000,-48583698,7778235.2044103,66674376.64913,-58896141.4447197
3961,Secretary,9304609,0,9304609,11279618.2734342,0.0,11279618.2734342
3962,The Scorpion King,165333180,60000000,105333180,200427031.19851598,72735683.6172328,127691347.58128318
3963,I Spy,33561137,70000000,-36438863,40684870.7111101,84858297.55343829,-44173426.84232819
3964,Bowling for Columbine,35564473,4000000,31564473,43113437.60236029,4849045.57448218,38264392.02787811
3965,25th Hour,13060843,15000000,-1939157,15833155.737039099,18183920.9043082,-2350765.1672691014
3966,Ken Park,447741,1300000,-852259,542779.1286410571,1575939.81170671,-1033160.6830656528
3967,Tarzan & Jane,0,0,0,0.0,0.0,0.0
3968,The Sum of All Fears,193,68,125,233.96644896876498,82.4337747661972,151.53267420256776
3969,The 51st State,0,28,-28,0.0,33.943319021375295,-33.943319021375295
3970,We Were Soldiers,114660784,75000000,39660784,138998841.805464,90919604.521541,48079237.283923
3971,Jackass: The Movie,64282312,5000000,59282312,77926965.1302708,6061306.96810273,71865658.16216807
3972,The Hot Chick,35081550,0,35081550,42528008.6933689,0.0,42528008.6933689
3973,Frida,56298474,12000000,44298474,68248466.5499501,14547136.7234465,53701329.82650359
3974,Murder by Numbers,56714147,50000000,6714147,68752370.8802205,60613069.68102729,8139301.199193209
3975,Adaptation.,32801173,19000000,13801173,39763595.693368606,23032966.4787903,16730629.214578304
3976,Sweet Home Alabama,180622424,30000000,150622424,218961591.437361,36367841.8086164,182593749.6287446
3977,Barbershop,75781642,12000000,63781642,91867158.9417733,14547136.7234465,77320022.21832679
3978,Dark Blue,9237470,15000000,-5762530,11198228.2557279,18183920.9043082,-6985692.6485803
3979,The Time Machine,123729176,80000000,43729176,149992103.329281,96980911.48964371,53011191.839637294
3980,Undisputed,12398628,20000000,-7601372,15030378.058262698,24245227.872410897,-9214849.814148199
3981,The Sweetest Thing,68696770,43000000,25696770,83278442.13743009,52127239.925683506,31151202.21174658
3982,The Guru,0,0,0,0.0,0.0,0.0
3983,Windtalkers,77628265,115000000,-37371735,94105748.7132451,139410060.266362,-45304311.55311692
3984,John Q,102244770,36000000,66244770,123947387.37061201,43641410.1703396,80305977.20027241
3985,Winnie the Pooh: A Very Merry Pooh Year,0,0,0,0.0,0.0,0.0
3986,40 Days and 40 Nights,0,17000000,-17000000,0.0,20608443.6915493,-20608443.6915493
3987,Barbie as Rapunzel,0,0,0,0.0,0.0,0.0
3988,Unfaithful,119137784,50000000,69137784,144426136.06470302,60613069.68102729,83813066.38367572
3989,Changing Lanes,94935764,45000000,49935764,115086961.571071,54551762.7129246,60535198.8581464
3990,Punch-Drunk Love,17000000,25000000,-8000000,20608443.6915493,30306534.8405136,-9698091.148964297
3991,K-19: The Widowmaker,35168966,100000000,-64831034,42633979.735353604,121226139.362054,-78592159.6267004
3992,Snow Queen,0,0,0,0.0,0.0,0.0
3993,Eight Legged Freaks,0,0,0,0.0,0.0,0.0
3994,Cube 2: Hypercube,0,0,0,0.0,0.0,0.0
3995,Queen of the Damned,45479110,35000000,10479110,55132569.26922211,42429148.7767191,12703420.49250301
3996,Spy Kids 2: Island of Lost Dreams,119723358,38000000,81723358,145136004.81801102,46065932.9575807,99070071.86043032
3997,The Land Before Time IX: Journey to the Big Water,0,0,0,0.0,0.0,0.0
3998,Enough,51801187,38000000,13801187,62796579.143818505,46065932.9575807,16730646.186237805
3999,Friday After Next,33526835,20000000,13526835,40643287.7207861,24245227.872410897,16398059.848375205
4000,Return to Never Land,109862682,20000000,89862682,133182287.988211,24245227.872410897,108937060.11580011
4001,Nicholas Nickleby,0,0,0,0.0,0.0,0.0
4002,Life or Something Like It,16872671,40000000,-23127329,20454087.6605609,48490455.744821794,-28036368.084260896
4003,Slackers,6413915,14000000,-7586085,7775341.53646373,16971659.5106876,-9196317.97422387
4004,Sorority Boys,0,12000000,-12000000,0.0,14547136.7234465,-14547136.7234465
4005,Interstate 60,0,7000000,-7000000,0.0,8485829.75534383,-8485829.75534383
4006,Chicago,306776732,45000000,261776732,371893588.664677,54551762.7129246,317341825.9517524
4007,One Hour Photo,52223306,12000000,40223306,63308297.711032204,14547136.7234465,48761160.98758571
4008,Femme Fatale,16838910,35000000,-18161090,20413160.503650896,42429148.7767191,-22015988.273068205
4009,Eight Crazy Nights,23833131,0,23833131,28891984.600401,0.0,28891984.600401
4010,City By The Sea,22433915,40000000,-17566085,27195769.0622648,48490455.744821794,-21294686.682556994
4011,Ali G Indahouse,0,0,0,0.0,0.0,0.0
4012,Darkness,0,0,0,0.0,0.0,0.0
4013,Reign of Fire,43061982,60000000,-16938018,52202378.3113829,72735683.6172328,-20533305.305849902
4014,Showtime,77741732,85000000,-7258268,94243300.376795,103042218.457746,-8798918.080951005
4015,S1m0ne,19576023,0,19576023,23731256.923527803,0.0,23731256.923527803
4016,High Crimes,63781810,42000000,21781810,77320225.87824091,50914978.532062896,26405247.346178018
4017,Moonlight Mile,10011050,21000000,-10988950,12136009.424604902,25457489.2660314,-13321479.841426497
4018,Hart's War,32287044,70000000,-37712956,39140336.9553279,84858297.55343829,-45717960.59811039
4019,About Schmidt,105834556,30000000,75834556,128299146.349771,36367841.8086164,91931304.5411546
4020,Blue Crush,51842679,25000000,26842679,62846878.2935626,30306534.8405136,32540343.453049
4021,Blood Work,26199517,50000000,-23800483,31760662.9906052,60613069.68102729,-28852406.69042209
4022,Solaris,30002758,47000000,-16997242,36371185.225540005,56976285.5001657,-20605100.274625696
4023,The Banger Sisters,0,10000000,-10000000,0.0,12122613.9362054,-12122613.9362054
4024,The Four Feathers,29882645,35000000,-5117355,36225576.872768,42429148.7767191,-6203571.903951101
4025,The Quiet American,27674124,30000000,-2325876,33548272.127467796,36367841.8086164,-2819569.6811486036
4026,Balto II: Wolf Quest,0,0,0,0.0,0.0,0.0
4027,The Magdalene Sisters,20957001,0,20957001,25405363.2383672,0.0,25405363.2383672
4028,The New Guy,0,13000000,-13000000,0.0,15759398.117067099,-15759398.117067099
4029,The Mothman Prophecies,55157539,32000000,23157539,66865355.0968196,38792364.5958575,28072990.5009621
4030,Dinotopia,0,0,0,0.0,0.0,0.0
4031,Snow Dogs,0,33000000,-33000000,0.0,40004625.989478,-40004625.989478
4032,Far from Heaven,29027914,13500000,15527914,35189419.4795373,16365528.813877301,18823890.66566
4033,The Rookie,75597042,20000000,55597042,91643375.488511,24245227.872410897,67398147.6161001
4034,Bad Company,65977295,70000000,-4022705,79981727.58401391,84858297.55343829,-4876569.969424382
4035,Sniper 2,0,5000000,-5000000,0.0,6061306.96810273,-6061306.96810273
4036,Confessions of a Dangerous Mind,33013805,30000000,3013805,40021361.2580169,36367841.8086164,3653519.4494004995
4037,The Rules of Attraction,0,4000000,-4000000,0.0,4849045.57448218,-4849045.57448218
4038,My Little Eye,0,3000000,-3000000,0.0,3636784.18086164,-3636784.18086164
4039,Hellraiser: Hellseeker,0,3000000,-3000000,0.0,3636784.18086164,-3636784.18086164
4040,Killing Me Softly,0,0,0,0.0,0.0,0.0
4041,Taken,0,0,0,0.0,0.0,0.0
4042,Ballistic: Ecks vs. Sever,19924033,70000000,-50075967,24153136.011121698,84858297.55343829,-60705161.54231659
4043,Analyze That,0,0,0,0.0,0.0,0.0
4044,Trapped,6916869,30000000,-23083131,8385053.25343076,36367841.8086164,-27982788.55518564
4045,Derailed,0,0,0,0.0,0.0,0.0
4046,Hollywood Ending,0,16000000,-16000000,0.0,19396182.2979287,-19396182.2979287
4047,Spun,0,2000000,-2000000,0.0,2424522.78724109,-2424522.78724109
4048,Clockstoppers,38793283,26000000,12793283,47027599.3126962,31518796.234134197,15508803.078562006
4049,Halloween: Resurrection,37664855,13000000,24664855,45659649.6128158,15759398.117067099,29900251.4957487
4050,Salton Sea,676698,18000000,-17323302,820334.860540237,21820705.0851698,-21000370.224629562
4051,Dog Soldiers,0,0,0,0.0,0.0,0.0
4052,The House on Turk Street,0,12000000,-12000000,0.0,14547136.7234465,-14547136.7234465
4053,Big Fat Liar,52970014,15000000,37970014,64213502.991739795,18183920.9043082,46029582.087431595
4054,The Count of Monte Cristo,75395048,0,75395048,91398505.96056801,0.0,91398505.96056801
4055,Narc,12633747,6500000,6133747,15315403.7448694,7879699.05853355,7435704.68633585
4056,Space Station 3D,0,0,0,0.0,0.0,0.0
4057,Rollerball,0,0,0,0.0,0.0,0.0
4058,They,0,17000000,-17000000,0.0,20608443.6915493,-20608443.6915493
4059,The Skulls II,0,3800000,-3800000,0.0,4606593.29575807,-4606593.29575807
4060,All or Nothing,0,9000000,-9000000,0.0,10910352.5425849,-10910352.5425849
4061,Gone Nutty,0,0,0,0.0,0.0,0.0
4062,Brown Sugar,27362712,8000000,19362712,33170759.382357597,9698091.14896437,23472668.23339323
4063,Madea's Family Reunion,0,6000000,-6000000,0.0,7273568.36172328,-7273568.36172328
4064,Divine Secrets of the Ya-Ya Sisterhood,0,27000000,-27000000,0.0,32731057.6277547,-32731057.6277547
4065,Antwone Fisher,23367586,12500000,10867586,28327622.369907897,15153267.4202568,13174354.949651098
4066,Try Seventeen,0,0,0,0.0,0.0,0.0
4067,24 Hour Party People,0,0,0,0.0,0.0,0.0
4068,Babylon 5: The Legend of the Rangers - To Live and Die in Starlight,0,0,0,0.0,0.0,0.0
4069,Cadet Kelly,0,0,0,0.0,0.0,0.0
4070,Igby Goes Down,4777465,9000000,-4222535,5791536.37887338,10910352.5425849,-5118816.16371152
4071,Liberty Stands Still,0,11000000,-11000000,0.0,13334875.329826,-13334875.329826
4072,Swept Away,598645,10000000,-9401355,725714.221983972,12122613.9362054,-11396899.71422143
4073,Rabbit-Proof Fence,0,0,0,0.0,0.0,0.0
4074,Boat Trip,8586376,20000000,-11413624,10408932.13591,24245227.872410897,-13836295.736500897
4075,White Oleander,0,0,0,0.0,0.0,0.0
4076,May,150277,500000,-349723,182175.005449114,606130.696810273,-423955.69136115897
4077,Crossroads,61141030,12000000,49141030,74118910.23519559,14547136.7234465,59571773.51174909
4078,The Adventures of Pluto Nash,7103973,100000000,-92896027,8611872.20922274,121226139.362054,-112614267.15283127
4079,Ripley's Game,0,30000000,-30000000,0.0,36367841.8086164,-36367841.8086164
4080,Abandon,10719357,25000000,-14280643,12994662.655536098,30306534.8405136,-17311872.1849775
4081,Heaven,0,11000000,-11000000,0.0,13334875.329826,-13334875.329826
4082,Firestarter 2: Rekindled,0,10000000,-10000000,0.0,12122613.9362054,-12122613.9362054
4083,Long Time Dead,13102295,0,13102295,15883406.3963275,0.0,15883406.3963275
4084,Doctor Zhivago,0,0,0,0.0,0.0,0.0
4085,Spider,0,0,0,0.0,0.0,0.0
4086,Deathwatch,0,0,0,0.0,0.0,0.0
4087,Red Dragon,209196298,78000000,131196298,253600595.753739,94556388.70240259,159044207.0513364
4088,Laurel Canyon,0,0,0,0.0,0.0,0.0
4089,Serving Sara,16930185,29000000,-12069815,20523809.6623536,35155580.414995804,-14631770.752642203
4090,Bloody Sunday,773228,0,773228,937354.452866428,0.0,937354.452866428
4091,Tom and Jerry: The Magic Ring,0,0,0,0.0,0.0,0.0
4092,Dragonfly,52322400,60000000,-7677600,63428425.54157171,72735683.6172328,-9307258.075661093
4093,Shottas,0,200000,-200000,0.0,242452.278724109,-242452.278724109
4094,Drumline,57588485,20000000,37588485,69812297.0825959,24245227.872410897,45567069.210185006
4095,The Importance of Being Earnest,0,0,0,0.0,0.0,0.0
4096,Like Mike,0,30000000,-30000000,0.0,36367841.8086164,-36367841.8086164
4097,Gerry,0,3500000,-3500000,0.0,4242914.87767191,-4242914.87767191
4098,Rose Red,0,0,0,0.0,0.0,0.0
4099,The Dangerous Lives of Altar Boys,0,0,0,0.0,0.0,0.0
4100,Hey Arnold! The Movie,0,0,0,0.0,0.0,0.0
4101,Carrie,0,0,0,0.0,0.0,0.0
4102,The Emperor's Club,0,0,0,0.0,0.0,0.0
4103,How to Kill Your Neighbor's Dog,0,0,0,0.0,0.0,0.0
4104,Half Past Dead,0,13000000,-13000000,0.0,15759398.117067099,-15759398.117067099
4105,Welcome to Collinwood,0,1200000,-1200000,0.0,1454713.67234465,-1454713.67234465
4106,Dirty Pretty Things,0,0,0,0.0,0.0,0.0
4107,K-9: P.I.,0,0,0,0.0,0.0,0.0
4108,Amen.,0,0,0,0.0,0.0,0.0
4109,Get a Clue,0,0,0,0.0,0.0,0.0
4110,The Truth About Charlie,0,0,0,0.0,0.0,0.0
4111,Orange County,0,0,0,0.0,0.0,0.0
4112,Run Ronnie Run,0,0,0,0.0,0.0,0.0
4113,All About the Benjamins,25482931,14000000,11482931,30891973.447596196,16971659.5106876,13920313.936908595
4114,Avenging Angelo,0,0,0,0.0,0.0,0.0
4115,FearDotCom,18902015,40000000,-21097985,22914183.046136398,48490455.744821794,-25576272.698685396
4116,Air Bud: Seventh Inning Fetch,0,0,0,0.0,0.0,0.0
4117,Dahmer,0,0,0,0.0,0.0,0.0
4118,The Wild Thornberrys Movie,0,35000000,-35000000,0.0,42429148.7767191,-42429148.7767191
4119,Auto Focus,2062066,7000000,-4937934,2499763.00289754,8485829.75534383,-5986066.75244629
4120,The Powerpuff Girls,11411644,10000000,1411644,13833895.4589415,12122613.9362054,1711281.5227361005
4121,Buying the Cow,0,0,0,0.0,0.0,0.0
4122,Bubba Ho-tep,0,1000000,-1000000,0.0,1212261.39362054,-1212261.39362054
4123,Possession,10113733,25000000,-14886267,12260488.0612861,30306534.8405136,-18046046.7792275
4124,When in Rome,0,0,0,0.0,0.0,0.0
4125,Evelyn,0,0,0,0.0,0.0,0.0
4126,Juwanna Mann,0,15600000,-15600000,0.0,18911277.740480497,-18911277.740480497
4127,Naqoyqatsi,13308,3000000,-2986692,16132.7746263022,3636784.18086164,-3620651.4062353377
4128,Full Frontal,2506446,2000000,506446,3038467.72099464,2424522.78724109,613944.93375355
4129,Repli-Kate,0,4000000,-4000000,0.0,4849045.57448218,-4849045.57448218
4130,The Crocodile Hunter: Collision Course,33082548,0,33082548,40104695.7429986,0.0,40104695.7429986
4131,Death to Smoochy,0,55000000,-55000000,0.0,66674376.64913,-66674376.64913
4132,Big Trouble,8493890,40000000,-31506110,10296814.9286596,48490455.744821794,-38193640.8161622
4133,American Psycho 2: All American Girl,0,10000000,-10000000,0.0,12122613.9362054,-12122613.9362054
4134,Kung Pow: Enter the Fist,0,0,0,0.0,0.0,0.0
4135,Saathiya,0,0,0,0.0,0.0,0.0
4136,Highway,0,14000000,-14000000,0.0,16971659.5106876,-16971659.5106876
4137,Swimfan,0,8500000,-8500000,0.0,10304221.8457746,-10304221.8457746
4138,A Time for Dancing,0,0,0,0.0,0.0,0.0
4139,2009 ë¡œìŠ¤íŠ¸ë©”ëª¨ë¦¬ì¦ˆ,0,0,0,0.0,0.0,0.0
4140,Spellbound,0,0,0,0.0,0.0,0.0
4141,Undercover Brother,41604473,25000000,16604473,50435496.4198284,30306534.8405136,20128961.5793148
4142,Left Behind II: Tribulation Force,0,0,0,0.0,0.0,0.0
4143,Below,605562,0,605562,734099.434043645,0.0,734099.434043645
4144,Ted Bundy,0,0,0,0.0,0.0,0.0
4145,Riders,0,0,0,0.0,0.0,0.0
4146,Better Luck Tomorrow,0,0,0,0.0,0.0,0.0
4147,Lost in La Mancha,0,0,0,0.0,0.0,0.0
4148,Morvern Callar,0,0,0,0.0,0.0,0.0
4149,Getting There,0,0,0,0.0,0.0,0.0
4150,People I Know,0,20000000,-20000000,0.0,24245227.872410897,-24245227.872410897
4151,Max,0,11000000,-11000000,0.0,13334875.329826,-13334875.329826
4152,Ã”nibus 174,217201,0,217201,263304.386955776,0.0,263304.386955776
4153,Le fils,0,0,0,0.0,0.0,0.0
4154,Rabbits,0,0,0,0.0,0.0,0.0
4155,Tuck Everlasting,0,0,0,0.0,0.0,0.0
4156,Roger Dodger,1260761,0,1260761,1528371.88688243,0.0,1528371.88688243
4157,Los lunes al sol,146402,4000000,-3853598,177477.492548835,4849045.57448218,-4671568.081933346
4158,Bang Bang You're Dead,0,0,0,0.0,0.0,0.0
4159,John Carpenterâ€™s Vampires: Los Muertos,0,0,0,0.0,0.0,0.0
4160,The Third Wheel,0,0,0,0.0,0.0,0.0
4161,Stealing Harvard,0,0,0,0.0,0.0,0.0
4162,3 zÃ©ros,0,0,0,0.0,0.0,0.0
4163,Plots with a View,0,0,0,0.0,0.0,0.0
4164,The Century of the Self,0,0,0,0.0,0.0,0.0
4165,The Master of Disguise,0,0,0,0.0,0.0,0.0
4166,Sweet Sixteen,0,0,0,0.0,0.0,0.0
4167,Deuces Wild,0,0,0,0.0,0.0,0.0
4168,Inuyasha: Kagami no Naka no MugenjÅ,0,0,0,0.0,0.0,0.0
4169,Ping Pong,0,0,0,0.0,0.0,0.0
4170,Is It College Yet?,0,0,0,0.0,0.0,0.0
4171,VeggieTales: Jonah,0,0,0,0.0,0.0,0.0
4172,Wishmaster 4: The Prophecy Fulfilled,0,0,0,0.0,0.0,0.0
4173,Kaante,0,0,0,0.0,0.0,0.0
4174,An Evening with Kevin Smith,0,0,0,0.0,0.0,0.0
4175,Biggie and Tupac,0,0,0,0.0,0.0,0.0
4176,The Kid Stays in the Picture,1434436,40000,1394436,1738911.38441948,48490.4557448218,1690420.9286746583
4177,Pulp Fiction,213928762,8000000,205928762,314713075.136581,11768892.492785301,302944182.6437957
4178,The Shawshank Redemption,28341469,25000000,3341469,41693462.718575895,36777789.039954,4915673.678621896
4179,Forrest Gump,677945399,55000000,622945399,997333314.6011789,80911135.8878989,916422178.71328
4180,The Lion King,788241776,45000000,743241776,1159591590.00826,66200020.2719173,1093391569.7363427
4181,Speed,350448145,30000000,320448145,515548317.850129,44133346.847944796,471414971.0021842
4182,Dumb and Dumber,247275374,17000000,230275374,363769661.58990896,25008896.5471687,338760765.0427403
4183,The Naked Gun 33â…“: The Final Insult,51132598,30000000,21132598,75221756.0923511,44133346.847944796,31088409.244406298
4184,Interview with the Vampire,223664608,60000000,163664608,329035590.74912,88266693.6958897,240768897.0532303
4185,The Return of Jafar,0,0,0,0.0,0.0,0.0
4186,True Lies,378882411,115000000,263882411,557378295.3082861,169177829.58378798,388200465.7244981
4187,The Mask,351583407,23000000,328583407,517218414.903772,33835565.916757695,483382848.9870143
4188,Maverick,0,0,0,0.0,0.0,0.0
4189,Stargate,196567262,55000000,141567262,289172371.759895,80911135.8878989,208261235.8719961
4190,Clear and Present Danger,215887717,62000000,153887717,317594916.48573196,91208916.819086,226385999.66664594
4191,Natural Born Killers,50282766,34000000,16282766,73971558.411735,50017793.0943375,23953765.317397498
4192,Clerks,3151130,27000,3124130,4635663.77509881,39720.0121631503,4595943.76293566
4193,Beverly Hills Cop III,119208989,50000000,69208989,175369721.964328,73555578.07990809,101814143.8844199
4194,The Santa Clause,189833357,22000000,167833357,279266046.259691,32364454.3551595,246901591.9045315
4195,Legends of the Fall,160638883,30000000,130638883,236317718.023514,44133346.847944796,192184371.1755692
4196,Blown Away,30156002,0,30156002,44362843.19377729,0.0,44362843.19377729
4197,Four Weddings and a Funeral,254700832,6000000,248700832,374693338.703871,8826669.36958897,365866669.33428204
4198,The Stand,0,28000000,-28000000,0.0,41191123.7247485,-41191123.7247485
4199,D2: The Mighty Ducks,45610410,0,45610410,67098001.480232395,0.0,67098001.480232395
4200,The Client,117615211,45000000,72615211,173025096.72190702,66200020.2719173,106825076.44998972
4201,The Crow,94000000,15000000,79000000,138284486.790227,22066673.423972398,116217813.3662546
4202,RiÂ¢hie RiÂ¢h,0,40000000,-40000000,0.0,58844462.4639265,-58844462.4639265
4203,The Flintstones,341631208,46000000,295631208,502577619.891546,67671131.83351551,434906488.0580305
4204,Miracle on 34th Street,46264384,0,46264384,68060070.192617,0.0,68060070.192617
4205,Star Trek: Generations,120000000,38000000,82000000,176533387.391779,55902239.3407301,120631148.0510489
4206,Ace Ventura: Pet Detective,107217396,15000000,92217396,157728750.860048,22066673.423972398,135662077.4360756
4207,It Could Happen to You,0,0,0,0.0,0.0,0.0
4208,Police Academy: Mission to Moscow,126247,0,126247,185723.421317083,0.0,185723.421317083
4209,Disclosure,214015089,55000000,159015089,314840071.784359,80911135.8878989,233928935.89646006
4210,Junior,37000000,60000000,-23000000,54431127.779132,88266693.6958897,-33835565.916757695
4211,New Nightmare,18090181,14000000,4090181,26612674.4205034,20595561.8623742,6017112.558129199
4212,The Shadow,48063435,25000000,23063435,70706674.91862181,36777789.039954,33928885.87866781
4213,Heavenly Creatures,3049135,5000000,-1950865,4485617.75137361,7355557.80799081,-2869940.0566171994
4214,The Swan Princess,9771658,35000000,-25228342,14375199.0597831,51488904.655935705,-37113705.5961526
4215,The Pagemaster,13670688,27000000,-13329312,20111107.1718012,39720012.163150296,-19608904.991349097
4216,The Next Karate Kid,15826984,12000000,3826984,23283259.1476291,17653338.739177898,5629920.408451203
4217,Airheads,0,0,0,0.0,0.0,0.0
4218,The Land Before Time II: The Great Valley Adventure,0,0,0,0.0,0.0,0.0
4219,Color of Night,19726050,40000000,-20273950,29019220.219663396,58844462.4639265,-29825242.244263105
4220,Ed Wood,5887457,18000000,-12112543,8661106.06111203,26480008.1087669,-17818902.047654867
4221,Timecop,101646581,27000000,74646581,149533460.506024,39720012.163150296,109813448.3428737
4222,Wyatt Earp,25052000,63000000,-37948000,36854286.8411571,92680028.3806842,-55825741.539527096
4223,Only You,0,0,0,0.0,0.0,0.0
4224,Death and the Maiden,0,0,0,0.0,0.0,0.0
4225,"The Adventures of Priscilla, Queen of the Desert",0,0,0,0.0,0.0,0.0
4226,Quiz Show,0,0,0,0.0,0.0,0.0
4227,Terminal Velocity,16478900,50000000,-33521100,24242300.3124199,73555578.07990809,-49313277.76748819
4228,Shallow Grave,0,0,0,0.0,0.0,0.0
4229,Muriel's Wedding,15119639,3000000,12119639,22242675.7400904,4413334.68479448,17829341.05529592
4230,Street Fighter,99423521,35000000,64423521,146263091.237897,51488904.655935705,94774186.5819613
4231,The Specialist,170362582,45000000,125362582,250622364.043915,66200020.2719173,184422343.7719977
4232,Zhong Nan Hai bao biao,0,0,0,0.0,0.0,0.0
4233,Thumbelina,11373501,28000000,-16626499,16731688.8169482,41191123.7247485,-24459434.907800302
4234,Highlander III: The Sorcerer,36800000,26000000,10800000,54136905.4668123,38248900.6015522,15888004.865260094
4235,On Deadly Ground,49000000,50000000,-1000000,72084466.5183099,73555578.07990809,-1471111.5615981817
4236,Chasers,1596687,0,1596687,2348904.70595348,0.0,2348904.70595348
4237,The Fantastic Four,0,1500000,-1500000,0.0,2206667.34239724,-2206667.34239724
4238,Black Beauty,0,0,0,0.0,0.0,0.0
4239,Getting Even with Dad,0,30000000,-30000000,0.0,44133346.847944796,-44133346.847944796
4240,Frankenstein,112006296,45000000,67006296,164773757.01738602,66200020.2719173,98573736.74546872
4241,Renaissance Man,24332324,40000000,-15667676,35795563.156952396,58844462.4639265,-23048899.306974106
4242,A Low Down Dirty Shame,29392418,10000000,19392418,43239525.943125896,14711115.615981601,28528410.327144295
4243,The Neverending Story III: Escape from Fantasia,0,17000000,-17000000,0.0,25008896.5471687,-25008896.5471687
4244,PrÃªt-Ã -Porter,11300653,15000000,-3699347,16624521.2819089,22066673.423972398,-5442152.1420634985
4245,The Chase,8009329,26000000,-17990671,11782616.492543401,38248900.6015522,-26466284.109008804
4246,The Hudsucker Proxy,0,30000000,-30000000,0.0,44133346.847944796,-44133346.847944796
4247,Reality Bites,20079850,11500000,8579850,29539699.4901568,16917782.9583788,12621916.531778
4248,Once Were Warriors,2201126,0,2201126,3238101.90713431,0.0,3238101.90713431
4249,The Jungle Book,0,0,0,0.0,0.0,0.0
4250,Bullets Over Broadway,0,0,0,0.0,0.0,0.0
4251,A Troll in Central Park,71368,23000000,-22928632,104990.28992813699,33835565.916757695,-33730575.62682956
4252,Guarding Tess,0,20000000,-20000000,0.0,29422231.231963202,-29422231.231963202
4253,Little Women,0,18000000,-18000000,0.0,26480008.1087669,-26480008.1087669
4254,Angels in the Outfield,50236831,0,50236831,73903982.902153,0.0,73903982.902153
4255,The Getaway,0,0,0,0.0,0.0,0.0
4256,Mrs. Parker and the Vicious Circle,0,0,0,0.0,0.0,0.0
4257,Wolf,0,0,0,0.0,0.0,0.0
4258,Amateur,0,0,0,0.0,0.0,0.0
4259,The Madness of King George,0,0,0,0.0,0.0,0.0
4260,Above the Rim,0,0,0,0.0,0.0,0.0
4261,Drop Zone,0,45000000,-45000000,0.0,66200020.2719173,-66200020.2719173
4262,Exotica,0,0,0,0.0,0.0,0.0
4263,Little Giants,0,0,0,0.0,0.0,0.0
4264,Mixed Nuts,0,15000000,-15000000,0.0,22066673.423972398,-22066673.423972398
4265,Blink,16668552,0,16668552,24521299.5623001,0.0,24521299.5623001
4266,I.Q.,0,25000000,-25000000,0.0,36777789.039954,-36777789.039954
4267,Mute Witness,0,0,0,0.0,0.0,0.0
4268,No Escape,0,20000000,-20000000,0.0,29422231.231963202,-29422231.231963202
4269,Milk Money,18137661,0,18137661,26682522.797448,0.0,26682522.797448
4270,Nell,106683817,0,106683817,156943796.624122,0.0,156943796.624122
4271,Phantasm III: Lord of the Dead,0,2500000,-2500000,0.0,3677778.9039954003,-3677778.9039954003
4272,Greedy,13145977,0,13145977,19339198.7532035,0.0,19339198.7532035
4273,Blank Check,0,13000000,-13000000,0.0,19124450.3007761,-19124450.3007761
4274,Hoop Dreams,7830611,700000,7130611,11519702.3764777,1029778.09311871,10489924.28335899
4275,"Corrina, Corrina",0,0,0,0.0,0.0,0.0
4276,In the Army Now,28881266,0,28881266,42487564.3261919,0.0,42487564.3261919
4277,Double Dragon,2341309,3500000,-1158691,3444326.73917383,5148890.46559357,-1704563.72641974
4278,The Paper,0,6000000,-6000000,0.0,8826669.36958897,-8826669.36958897
4279,Fresh,0,0,0,0.0,0.0,0.0
4280,Il Mostro,0,0,0,0.0,0.0,0.0
4281,The Road to Wellville,0,0,0,0.0,0.0,0.0
4282,The Cowboy Way,0,0,0,0.0,0.0,0.0
4283,Lassie,0,0,0,0.0,0.0,0.0
4284,Before the Rain,763847,0,763847,1123704.15299207,0.0,1123704.15299207
4285,The Ref,11439193,11000000,439193,16828329.077652697,16182227.1775797,646101.9000729974
4286,Major League II,30626182,0,30626182,45054530.4278095,0.0,45054530.4278095
4287,Death Machine,1422749,0,1422749,2093022.50315222,0.0,2093022.50315222
4288,My Father the Hero,0,0,0,0.0,0.0,0.0
4289,North,0,40000000,-40000000,0.0,58844462.4639265,-58844462.4639265
4290,Swimming with Sharks,0,0,0,0.0,0.0,0.0
4291,The Air Up There,21011500,17080000,3931500,30910260.5765198,25126585.4720966,5783675.104423199
4292,La citÃ© de la peur,0,0,0,0.0,0.0,0.0
4293,Exit to Eden,6841570,0,6841570,10064712.7264831,0.0,10064712.7264831
4294,Nobody's Fool,0,0,0,0.0,0.0,0.0
4295,Trapped in Paradise,5777916,0,5777916,8499959.02954301,0.0,8499959.02954301
4296,Jing wu ying xiong,1907743,0,1907743,2806502.78385796,0.0,2806502.78385796
4297,Blue Chips,0,0,0,0.0,0.0,0.0
4298,Roadracers,0,1000000,-1000000,0.0,1471111.56159816,-1471111.56159816
4299,City Slickers II: The Legend of Curly's Gold,0,0,0,0.0,0.0,0.0
4300,Death Wish 5: The Face of Death,0,0,0,0.0,0.0,0.0
4301,Lightning Jack,0,0,0,0.0,0.0,0.0
4302,Immortal Beloved,0,0,0,0.0,0.0,0.0
4303,Don Juan DeMarco,22200000,25000000,-2800000,32658676.6674792,36777789.039954,-4119112.372474801
4304,Bad Girls,15240435,0,15240435,22420380.1322852,0.0,22420380.1322852
4305,I Love Trouble,0,45000000,-45000000,0.0,66200020.2719173,-66200020.2719173
4306,Riget,0,0,0,0.0,0.0,0.0
4307,The Little Rascals,67308282,0,67308282,99017991.84150949,0.0,99017991.84150949
4308,Kickboxer 4: The Aggressor,0,400000,-400000,0.0,588444.624639265,-588444.624639265
4309,Leprechaun 2,2260622,2000000,260622,3325627.16060316,2942223.12319632,383404.0374068399
4310,Spanking the Monkey,0,200000,-200000,0.0,294222.312319632,-294222.312319632
4311,S.F.W.,0,0,0,0.0,0.0,0.0
4312,Baby's Day Out,16671505,50000000,-33328495,24525643.7547415,73555578.07990809,-49029934.32516658
4313,Texas Chainsaw Massacre: The Next Generation,185898,600000,-414102,273476.697077975,882666.936958897,-609190.239880922
4314,My Girl 2,0,0,0,0.0,0.0,0.0
4315,Surviving the Game,7690013,7400000,290013,11312867.0331401,10886225.555826401,426641.4773136992
4316,Camp Nowhere,0,0,0,0.0,0.0,0.0
4317,The River Wild,0,0,0,0.0,0.0,0.0
4318,Intersection,21355893,45000000,-23644107,31416901.1005532,66200020.2719173,-34783119.1713641
4319,Little Odessa,0,0,0,0.0,0.0,0.0
4320,Cops & Robbersons,0,0,0,0.0,0.0,0.0
4321,Fatherland,0,0,0,0.0,0.0,0.0
4322,Serial Mom,7820688,13000000,-5179312,11505104.536452001,19124450.3007761,-7619345.764324101
4323,With Honors,0,0,0,0.0,0.0,0.0
4324,3 Ninjas Kick Back,0,0,0,0.0,0.0,0.0
4325,Threesome,0,0,0,0.0,0.0,0.0
4326,The Last Seduction,0,2500000,-2500000,0.0,3677778.9039954003,-3677778.9039954003
4327,Iron Will,0,0,0,0.0,0.0,0.0
4328,Andre,0,0,0,0.0,0.0,0.0
4329,Monkey Trouble,16453258,0,16453258,24204578.0697574,0.0,24204578.0697574
4330,A Simple Twist of Fate,0,0,0,0.0,0.0,0.0
4331,The War,0,0,0,0.0,0.0,0.0
4332,8 Seconds,0,0,0,0.0,0.0,0.0
4333,Blankman,0,0,0,0.0,0.0,0.0
4334,The Scout,0,0,0,0.0,0.0,0.0
4335,The Puppet Masters,8638072,0,8638072,12707567.5891173,0.0,12707567.5891173
4336,ã‚´ã‚¸ãƒ©vsã‚¹ãƒšãƒ¼ã‚¹ã‚´ã‚¸ãƒ©,0,10300000,-10300000,0.0,15152449.084460998,-15152449.084460998
4337,Bottle Rocket,0,0,0,0.0,0.0,0.0
4338,Crooklyn,0,0,0,0.0,0.0,0.0
4339,Backbeat,0,0,0,0.0,0.0,0.0
4340,Crumb,3174695,0,3174695,4670330.51904788,0.0,4670330.51904788
4341,Rapa Nui,305070,20000000,-19694930,448792.00409675104,29422231.231963202,-28973439.227866452
4342,Hercules and the Amazon Women,0,0,0,0.0,0.0,0.0
4343,Guyver: Dark Hero,0,0,0,0.0,0.0,0.0
4344,Macross Plus,0,0,0,0.0,0.0,0.0
4345,Pumpkinhead II: Blood Wings,0,0,0,0.0,0.0,0.0
4346,Twin Sitters,0,0,0,0.0,0.0,0.0
4347,Men of War,0,0,0,0.0,0.0,0.0
4348,Il silenzio dei prosciutti,0,0,0,0.0,0.0,0.0
4349,From Beijing with Love,0,0,0,0.0,0.0,0.0
4350,Il Postino,0,0,0,0.0,0.0,0.0
4351,Brainscan,4352094,0,4352094,6402415.80056199,0.0,6402415.80056199
4352,PCU,4350774,9000000,-4649226,6400473.93330068,13240004.0543834,-6839530.121082721
4353,Hercules in the Underworld,0,0,0,0.0,0.0,0.0
4354,The Sum of Us,0,32,-32,0.0,47.075569971141206,-47.075569971141206
4355,Wing Chun,0,0,0,0.0,0.0,0.0
4356,Hercules and the Lost Kingdom,0,0,0,0.0,0.0,0.0
4357,When a Man Loves a Woman,50021959,0,50021959,73587882.2186892,0.0,73587882.2186892
4358,Hercules and the Circle of Fire,0,0,0,0.0,0.0,0.0
4359,Wagons East!,0,0,0,0.0,0.0,0.0
4360,Hercules in the Maze of the Minotaur,0,0,0,0.0,0.0,0.0
4361,The Avengers,1519557910,220000000,1299557910,1443191435.20607,208943741.897494,1234247693.3085759
4362,Underworld: Awakening,132400000,70000000,62400000,125746142.85103701,66482099.6946572,59264043.15637981
4363,The Dark Knight Rises,1081041287,250000000,831041287,1026712780.23392,237436070.33806098,789276709.895859
4364,Django Unchained,425368238,100000000,325368238,403991051.509381,94974428.1352245,309016623.3741565
4365,Skyfall,1108561013,200000000,908561013,1052849482.6268,189948856.270449,862900626.3563509
4366,The Bourne Legacy,276572938,130000000,146572938,262673566.242289,123466756.57579099,139206809.666498
4367,The Hobbit: An Unexpected Journey,1017003568,250000000,767003568,965893322.8228301,237436070.33806098,728457252.4847691
4368,Prometheus,403170142,130000000,273170142,382908536.77647203,123466756.57579099,259441780.20068103
4369,Silver Linings Playbook,205738714,21000000,184738714,195399167.074265,19944629.9083971,175454537.1658679
4370,The Amazing Spider-Man,752215857,215000000,537215857,714412708.528228,204195020.490732,510217688.03749603
4371,Brave,538983207,185000000,353983207,511896218.593143,175702692.050165,336193526.542978
4372,Snow White and the Huntsman,396600000,170000000,226600000,376668581.9843,161456527.829881,215212054.154419
4373,21 Jump Street,201585328,42000000,159585328,191454512.472516,39889259.8167943,151565252.6557217
4374,Life of Pi,609016565,120000000,489016565,578409999.857538,113969313.76226899,464440686.09526896
4375,Ice Age: Continental Drift,877244782,95000000,782244782,833158215.050597,90225706.72846329,742932508.3221337
4376,Ted,549368315,50000000,499368315,521759415.527369,47487214.0676122,474272201.45975685
4377,Jack Reacher,218340595,60000000,158340595,207367731.488296,56984656.881134704,150383074.60716128
4378,Lo imposible,180274123,42000000,138274123,171214317.395041,39889259.8167943,131325057.57824668
4379,Wreck-It Ralph,471222889,165000000,306222889,447541244.07003397,156707806.42312,290833437.646914
4380,Pitch Perfect,115350426,17000000,98350426,109553407.445045,16145652.782988098,93407754.6620569
4381,Men in Black 3,624026776,225000000,399026776,592665861.9166781,213692463.304255,378973398.61242306
4382,The Hunger Games,691210692,75000000,616210692,656473401.9365281,71230821.1014184,585242580.8351097
4383,Total Recall,198802074,125000000,73802074,188811132.902466,118718035.16903001,70093097.73343599
4384,Cloud Atlas,130482868,102000000,28482868,123925357.69743899,96873916.69792901,27051440.999509975
4385,The Expendables 2,312573423,100000000,212573423,296864820.996946,94974428.1352245,201890392.86172146
4386,Taken 2,376141306,45000000,331141306,357238054.35386497,42738492.660851,314499561.69301397
4387,Dark Shadows,245527149,150000000,95527149,233188005.67947003,142461642.202836,90726363.47663403
4388,The Perks of Being a Wallflower,33400000,13000000,20400000,31721458.997165002,12346675.6575791,19374783.3395859
4389,Argo,232324128,44500000,187824128,220648511.98814702,42263620.5201749,178384891.46797213
4390,American Reunion,234989584,50000000,184989584,223180013.58134302,47487214.0676122,175692799.51373082
4391,Magic Mike,167221571,7000000,160221571,158817730.77598798,6648209.96946572,152169520.80652225
4392,The Cabin in the Woods,66486080,30000000,36486080,63144774.26952789,28492328.440567303,34652445.82896058
4393,Rise of the Guardians,306941670,145000000,161941670,291516095.791208,137712920.796075,153803174.99513304
4394,The Vow,196114570,30000000,166114570,186258691.347354,28492328.440567303,157766362.90678668
4395,Journey 2: The Mysterious Island,355692760,79000000,276692760,337817164.728396,75029798.2268274,262787366.50156862
4396,The Paperboy,1353868,12500000,-11146132,1285828.3907058001,11871803.516903,-10585975.1261972
4397,Safe,40346186,30000000,10346186,38318559.427874,28492328.440567303,9826230.987306695
4398,Abraham Lincoln: Vampire Hunter,112265139,69000000,43265139,106623173.760465,65532355.413304895,41090818.3471601
4399,Upside Down,8106475,60000000,-51893525,7699078.27317494,56984656.881134704,-49285578.60795976
4400,"Batman: The Dark Knight Returns, Part 1",0,3500000,-3500000,0.0,3324104.98473286,-3324104.98473286
4401,The Lorax,348840316,70000000,278840316,331309095.22611,66482099.6946572,264826995.53145278
4402,Moonrise Kingdom,68263166,16000000,52263166,64832551.535499,15195908.501635902,49636643.0338631
4403,Starship Troopers: Invasion,0,0,0,0.0,0.0,0.0
4404,Dredd,41037742,50000000,-8962258,38975360.784108795,47487214.0676122,-8511853.283503406
4405,Battleship,303025485,209000000,94025485,287796721.48274,198496554.80261898,89300166.680121
4406,LOL,0,11000000,-11000000,0.0,10447187.094874699,-10447187.094874699
4407,Secret of the Wings,0,0,0,0.0,0.0,0.0
4408,This Means War,0,65000000,-65000000,0.0,61733378.287895896,-61733378.287895896
4409,Les MisÃ©rables,441809770,61000000,380809770,419606302.503051,57934401.162487,361671901.340564
4410,Mirror Mirror,183018522,85000000,98018522,173820794.65104,80728263.91494091,93092530.73609908
4411,John Carter,284139100,260000000,24139100,269859485.333573,246933513.15158302,22925972.181989968
4412,Looper,47042000,30000000,17042000,44677870.48337229,28492328.440567303,16185542.04280499
4413,The Twilight Saga: Breaking Dawn - Part 2,829000000,120000000,709000000,787338009.241011,113969313.76226899,673368695.478742
4414,Zero Dark Thirty,132820716,40000000,92820716,126145715.46611,37989771.254089795,88155944.21202022
4415,Haywire,33372606,23000000,10372606,31695441.7023216,21844118.4711016,9851323.23122
4416,Wrath of the Titans,301000000,150000000,151000000,285873028.68702596,142461642.202836,143411386.48418996
4417,Step Up Revolution,140470746,33000000,107470746,133411287.710783,31341561.284624103,102069726.4261589
4418,Chronicle,145000000,15000000,130000000,137712920.796075,14246164.2202836,123466756.57579139
4419,Act of Valor,81272766,12000000,69272766,77188344.73817919,11396931.3762269,65791413.36195229
4420,Hotel Transylvania,358375603,85000000,273375603,340365179.525412,80728263.91494091,259636915.61047113
4421,Sinister,77712439,3000000,74712439,73806944.53018521,2849232.84405673,70957711.68612848
4422,Here Comes the Boom,73100172,0,73100172,69426470.3228655,0.0,69426470.3228655
4423,End of Watch,48126384,7000000,41126384,45707757.9861622,6648209.96946572,39059548.01669648
4424,Anna Karenina,68929150,0,68929150,65465066.0309711,0.0,65465066.0309711
4425,Lincoln,275293450,65000000,210293450,261458379.83122998,61733378.287895896,199725001.5433341
4426,What to Expect When You're Expecting,79700000,40000000,39700000,75694619.223774,37989771.254089795,37704847.969684206
4427,The Dictator,179379533,65000000,114379533,170364685.65838602,61733378.287895896,108631307.37049013
4428,Iron Sky,8135031,7500000,635031,7726199.17087324,7123082.11014184,603117.0607313998
4429,The Lucky One,99357138,25000000,74357138,94363873.6270259,23743607.0338061,70620266.5932198
4430,Project X,100000000,12000000,88000000,94974428.1352245,11396931.3762269,83577496.7589976
4431,Contraband,63100000,25000000,38100000,59928864.15332671,23743607.0338061,36185257.11952061
4432,Stuck in Love,81071,0,81071,76996.7186335079,0.0,76996.7186335079
4433,Madagascar 3: Europe's Most Wanted,746921274,145000000,601921274,709384208.601833,137712920.796075,571671287.805758
4434,Paperman,0,0,0,0.0,0.0,0.0
4435,Lawless,53676580,26000000,27676580,50979024.8975463,24693351.3151583,26285673.582388
4436,Gone,18100189,0,18100189,17190550.9941448,0.0,17190550.9941448
4437,The Raven,29657751,26000000,3657751,28167279.410018798,24693351.3151583,3473928.094860498
4438,Rock of Ages,59418613,75000000,-15581387,56432487.9026322,71230821.1014184,-14798333.198786207
4439,Stolen,2106557,35000000,-32893443,2000690.46409254,33241049.8473286,-31240359.383236058
4440,Gambit,0,0,0,0.0,0.0,0.0
4441,Chasing Mavericks,0,0,0,0.0,0.0,0.0
4442,The Watch,68267862,68000000,267862,64837011.5346442,64582611.131952696,254400.40269150585
4443,The Pirates! In an Adventure with Scientists!,118338361,60000000,58338361,112391181.624347,56984656.881134704,55406524.7432123
4444,The Master,28258060,32000000,-3741940,26837930.8871086,30391817.003271803,-3553886.1161632016
4445,The Factory,0,25000000,-25000000,0.0,23743607.0338061,-23743607.0338061
4446,The Five-Year Engagement,53909751,30000000,23909751,51200477.7213735,28492328.440567303,22708149.280806195
4447,This Is 40,88058786,35000000,53058786,83633328.42632121,33241049.8473286,50392278.578992605
4448,Lockout,32204030,20000000,12204030,30585593.3289961,18994885.627044898,11590707.701951202
4449,Wanderlust,24159934,35000000,-10840066,22945759.154347602,33241049.8473286,-10295290.692980997
4450,The Woman in Black,127730736,17000000,110730736,121311536.06891298,16145652.782988098,105165883.28592488
4451,Frankenweenie,81491068,39000000,42491068,77395675.814287,37040026.9727375,40355648.84154951
4452,That's My Boy,58058367,70000000,-11941633,55140602.0428999,66482099.6946572,-11341497.6517573
4453,Safe House,208076205,85000000,123076205,197619185.784227,80728263.91494091,116890921.8692861
4454,Savages,47000000,45000000,2000000,44637981.2235555,42738492.660851,1899488.562704496
4455,Get the Gringo,0,35000000,-35000000,0.0,33241049.8473286,-33241049.8473286
4456,The Sweeney,6294161,3730500,2563661,5977843.41566033,3543021.04158455,2434822.37407578
4457,The First Time,0,0,0,0.0,0.0,0.0
4458,Flight,161772375,31000000,130772375,153642388.03702098,29442072.721919604,124200315.31510139
4459,Man on a Ledge,46221189,42000000,4221189,43898309.9300513,39889259.8167943,4009050.1132569984
4460,Seven Psychopaths,19422261,15000000,4422261,18446181.3156807,14246164.2202836,4200017.095397102
4461,Big Miracle,24719215,40000000,-15280785,23476933.085766602,37989771.254089795,-14512838.168323193
4462,Bel Ami,8303261,9000000,-696739,7885974.65132513,8547698.53217021,-661723.8808450801
4463,Wrong Turn 5: Bloodlines,0,0,0,0.0,0.0,0.0
4464,Maniac,31081,6000000,-5968919,29519.0020087091,5698465.68811347,-5668946.6861047605
4465,Disconnect,3428048,10000000,-6571952,3255768.9842009996,9497442.81352245,-6241673.8293214515
4466,People Like Us,12434778,16000000,-3565222,11809859.295384698,15195908.501635902,-3386049.206251204
4467,Piranha 3DD,8493728,5000000,3493728,8066869.59536144,4748721.40676122,3318148.1886002207
4468,Hitchcock,23570541,0,23570541,22385986.523128603,0.0,22385986.523128603
4469,The Possession,85446075,14000000,71446075,81151921.0952451,13296419.938931402,67855501.15631369
4470,Silent Hill: Revelation 3D,52302796,20000000,32302796,49674281.3997331,18994885.627044898,30679395.7726882
4471,Killing Them Softly,37930465,15000000,22930465,36024242.2227815,14246164.2202836,21778078.002497904
4472,The Cold Light of Day,16863583,20000000,-3136417,16016091.5173589,18994885.627044898,-2978794.1096859984
4473,Biohazard: Damnation,0,0,0,0.0,0.0,0.0
4474,Arbitrage,35485056,12000000,23485056,33701729.0094642,11396931.3762269,22304797.633237295
4475,The Iceman,1969193,20000000,-18030807,1870229.79062887,18994885.627044898,-17124655.83641603
4476,The Campaign,104907746,0,104907746,99635531.8330539,0.0,99635531.8330539
4477,Now Is Good,0,0,0,0.0,0.0,0.0
4478,Red Dawn,44806783,65000000,-20193217,42554985.920040995,61733378.287895896,-19178392.3678549
4479,Red Lights,13551174,14000000,-448826,12870150.0121092,13296419.938931402,-426269.9268222023
4480,The Three Stooges,54819301,30000000,24819301,52064317.632477395,28492328.440567303,23571989.19191009
4481,Hope Springs,114281051,30000000,84281051,108537774.654174,28492328.440567303,80045446.2136067
4482,Cleanskin,0,0,0,0.0,0.0,0.0
4483,To the Wonder,587615,0,587615,558083.9858868,0.0,558083.9858868
4484,The Man with the Iron Fists,15608545,15000000,608545,14824126.353979098,14246164.2202836,577962.1336954981
4485,Goon,6483963,0,6483963,6158106.77974955,0.0,6158106.77974955
4486,Home Alone: The Holiday Heist,0,0,0,0.0,0.0,0.0
4487,Byzantium,89237,0,89237,84752.33043503031,0.0,84752.33043503031
4488,A Thousand Words,22044277,40000000,-17955723,20936426.017294798,37989771.254089795,-17053345.236794997
4489,Blue Lagoon: The Awakening,0,0,0,0.0,0.0,0.0
4490,Passion,0,30000000,-30000000,0.0,28492328.440567303,-28492328.440567303
4491,The Baytown Outlaws,0,4000000,-4000000,0.0,3798977.12540898,-3798977.12540898
4492,Trouble with the Curve,0,0,0,0.0,0.0,0.0
4493,To Rome with Love,73244881,17000000,56244881,69563906.86807571,16145652.782988098,53418254.08508761
4494,Chernobyl Diaries,18112929,0,18112929,17202650.7362892,0.0,17202650.7362892
4495,About Cherry,3003,2500000,-2496997,2852.0820769007896,2374360.70338061,-2371508.621303709
4496,Thanks for Sharing,1065881,0,1065881,1012314.38435201,0.0,1012314.38435201
4497,House at the End of the Street,0,6900000,-6900000,0.0,6553235.54133049,-6553235.54133049
4498,Alex Cross,30353232,45000000,-14646768,28827808.512557898,42738492.660851,-13910684.148293104
4499,One for the Money,36893721,40000000,-3106279,35039600.5375552,37989771.254089795,-2950170.716534592
4500,Quartet,59520298,11000000,48520298,56529062.6498815,10447187.094874699,46081875.5550068
4501,Lay the Favorite,1576687,26350000,-24773313,1497449.46173242,25025761.8136316,-23528312.35189918
4502,The Odd Life of Timothy Green,51854875,0,51854875,49248870.9914855,0.0,49248870.9914855
4503,Ruby Sparks,9128263,0,9128263,8669515.58292929,0.0,8669515.58292929
4504,Black Rock,0,0,0,0.0,0.0,0.0
4505,ParaNorman,107139399,60000000,47139399,101755031.50776601,56984656.881134704,44770374.626631305
4506,Promised Land,8138788,15000000,-6861212,7729767.36013828,14246164.2202836,-6516396.860145319
4507,Diary of a Wimpy Kid: Dog Days,77112176,22000000,55112176,73236848.17862791,20894374.189749397,52342473.98887851
4508,Hemingway & Gellhorn,0,19500000,-19500000,0.0,18520013.486368697,-18520013.486368697
4509,Great Expectations,258656,0,258656,245657.05683744603,0.0,245657.05683744603
4510,The Scorpion King 3 : Battle for Redemption,0,5000000,-5000000,0.0,4748721.40676122,-4748721.40676122
4511,For Greater Glory - The True Story of Cristiada,9622846,12000000,-2377154,9139242.95883333,11396931.3762269,-2257688.4173935708
4512,Red Tails,50365377,58000000,-7634623,47834228.783899896,55085168.3184302,-7250939.534530304
4513,6 Bullets,0,10000000,-10000000,0.0,9497442.81352245,-9497442.81352245
4514,Would You Rather,0,0,0,0.0,0.0,0.0
4515,Fun Size,11417362,14000000,-2582638,10843574.2676284,13296419.938931402,-2452845.671303002
4516,Playing for Keeps,0,35000000,-35000000,0.0,33241049.8473286,-33241049.8473286
4517,The Lords of Salem,1165882,1500000,-334118,1107289.76223151,1424616.42202836,-317326.65979685006
4518,The Dinosaur Project,0,0,0,0.0,0.0,0.0
4519,Premium Rush,31083599,35000000,-3916401,29521470.3940963,33241049.8473286,-3719579.4532322995
4520,Bachelorette,11947954,3000000,8947954,11347500.9853596,2849232.84405673,8498268.141302869
4521,Room on the Broom,0,0,0,0.0,0.0,0.0
4522,The Guilt Trip,41863726,40000000,1863726,39759834.3645973,37989771.254089795,1770063.1105075032
4523,Ghost Recon: Alpha,0,0,0,0.0,0.0,0.0
4524,The Sessions,9138338,1000000,8138338,8679084.25656392,949744.281352245,7729339.975211675
4525,At Any Price,0,0,0,0.0,0.0,0.0
4526,Seeking a Friend for the End of the World,9636289,10000000,-363711,9152010.37120755,9497442.81352245,-345432.44231490046
4527,Tangled Ever After,0,0,0,0.0,0.0,0.0
4528,Won't Back Down,5310554,0,5310554,5043668.29231229,0.0,5043668.29231229
4529,AstÃ©rix & ObÃ©lix - Au service de Sa MajestÃ©,0,61000000,-61000000,0.0,57934401.162487,-57934401.162487
4530,The Words,13231461,6000000,7231461,12566504.4186852,5698465.68811347,6868038.73057173
4531,Erased,0,12000000,-12000000,0.0,11396931.3762269,-11396931.3762269
4532,StreetDance 2,0,0,0,0.0,0.0,0.0
4533,Kon-Tiki,0,16600000,-16600000,0.0,15765755.070447199,-15765755.070447199
4534,Paranormal Activity 4,142817992,5000000,137817992,135640571.17621002,4748721.40676122,130891849.7694488
4535,Venuto al mondo,18295,13000000,-12981705,17375.5716273393,12346675.6575791,-12329300.08595176
4536,On the Road,8784318,25000000,-16215682,8342855.78607959,23743607.0338061,-15400751.247726511
4537,360,1663931,0,1663931,1580308.95181472,0.0,1580308.95181472
4538,Universal Soldier: Day of Reckoning,1402307,11500000,-10097693,1331833.05395022,10922059.2355508,-9590226.18160058
4539,Fortress,0,5000000,-5000000,0.0,4748721.40676122,-4748721.40676122
4540,Dracula 3D,8139,5600000,-5591861,7729.96870592592,5318567.97557257,-5310838.006866644
4541,Antiviral,0,2400000,-2400000,0.0,2279386.27524539,-2279386.27524539
4542,The Bay,30668,0,30668,29126.7576205106,0.0,29126.7576205106
4543,Bernie,0,0,0,0.0,0.0,0.0
4544,Maximum Conviction,0,0,0,0.0,0.0,0.0
4545,So Undercover,0,0,0,0.0,0.0,0.0
4546,Radio Rebel,0,0,0,0.0,0.0,0.0
4547,London 2012 Olympic Opening Ceremony: Isles of Wonder,0,0,0,0.0,0.0,0.0
4548,Much Ado About Nothing,0,0,0,0.0,0.0,0.0
4549,Io e te,0,0,0,0.0,0.0,0.0
4550,"For a Good Time, Call...",1243961,850000,393961,1181444.84597522,807282.639149409,374162.20682581095
4551,Laurence Anyways,0,9500000,-9500000,0.0,9022570.67284633,-9022570.67284633
4552,Truth or Dare,0,0,0,0.0,0.0,0.0
4553,A Turtleâ€™s Tale 2: Sammyâ€™s Escape From Paradise,0,0,0,0.0,0.0,0.0
4554,Tooth Fairy 2,0,5000000,-5000000,0.0,4748721.40676122,-4748721.40676122
4555,Girl in Progress,0,5000000,-5000000,0.0,4748721.40676122,-4748721.40676122
4556,Parental Guidance,119772232,25000000,94772232,113752992.406794,23743607.0338061,90009385.3729879
4557,Grave Encounters 2,0,0,0,0.0,0.0,0.0
4558,V/H/S,100345,0,100345,95302.08991229109,0.0,95302.08991229109
4559,Hyde Park on Hudson,8887603,0,8887603,8440950.12417906,0.0,8440950.12417906
4560,The Devil Inside,101758490,1000000,100758490,96644543.9565396,949744.281352245,95694799.67518735
4561,Flukt,0,0,0,0.0,0.0,0.0
4562,Chained,0,0,0,0.0,0.0,0.0
4563,The Collection,6842058,0,6842058,6498205.45818038,0.0,6498205.45818038
4564,Dark Tide,432274,25000000,-24567726,410549.75947726,23743607.0338061,-23333057.27432884
4565,The Tall Man,0,18200000,-18200000,0.0,17285345.9206108,-17285345.9206108
4566,Broken,0,0,0,0.0,0.0,0.0
4567,Camille redouble,0,0,0,0.0,0.0,0.0
4568,Starlet,0,0,0,0.0,0.0,0.0
4569,Emperor,3346265,0,3346265,3178096.04763917,0.0,3178096.04763917
4570,The Philadelphia Experiment,0,0,0,0.0,0.0,0.0
4571,Think Like a Man,96070507,12000000,84070507,91242414.62986091,11396931.3762269,79845483.253634
4572,Saints and Soldiers: Airborne Creed,0,0,0,0.0,0.0,0.0
4573,Hit & Run,14400000,2000000,12400000,13676317.6514723,1899488.56270449,11776829.08876781
4574,Branded,0,0,0,0.0,0.0,0.0
4575,Seal Team Six: The Raid on Osama Bin Laden,0,0,0,0.0,0.0,0.0
4576,Stand Up Guys,0,0,0,0.0,0.0,0.0
4577,The Brass Teapot,0,0,0,0.0,0.0,0.0
4578,Burning Bright,0,0,0,0.0,0.0,0.0
4579,Marvel One-Shot: Item 47,0,0,0,0.0,0.0,0.0
4580,Come Out and Play,0,0,0,0.0,0.0,0.0
4581,Deadfall,66351,12000000,-11933649,63016.4828120028,11396931.3762269,-11333914.893414898
4582,Arthur Newman,0,0,0,0.0,0.0,0.0
4583,John Dies at the End,0,0,0,0.0,0.0,0.0
4584,Liberal Arts,0,0,0,0.0,0.0,0.0
4585,Cirque du Soleil: Worlds Away,34153101,0,34153101,32436712.3651956,0.0,32436712.3651956
4586,Sightseers,61782,0,61782,58677.10119050441,0.0,58677.10119050441
4587,Compliance,319285,0,319285,303239.102871551,0.0,303239.102871551
4588,Excision,0,0,0,0.0,0.0,0.0
4589,Tong que tai,0,0,0,0.0,0.0,0.0
4590,The Company You Keep,19633027,0,19633027,18646355.1188842,0.0,18646355.1188842
4591,ATM,3010,3000000,-2996990,2858.73028687026,2849232.84405673,-2846374.11376986
4592,Soldiers of Fortune,0,8000000,-8000000,0.0,7597954.25081796,-7597954.25081796
4593,Abraham Lincoln vs. Zombies,0,150000,-150000,0.0,142461.642202836,-142461.642202836
4594,Beasts of the Southern Wild,21107746,1800000,19307746,20046961.0557357,1709539.70643404,18337421.34930166
4595,The Last Will and Testament of Rosalind Leigh,0,0,0,0.0,0.0,0.0
4596,The Swan Princess Christmas,0,40000000,-40000000,0.0,37989771.254089795,-37989771.254089795
4597,7 Below,0,6000000,-6000000,0.0,5698465.68811347,-5698465.68811347
4598,My Awkward Sexual Adventure,45250,0,45250,42975.9287311891,0.0,42975.9287311891
4599,A Bride for Christmas,0,0,0,0.0,0.0,0.0
4600,Imaginaerum,0,4275000,-4275000,0.0,4060156.80278085,-4060156.80278085
4601,Holy Motors,641100,0,641100,608881.058774924,0.0,608881.058774924
4602,Zambezia,0,20000000,-20000000,0.0,18994885.627044898,-18994885.627044898
4603,Fire with Fire,4636169,20000000,-15363831,4403174.99513256,18994885.627044898,-14591710.631912338
4604,Safety Not Guaranteed,4007792,750000,3257792,3806377.53284928,712308.211014184,3094069.321835096
4605,Partysaurus Rex,0,0,0,0.0,0.0,0.0
4606,Leviathan,0,0,0,0.0,0.0,0.0
4607,Rosewood Lane,0,0,0,0.0,0.0,0.0
4608,I Am Bruce Lee,0,0,0,0.0,0.0,0.0
4609,Eden,0,0,0,0.0,0.0,0.0
4610,What Richard Did,0,0,0,0.0,0.0,0.0
4611,The Samaritan,2521,12000000,-11997479,2394.30533328901,11396931.3762269,-11394537.070893612
4612,Small Apartments,0,2000000,-2000000,0.0,1899488.56270449,-1899488.56270449
4613,PromociÃ³n Fantasma,0,0,0,0.0,0.0,0.0
4614,The Apparition,9627492,17000000,-7372508,9143655.47076449,16145652.782988098,-7001997.312223608
4615,Eating Out: The Open Weekend,0,0,0,0.0,0.0,0.0
4616,Werewolf: The Beast Among Us,0,5000000,-5000000,0.0,4748721.40676122,-4748721.40676122
4617,Halo 4: Forward Unto Dawn,0,12500000,-12500000,0.0,11871803.516903,-11871803.516903
4618,The Thompsons,0,3000000,-3000000,0.0,2849232.84405673,-2849232.84405673
4619,Not Suitable For Children,0,0,0,0.0,0.0,0.0
4620,Lovely Molly,0,1000000,-1000000,0.0,949744.281352245,-949744.281352245
4621,Outpost: Black Sun,0,3000000,-3000000,0.0,2849232.84405673,-2849232.84405673
4622,The Babymakers,0,0,0,0.0,0.0,0.0
4623,Bad Ass,0,0,0,0.0,0.0,0.0
4624,2 Days in New York,1653792,8000000,-6346208,1570679.49454609,7597954.25081796,-6027274.75627187
4625,The Forger,0,0,0,0.0,0.0,0.0
4626,Ginger & Rosa,1005700,0,1005700,955157.823755953,0.0,955157.823755953
4627,El Gringo,0,3000000,-3000000,0.0,2849232.84405673,-2849232.84405673
4628,Robot & Frank,3325038,2500000,825038,3157935.8257788997,2374360.70338061,783575.1223982899
4629,The Motel Life,0,0,0,0.0,0.0,0.0
4630,Frenemies,0,0,0,0.0,0.0,0.0
4631,Bait,0,30000000,-30000000,0.0,28492328.440567303,-28492328.440567303
4632,The Battery,0,0,0,0.0,0.0,0.0
4633,Battlestar Galactica: Blood & Chrome,0,0,0,0.0,0.0,0.0
4634,Dragon Eyes,0,3000000,-3000000,0.0,2849232.84405673,-2849232.84405673
4635,Cosmopolis,6063556,20500000,-14436444,5758827.63565909,19469757.767720997,-13710930.132061906
4636,Extracted,0,0,0,0.0,0.0,0.0
4637,Marley,0,0,0,0.0,0.0,0.0
4638,Airborne,0,0,0,0.0,0.0,0.0
4639,"3, 2, 1... Frankie Go Boom",0,0,0,0.0,0.0,0.0
4640,Dungeons & Dragons: The Book of Vile Darkness,0,12000000,-12000000,0.0,11396931.3762269,-11396931.3762269
4641,Cockneys vs Zombies,0,0,0,0.0,0.0,0.0
4642,Hijacked,0,0,0,0.0,0.0,0.0
4643,Blood,0,0,0,0.0,0.0,0.0
4644,Loosies,0,0,0,0.0,0.0,0.0
4645,Side by Side,0,0,0,0.0,0.0,0.0
4646,Thunderstruck,0,0,0,0.0,0.0,0.0
4647,Nazis at the Center of the Earth,0,0,0,0.0,0.0,0.0
4648,Goats,0,3000000,-3000000,0.0,2849232.84405673,-2849232.84405673
4649,Citadel,0,0,0,0.0,0.0,0.0
4650,The Seasoning House,0,0,0,0.0,0.0,0.0
4651,The Sapphires,0,0,0,0.0,0.0,0.0
4652,Sushi Girl,0,2000000,-2000000,0.0,1899488.56270449,-1899488.56270449
4653,Rebelle,0,0,0,0.0,0.0,0.0
4654,Freelancers,0,11000000,-11000000,0.0,10447187.094874699,-10447187.094874699
4655,Game Change,0,0,0,0.0,0.0,0.0
4656,The Outback,0,5300000,-5300000,0.0,5033644.691166901,-5033644.691166901
4657,Grupo 7,0,3500000,-3500000,0.0,3324104.98473286,-3324104.98473286
4658,Hello I Must Be Going,0,0,0,0.0,0.0,0.0
4659,Love at the Christmas Table,0,0,0,0.0,0.0,0.0
4660,Apartment 1303 3D,0,5000000,-5000000,0.0,4748721.40676122,-4748721.40676122
4661,Grimm's Snow White,0,0,0,0.0,0.0,0.0
4662,Atlas Shrugged Part II,0,0,0,0.0,0.0,0.0
4663,100 Bloody Acres,0,0,0,0.0,0.0,0.0
4664,Cesare deve morire,0,0,0,0.0,0.0,0.0
4665,Into the White,704,0,704,668.619974071981,0.0,668.619974071981
4666,Take This Waltz,0,0,0,0.0,0.0,0.0
4667,The Butterfly Room,1081,0,1081,1026.67356814177,0.0,1026.67356814177
4668,Best Man Down,1938,1500000,-1498062,1840.60441726065,1424616.42202836,-1422775.8176110992
4669,Keep the Lights On,0,0,0,0.0,0.0,0.0
4670,Lola Versus,252603,0,252603,239908.25470242102,0.0,239908.25470242102
4671,Damsels in Distress,0,0,0,0.0,0.0,0.0
4672,Big Time Movie,0,0,0,0.0,0.0,0.0
4673,Good Deeds,0,0,0,0.0,0.0,0.0
4674,The Punisher: Dirty Laundry,0,0,0,0.0,0.0,0.0
4675,Joyful Noise,30,25,5,28.492328440567302,23.7436070338061,4.748721406761202
4676,The Magic of Belle Isle,102388,0,102388,97242.4174790937,0.0,97242.4174790937
4677,After,0,0,0,0.0,0.0,0.0
4678,Room 237,0,0,0,0.0,0.0,0.0
4679,Barbie in A Mermaid Tale 2,0,0,0,0.0,0.0,0.0
4680,Shadow Dancer,419953,6300000,-5880047,398847.96018671896,5983388.97251914,-5584541.012332421
4681,Celeste & Jesse Forever,3094813,0,3094813,2939280.94860458,0.0,2939280.94860458
4682,Meeting Evil,525,0,525,498.615747709929,0.0,498.615747709929
4683,Piranhaconda,0,1000000,-1000000,0.0,949744.281352245,-949744.281352245
4684,Assassin's Bullet,0,5000000,-5000000,0.0,4748721.40676122,-4748721.40676122
4685,Generation Um...,0,1700000,-1700000,0.0,1614565.27829881,-1614565.27829881
4686,A Little Bit Zombie,0,0,0,0.0,0.0,0.0
4687,Brake,0,0,0,0.0,0.0,0.0
4688,Barbie: The Princess & The Popstar,0,0,0,0.0,0.0,0.0
4689,Le Guetteur,0,0,0,0.0,0.0,0.0
4690,One in the Chamber,0,6000000,-6000000,0.0,5698465.68811347,-5698465.68811347
4691,Populaire,0,0,0,0.0,0.0,0.0
4692,Song for Marion,1697294,0,1697294,1611995.27027347,0.0,1611995.27027347
4693,The Imposter,0,0,0,0.0,0.0,0.0
4694,Storage 24,0,0,0,0.0,0.0,0.0
4695,Nobody Walks,24995,0,24995,23738.8583123993,0.0,23738.8583123993
4696,Madea's Witness Protection,0,0,0,0.0,0.0,0.0
4697,The Legend of Mor'du,0,0,0,0.0,0.0,0.0
4698,Une vie meilleure,0,0,0,0.0,0.0,0.0
4699,The Details,0,0,0,0.0,0.0,0.0
4700,Breaking Wind,0,0,0,0.0,0.0,0.0
4701,The Conspiracy,0,0,0,0.0,0.0,0.0
4702,More Than Honey,0,0,0,0.0,0.0,0.0
4703,Modus Anomali,0,200000,-200000,0.0,189948.85627044897,-189948.85627044897
4704,Struck by Lightning,22930,0,22930,21777.636371407,0.0,21777.636371407
4705,Ce que le jour doit Ã  la nuit,0,17,-17,0.0,16.1456527829881,-16.1456527829881
4706,A Dark Truth,5750,0,5750,5461.02961777541,0.0,5461.02961777541
4707,Smashed,376597,500000,-123403,357670.847124411,474872.14067612204,-117201.29355171102
4708,2-Headed Shark Attack,0,0,0,0.0,0.0,0.0
4709,Dragon Age: Dawn of the Seeker,0,0,0,0.0,0.0,0.0
4710,Pusher,0,0,0,0.0,0.0,0.0
4711,"Love, Marilyn",0,0,0,0.0,0.0,0.0
4712,Girl vs. Monster,0,0,0,0.0,0.0,0.0
4713,Boot Tracks,0,0,0,0.0,0.0,0.0
4714,Hannah Arendt,717205,0,717205,681161.347307237,0.0,681161.347307237
4715,Resident Evil: Retribution,240159255,65000000,175159255,228089879.05006498,61733378.287895896,166356500.7621691
4716,Mass Effect: Paragon Lost,0,0,0,0.0,0.0,0.0
4717,Tape 407,0,0,0,0.0,0.0,0.0
4718,Gallowwalkers,0,17000000,-17000000,0.0,16145652.782988098,-16145652.782988098
4719,American Mary,0,0,0,0.0,0.0,0.0
4720,Paradies: Glaube,6508,0,6508,6180.935783040411,0.0,6180.935783040411
4721,Everything or Nothing: The Untold Story of 007,0,0,0,0.0,0.0,0.0
4722,Devil Seed,0,0,0,0.0,0.0,0.0
4723,Free Samples,0,0,0,0.0,0.0,0.0
4724,Justice League: Doom,0,0,0,0.0,0.0,0.0
4725,Oh Boy,2750275,300000,2450275,2612057.95339604,284923.284405673,2327134.668990367
4726,The We and the I,0,0,0,0.0,0.0,0.0
4727,Unconditional,0,2000000,-2000000,0.0,1899488.56270449,-1899488.56270449
4728,Ill Manors,0,170000,-170000,0.0,161456.527829881,-161456.527829881
4729,Blue Like Jazz,0,1250000,-1250000,0.0,1187180.3516903,-1187180.3516903
4730,The Pelayos,0,0,0,0.0,0.0,0.0
4731,My Brother the Devil,0,0,0,0.0,0.0,0.0
4732,The Scapegoat,0,0,0,0.0,0.0,0.0
4733,Something from Nothing: The Art of Rap,288312,0,288312,273822.673245228,0.0,273822.673245228
4734,Time Travel Mater,0,0,0,0.0,0.0,0.0
4735,Aurora,0,0,0,0.0,0.0,0.0
4736,Lake Placid: The Final Chapter,0,0,0,0.0,0.0,0.0
4737,Eega,19450000,5990000,13460000,18472526.2723011,5688968.24529995,12783558.02700115
4738,Rogue River,0,2000000,-2000000,0.0,1899488.56270449,-1899488.56270449
4739,Cowgirls n' Angels,120680,0,120680,114615.13987358901,0.0,114615.13987358901
4740,Dino Time,0,0,0,0.0,0.0,0.0
4741,ThÃ©rÃ¨se Desqueyroux,0,0,0,0.0,0.0,0.0
4742,Jesus Henry Christ,0,0,0,0.0,0.0,0.0
4743,Indie Game: The Movie,0,0,0,0.0,0.0,0.0
4744,Girl Most Likely,0,0,0,0.0,0.0,0.0
4745,Stash House,0,2000000,-2000000,0.0,1899488.56270449,-1899488.56270449
4746,Tower Block,0,0,0,0.0,0.0,0.0
4747,A Glimpse Inside the Mind of Charles Swan III,0,0,0,0.0,0.0,0.0
4748,Main dans la main,0,0,0,0.0,0.0,0.0
4749,A Fantastic Fear of Everything,0,0,0,0.0,0.0,0.0
4750,Insensibles,0,0,0,0.0,0.0,0.0
4751,Chimpanzee,0,0,0,0.0,0.0,0.0
4752,The Rise,0,0,0,0.0,0.0,0.0
4753,Jayne Mansfield's Car,0,0,0,0.0,0.0,0.0
4754,Save the Date,0,0,0,0.0,0.0,0.0
4755,Mac & Devin Go to High School,0,0,0,0.0,0.0,0.0
4756,Columbus Circle,0,10000000,-10000000,0.0,9497442.81352245,-9497442.81352245
4757,Transit,0,5000000,-5000000,0.0,4748721.40676122,-4748721.40676122
4758,Electrick Children,0,0,0,0.0,0.0,0.0
4759,Midnight's Children,884100,0,884100,839668.91914352,0.0,839668.91914352
4760,High Road,0,0,0,0.0,0.0,0.0
4761,Beverly Hills Chihuahua 3 - Viva La Fiesta!,0,0,0,0.0,0.0,0.0
4762,Grabbers,0,0,0,0.0,0.0,0.0
4763,Kiss of the Damned,14752,0,14752,14010.6276385083,0.0,14010.6276385083
4764,Dawn Rider,0,0,0,0.0,0.0,0.0
4765,Superman vs. The Elite,0,3500000,-3500000,0.0,3324104.98473286,-3324104.98473286
4766,Being Flynn,540152,0,540152,513006.273060978,0.0,513006.273060978
4767,Chasing Ice,1328467,0,1328467,1261703.93621517,0.0,1261703.93621517
4768,Ai Weiwei: Never Sorry,181107,0,181107,172005.337562861,0.0,172005.337562861
4769,The Pervert's Guide to Ideology,0,0,0,0.0,0.0,0.0
4770,Resolution,0,0,0,0.0,0.0,0.0
4771,Under the Bed,0,0,0,0.0,0.0,0.0
4772,Comedown,0,0,0,0.0,0.0,0.0
4773,Alien Uprising,0,2500000,-2500000,0.0,2374360.70338061,-2374360.70338061
4774,The Liability,0,0,0,0.0,0.0,0.0
4775,Dead Mine,0,0,0,0.0,0.0,0.0
4776,Sparkle,24637469,14000000,10637469,23399295.2897432,13296419.938931402,10102875.350811798
4777,The Angels' Share,7034007,0,7034007,6680507.92324166,0.0,6680507.92324166
4778,The Philly Kid,0,5000000,-5000000,0.0,4748721.40676122,-4748721.40676122
4779,DjÃºpiÃ°,0,3000000,-3000000,0.0,2849232.84405673,-2849232.84405673
4780,Casa De Mi Padre,0,0,0,0.0,0.0,0.0
4781,A Late Quartet,1562546,0,1562546,1484019.12784982,0.0,1484019.12784982
4782,28 Hotel Rooms,0,0,0,0.0,0.0,0.0
4783,Mine Games,0,1500000,-1500000,0.0,1424616.42202836,-1424616.42202836
4784,Detention of the Dead,0,500000,-500000,0.0,474872.14067612204,-474872.14067612204
4785,Lemale et ha'halal,1775316,0,1775316,1686096.21859314,0.0,1686096.21859314
4786,Treasure Island,0,0,0,0.0,0.0,0.0
4787,Vous n'avez encore rien vu,0,0,0,0.0,0.0,0.0
4788,World Without End,0,0,0,0.0,0.0,0.0
4789,Silent Night,14567,0,14567,13834.9249464581,0.0,13834.9249464581
4790,English Vinglish,11620000,2840000,8780000,11036028.549313001,2697273.75904037,8338754.790272631
4791,Fast Girls,0,0,0,0.0,0.0,0.0
4792,Searching for Sugar Man,0,0,0,0.0,0.0,0.0
4793,American Warships,0,0,0,0.0,0.0,0.0
4794,Kauwboy,0,0,0,0.0,0.0,0.0
4795,Freaky Deaky,0,0,0,0.0,0.0,0.0
4796,Rise of the Zombies,0,0,0,0.0,0.0,0.0
4797,Doctor Who: The Snowmen,0,0,0,0.0,0.0,0.0
4798,"Il Ã©tait une fois, une fois",0,0,0,0.0,0.0,0.0
4799,In Their Skin,0,4000000,-4000000,0.0,3798977.12540898,-3798977.12540898
4800,The Giant Mechanical Man,0,0,0,0.0,0.0,0.0
4801,Whole Lotta Sole,0,0,0,0.0,0.0,0.0
4802,The Girl from the Naked Eye,0,1100000,-1100000,0.0,1044718.70948747,-1044718.70948747
4803,One Direction: Up All Night - The Live Tour,0,0,0,0.0,0.0,0.0
4804,40 Days and Nights,0,0,0,0.0,0.0,0.0
4805,Love Never Dies,0,0,0,0.0,0.0,0.0
4806,Found,0,8000,-8000,0.0,7597.954250817959,-7597.954250817959
4807,Jack Irish: Bad Debts,0,0,0,0.0,0.0,0.0
4808,The Devil's Carnival,0,500000,-500000,0.0,474872.14067612204,-474872.14067612204
4809,"Peace, Love & Misunderstanding",539896,0,539896,512763.13852495205,0.0,512763.13852495205
4810,Not Fade Away,610792,20000000,-19389208,580096.209095701,18994885.627044898,-18414789.417949196
4811,Fairy Tail the Movie: Phoenix Priestess,0,0,0,0.0,0.0,0.0
4812,L'Attentat,0,0,0,0.0,0.0,0.0
4813,Smiley,0,0,0,0.0,0.0,0.0
4814,Any Day Now,0,0,0,0.0,0.0,0.0
4815,3 Zimmer/KÃ¼che/Bad,0,0,0,0.0,0.0,0.0
4816,Darling Companion,0,0,0,0.0,0.0,0.0
4817,Fist of Jesus,0,0,0,0.0,0.0,0.0
4818,Maggie Simpson in The Longest Daycare,0,0,0,0.0,0.0,0.0
4819,Donner Pass,0,300000,-300000,0.0,284923.284405673,-284923.284405673
4820,Interview with a Hitman,0,0,0,0.0,0.0,0.0
4821,Errors of the Human Body,0,1500000,-1500000,0.0,1424616.42202836,-1424616.42202836
4822,Christmas with Holly,0,0,0,0.0,0.0,0.0
4823,The Summit,0,0,0,0.0,0.0,0.0
4824,Jack & Diane,0,0,0,0.0,0.0,0.0
4825,Mansome,0,0,0,0.0,0.0,0.0
4826,We Are Legion: The Story of the Hacktivists,0,0,0,0.0,0.0,0.0
4827,í•˜ìš¸ë§,0,0,0,0.0,0.0,0.0
4828,The Gatekeepers,0,0,0,0.0,0.0,0.0
4829,Rags,0,0,0,0.0,0.0,0.0
4830,Simon Killer,0,0,0,0.0,0.0,0.0
4831,Redd Inc.,1000000,500000,500000,949744.281352245,474872.14067612204,474872.140676123
4832,Reincarnated,0,0,0,0.0,0.0,0.0
4833,A Perfect Ending,0,0,0,0.0,0.0,0.0
4834,Arjun: The Warrior Prince,0,0,0,0.0,0.0,0.0
4835,The Barrens,0,0,0,0.0,0.0,0.0
4836,Head Over Heels,0,10400,-10400,0.0,9877.34052606335,-9877.34052606335
4837,Barricade,0,0,0,0.0,0.0,0.0
4838,Still Mine,0,0,0,0.0,0.0,0.0
4839,Last Kind Words,0,0,0,0.0,0.0,0.0
4840,Marina AbramoviÄ‡: The Artist Is Present,0,0,0,0.0,0.0,0.0
4841,Astronaut: The Last Push,0,0,0,0.0,0.0,0.0
4842,Stitches,95000,100000,-5000,90225.7067284633,94974.42813522449,-4748.721406761193
4843,Reality,0,0,0,0.0,0.0,0.0
4844,The Courier,0,0,0,0.0,0.0,0.0
4845,White Frog,0,0,0,0.0,0.0,0.0
4846,Dead Before Dawn 3D,0,0,0,0.0,0.0,0.0
4847,Wish You Were Here,0,0,0,0.0,0.0,0.0
4848,I Will Follow You Into the Dark,0,5000000,-5000000,0.0,4748721.40676122,-4748721.40676122
4849,Coldplay: Live 2012,0,0,0,0.0,0.0,0.0
4850,Taped,0,0,0,0.0,0.0,0.0
4851,Playback,0,7500000,-7500000,0.0,7123082.11014184,-7123082.11014184
4852,Let It Shine,0,0,0,0.0,0.0,0.0
4853,Why Stop Now?,0,0,0,0.0,0.0,0.0
4854,Tim and Eric's Billion Dollar Movie,0,0,0,0.0,0.0,0.0
4855,Spike Island,0,0,0,0.0,0.0,0.0
4856,Stories We Tell,0,0,0,0.0,0.0,0.0
4857,After Porn Ends,0,400000,-400000,0.0,379897.71254089795,-379897.71254089795
4858,Hungry For Change,0,0,0,0.0,0.0,0.0
4859,Foodfight!,73706,65000000,-64926294,70001.8520013486,61733378.287895896,-61663376.43589455
4860,Good Vibrations,0,0,0,0.0,0.0,0.0
4861,When the Lights Went Out,0,0,0,0.0,0.0,0.0
4862,Vamps,0,16000000,-16000000,0.0,15195908.501635902,-15195908.501635902
4863,Berberian Sound Studio,0,0,0,0.0,0.0,0.0
4864,Political Animals,0,0,0,0.0,0.0,0.0
4865,The Girl,0,0,0,0.0,0.0,0.0
4866,PokÅ‚osie,0,0,0,0.0,0.0,0.0
4867,Nitro Circus: The Movie,3903479,0,3903479,3707306.85762858,0.0,3707306.85762858
4868,Among Friends,0,0,0,0.0,0.0,0.0
4869,Scary or Die,0,0,0,0.0,0.0,0.0
4870,Bad Kids Go to Hell,0,0,0,0.0,0.0,0.0
4871,A Mother's Nightmare,0,0,0,0.0,0.0,0.0
4872,Party Bercy,0,0,0,0.0,0.0,0.0
4873,Artifact,0,0,0,0.0,0.0,0.0
4874,Amy Schumer: Mostly Sex Stuff,0,0,0,0.0,0.0,0.0
4875,Birdsong,0,0,0,0.0,0.0,0.0
4876,Mr. Pip,0,0,0,0.0,0.0,0.0
4877,Gayby,0,0,0,0.0,0.0,0.0
4878,It's a SpongeBob Christmas!,0,0,0,0.0,0.0,0.0
4879,Bill Burr: You People Are All The Same,0,0,0,0.0,0.0,0.0
4880,Crawlspace,0,0,0,0.0,0.0,0.0
4881,Talaash,0,8510000,-8510000,0.0,8082323.83430761,-8082323.83430761
4882,Jurassic Shark,0,0,0,0.0,0.0,0.0
4883,Fresh Guacamole,0,0,0,0.0,0.0,0.0
4884,Free Angela and All Political Prisoners,0,0,0,0.0,0.0,0.0
4885,Girls Against Boys,0,0,0,0.0,0.0,0.0
4886,Jackie,278000,0,278000,264028.91021592397,0.0,264028.91021592397
4887,The Pact,0,0,0,0.0,0.0,0.0
4888,Led Zeppelin: Celebration Day,0,0,0,0.0,0.0,0.0
4889,2016: Obama's America,33400000,2500000,30900000,31721458.997165002,2374360.70338061,29347098.29378439
4890,Cousin Ben Troop Screening,0,0,0,0.0,0.0,0.0
4891,Du vent dans mes mollets,0,0,0,0.0,0.0,0.0
4892,Student of the Year,0,0,0,0.0,0.0,0.0
4893,Underground: The Julian Assange Story,0,0,0,0.0,0.0,0.0
4894,The Queen of Versailles,714544,0,714544,678634.077774559,0.0,678634.077774559
4895,Beware of Mr. Baker,0,0,0,0.0,0.0,0.0
4896,Craigslist Joe,0,0,0,0.0,0.0,0.0
4897,Blancanieves,279735,0,279735,265676.71654407,0.0,265676.71654407
4898,How to Make Money Selling Drugs,0,0,0,0.0,0.0,0.0
4899,Minecraft: The Story of Mojang,0,0,0,0.0,0.0,0.0
4900,Sleepwalk With Me,0,0,0,0.0,0.0,0.0
4901,The Millionaire Tour,0,0,0,0.0,0.0,0.0
4902,Una pistola en cada mano,0,0,0,0.0,0.0,0.0
4903,Katy Perry: Part of Me,32726956,12000000,20726956,31082239.307066496,11396931.3762269,19685307.9308396
4904,Museum Hours,0,0,0,0.0,0.0,0.0
4905,Jim Gaffigan: Mr. Universe,0,0,0,0.0,0.0,0.0
4906,Aziz Ansari: Dangerously Delicious,0,0,0,0.0,0.0,0.0
4907,Fresh Meat,0,0,0,0.0,0.0,0.0
4908,Just Like a Woman,0,0,0,0.0,0.0,0.0
4909,Eddie: The Sleepwalking Cannibal,1632,0,1632,1549.98266716686,0.0,1549.98266716686
4910,The Sleeper,0,0,0,0.0,0.0,0.0
4911,Belle du Seigneur,0,0,0,0.0,0.0,0.0
4912,Freeloaders,0,3000000,-3000000,0.0,2849232.84405673,-2849232.84405673
4913,Undercover Bridesmaid,0,0,0,0.0,0.0,0.0
4914,West of Memphis,0,0,0,0.0,0.0,0.0
4915,Inch'Allah,0,0,0,0.0,0.0,0.0
4916,Sassy Pants,0,0,0,0.0,0.0,0.0
4917,Steve Jobs: The Lost Interview,0,0,0,0.0,0.0,0.0
4918,O Som ao Redor,0,0,0,0.0,0.0,0.0
4919,Freddie Mercury: The Great Pretender,0,0,0,0.0,0.0,0.0
4920,McCullin,0,0,0,0.0,0.0,0.0
4921,Adam and Dog,0,0,0,0.0,0.0,0.0
4922,I Hate Love,0,0,0,0.0,0.0,0.0
4923,The House I Live In,0,0,0,0.0,0.0,0.0
4924,Mental,0,0,0,0.0,0.0,0.0
4925,Hold Your Breath,0,0,0,0.0,0.0,0.0
4926,Daddy's Little Girl,0,0,0,0.0,0.0,0.0
4927,The History of Future Folk,0,0,0,0.0,0.0,0.0
4928,Amber Alert,0,0,0,0.0,0.0,0.0
4929,The Comedy,0,0,0,0.0,0.0,0.0
4930,KumarÃ©,0,0,0,0.0,0.0,0.0
4931,The Dream Team,0,0,0,0.0,0.0,0.0
4932,Jim Jefferies: Fully Functional,0,0,0,0.0,0.0,0.0
4933,It's Such a Beautiful Day,0,0,0,0.0,0.0,0.0
4934,John Mulaney: New In Town,0,0,0,0.0,0.0,0.0
4935,Liz & Dick,0,0,0,0.0,0.0,0.0
4936,A Fairly Odd Christmas,0,0,0,0.0,0.0,0.0
4937,Bekas,0,2000000,-2000000,0.0,1899488.56270449,-1899488.56270449
4938,Elefante blanco,0,0,0,0.0,0.0,0.0
4939,The Men Who Built America,0,0,0,0.0,0.0,0.0
4940,Naughty or Nice,0,0,0,0.0,0.0,0.0
4941,Heroine,0,0,0,0.0,0.0,0.0
4942,Curfew,0,0,0,0.0,0.0,0.0
4943,Shut Up and Play the Hits,0,0,0,0.0,0.0,0.0
4944,How to Fall in Love,0,0,0,0.0,0.0,0.0
4945,The Pregnancy Project,0,0,0,0.0,0.0,0.0
4946,Bones Brigade: An Autobiography,0,110,-110,0.0,104.47187094874701,-104.47187094874701
4947,The Central Park Five,273747,0,273747,259989.647787333,0.0,259989.647787333
4948,The Invisible War,0,0,0,0.0,0.0,0.0
4949,The Lord of the Rings: The Return of the King,1118888979,94000000,1024888979,1326278010.4756699,111423148.609557,1214854861.866113
4950,Underworld,95708457,22000000,73708457,113448272.63300401,26077758.1852156,87370514.44778842
4951,Pirates of the Caribbean: The Curse of the Black Pearl,655011224,140000000,515011224,776419286.73064,165949370.269553,610469916.461087
4952,Kill Bill: Vol. 1,180949000,30000000,150949000,214488375.720753,35560579.3434758,178927796.37727723
4953,The Matrix Revolutions,424988211,150000000,274988211,503760899.910245,177802896.717379,325958003.19286597
4954,The Matrix Reloaded,738599701,150000000,588599701,875501109.015934,177802896.717379,697698212.298555
4955,Finding Nemo,864625978,94000000,770625978,1024886689.7699699,111423148.609557,913463541.1604129
4956,Bruce Almighty,484572835,80000000,404572835,574389691.557017,94828211.5826022,479561479.97441477
4957,Love Actually,244931766,40000000,204931766,290330516.61935496,47414105.7913011,242916410.82805386
4958,Elf,173398518,32000000,141398518,205538391.91267,37931284.63304079,167607107.2796292
4959,Terminator 3: Rise of the Machines,435000000,200000000,235000000,515628400.480399,237070528.95650497,278557871.5238941
4960,The Dreamers,15121165,15000000,121165,17923912.9249429,17780289.6717379,143623.25320500135
4961,Big Fish,122919055,70000000,52919055,145702426.93841898,82974685.1347769,62727741.80364208
4962,Daredevil,179179718,78000000,101179718,212391152.622687,92457506.2930371,119933646.32964991
4963,American Wedding,231449203,55000000,176449203,274348924.908858,65194395.463039,209154529.445819
4964,The League of Extraordinary Gentlemen,179265204,78000000,101265204,212492483.678879,92457506.2930371,120034977.38584189
4965,The Italian Job,176070171,60000000,116070171,208705242.862161,71121158.6869516,137584084.1752094
4966,The Jungle Book 2,135680000,20000000,115680000,160828646.844093,23707052.895650502,137121593.9484425
4967,Lost in Translation,119723856,4000000,115723856,141914989.35316202,4741410.57913011,137173578.7740319
4968,Bad Santa,76488889,23000000,53488889,90666306.8726272,27263110.829998102,63403196.04262909
4969,Johnny English,160583018,40000000,120583018,190347505.09346002,47414105.7913011,142933399.30215892
4970,Brother Bear,250,100000000,-99999750,296.33816119563204,118535264.47825201,-118534968.14009081
4971,Peter Pan,121975011,100000000,21975011,144583401.886227,118535264.47825201,26048137.407975003
4972,Scary Movie 3,220673217,48000000,172673217,261575581.403618,56896926.94956129,204678654.4540567
4973,Honey,62646763,18000000,44646763,74258506.20911421,21336347.6060855,52922158.60302871
4974,A Man Apart,44350926,36000000,8350926,52571487.432654105,42672695.212171,9898792.220483102
4975,The School of Rock,131282949,35000000,96282949,155616590.811999,41487342.5673884,114129248.2446106
4976,The Last Samurai,456758981,140000000,316758981,541420466.1565219,165949370.269553,375471095.8869689
4977,Bad Boys II,273339556,130000000,143339556,324003765.628281,154095843.821728,169907921.806553
4978,Lara Croft Tomb Raider: The Cradle of Life,156505388,95000000,61505388,185514075.58851498,112608501.25434,72905574.33417499
4979,Wrong Turn,28650575,12600000,16050575,33961034.8507901,14935443.324259803,19025591.526530296
4980,Identity,90259536,30000000,60259536,106989379.714443,35560579.3434758,71428800.37096721
4981,Master and Commander: The Far Side of the World,212011111,150000000,62011111,251307931.14713198,177802896.717379,73505034.42975298
4982,Mona Lisa Smile,0,65000000,-65000000,0.0,77047921.9108643,-77047921.9108643
4983,Mystic River,156822020,25000000,131822020,185889396.16713798,29633816.119563203,156255580.0475748
4984,The Animatrix,0,5000000,-5000000,0.0,5926763.22391264,-5926763.22391264
4985,Anger Management,195745823,75000000,120745823,232027828.99818197,88901448.3586895,143126380.63949245
4986,The Core,74208267,60000000,14208267,87962965.55317791,71121158.6869516,16841806.866226315
4987,Hulk,245360480,137000000,108360480,290838693.89311004,162393312.335206,128445381.55790403
4988,Once Upon a Time in Mexico,98185582,29000000,69185582,116384539.303211,34375226.6986933,82009312.6045177
4989,101 Dalmatians II: Patch's London Adventure,0,0,0,0.0,0.0,0.0
4990,Old School,87055349,24000000,63055349,103191288.179616,28448463.474780604,74742824.7048354
4991,How to Lose a Guy in 10 Days,177371441,50000000,127371441,210247706.698238,59267632.23912641,150980074.45911157
4992,Shanghai Knights,88323487,50000000,38323487,104694478.911865,59267632.23912641,45426846.67273859
4993,S.W.A.T.,116643346,80000000,36643346,138263498.677383,94828211.5826022,43435287.0947808
4994,Tears of the Sun,85632458,70000000,15632458,101504660.569528,82974685.1347769,18529975.434751093
4995,"Legally Blonde 2: Red, White & Blonde",124914842,45000000,79914842,148068138.337291,53340869.015213706,94727269.3220773
4996,Atlantis: Milo's Return,0,0,0,0.0,0.0,0.0
4997,The Cat in the Hat,0,0,0,0.0,0.0,0.0
4998,Freaky Friday,110230332,26000000,84230332,130661815.571456,30819168.764345698,99842646.80711031
4999,Sinbad: Legend of the Seven Seas,26288320,60000000,-33711680,31160929.6388894,71121158.6869516,-39960229.04806219
5000,Timeline,19480739,80000000,-60519261,23091545.495968103,94828211.5826022,-71736666.0866341
5001,Paycheck,96269812,60000000,36269812,114113676.26691599,71121158.6869516,42992517.5799644
5002,Charlie's Angels: Full Throttle,259175788,120000000,139175788,307214705.769395,142242317.373903,164972388.395492
5003,Something's Gotta Give,266728738,80000000,186728738,316167615.027806,94828211.5826022,221339403.44520378
5004,The Haunted Mansion,182290266,90000000,92290266,216078248.92121002,106681738.03042701,109396510.89078301
5005,Duplex,19322135,40000000,-20677865,22903543.825095,47414105.7913011,-24510561.9662061
5006,Gothika,141591324,40000000,101591324,167835650.381659,47414105.7913011,120421544.5903579
5007,21 Grams,60427839,20000000,40427839,71628298.7771428,23707052.895650502,47921245.88149229
5008,Final Destination 2,90426405,26000000,64426405,107187178.324926,30819168.764345698,76368009.56058031
5009,George of the Jungle 2,0,0,0,0.0,0.0,0.0
5010,The Texas Chainsaw Massacre,107071655,9500000,97571655,126917669.435492,11260850.125434,115656819.310058
5011,The Recruit,101191884,0,101191884,119948067.329926,0.0,119948067.329926
5012,Cheaper by the Dozen,190212113,40000000,150212113,225468431.214223,47414105.7913011,178054325.4229219
5013,Cold Mountain,173013509,79000000,94013509,205082020.476255,93642858.9378197,111439161.5384353
5014,11:14,0,6000000,-6000000,0.0,7112115.86869516,-7112115.86869516
5015,Holes,0,20000000,-20000000,0.0,23707052.895650502,-23707052.895650502
5016,The Medallion,0,41000000,-41000000,0.0,48599458.4360836,-48599458.4360836
5017,Thirteen,4601043,2000000,2601043,5453858.48880813,2370705.28956505,3083153.19924308
5018,Freddy vs. Jason,114908830,30000000,84908830,136207485.54936498,35560579.3434758,100646906.2058892
5019,Cradle 2 the Grave,56489558,25000000,31489558,66960046.977896,29633816.119563203,37326230.8583328
5020,Boundin',0,0,0,0.0,0.0,0.0
5021,Looney Tunes: Back in Action,68514844,80000000,-11485156,81214251.54226229,94828211.5826022,-13613960.040339917
5022,Basic,42792561,50000000,-7207439,50724275.3583676,59267632.23912641,-8543356.880758807
5023,The Rundown,80916492,85000000,-4083508,95914577.7987242,100754974.806514,-4840397.007789791
5024,Barbie of Swan Lake,0,0,0,0.0,0.0,0.0
5025,2 Fast 2 Furious,236350661,76000000,160350661,280158881.112448,90086801.00347209,190072080.1089759
5026,View from the Top,15614000,0,15614000,18508096.1956343,0.0,18508096.1956343
5027,Batman: Mystery of the Batwoman,0,0,0,0.0,0.0,0.0
5028,Confidence,0,0,0,0.0,0.0,0.0
5029,What a Girl Wants,0,0,0,0.0,0.0,0.0
5030,In Hell,0,0,0,0.0,0.0,0.0
5031,Open Range,68296293,22000000,46296293,80955191.5363924,26077758.1852156,54877433.351176806
5032,Just Married,101564935,18000000,83564935,120390264.31941499,21336347.6060855,99053916.7133295
5033,Under the Tuscan Sun,0,0,0,0.0,0.0,0.0
5034,Tais-toi !,0,27440000,-27440000,0.0,32526076.572832502,-32526076.572832502
5035,Daddy Day Care,164433867,60000000,104433867,194912119.140268,71121158.6869516,123790960.4533164
5036,Matchstick Men,65565672,0,65565672,77718442.7121437,0.0,77718442.7121437
5037,Seabiscuit,148336445,87000000,61336445,175830997.398388,103125680.096079,72705317.30230899
5038,Out of Time,55495563,50000000,5495563,65781812.3757454,59267632.23912641,6514180.136618994
5039,Jeepers Creepers 2,63102666,17000000,46102666,74798912.0359285,20150994.9613029,54647917.074625604
5040,The Lizzie McGuire Movie,55534455,17000000,38534455,65827913.110806204,20150994.9613029,45676918.149503306
5041,Dreamcatcher,75715436,68000000,7715436,89749492.31346221,80603979.84521191,9145512.468250304
5042,Bionicle: Mask of Light,0,0,0,0.0,0.0,0.0
5043,Ned Kelly,6585516,0,6585516,7806158.80785765,0.0,7806158.80785765
5044,Bulletproof Monk,0,52000000,-52000000,0.0,61638337.528691396,-61638337.528691396
5045,Spy Kids 3-D: Game Over,197011982,38000000,159011982,233528673.91754702,45043400.501736,188485273.415811
5046,Down with Love,20298207,35000000,-14701793,24060533.3517932,41487342.5673884,-17426809.2155952
5047,The Order,11560806,35000000,-23439194,13703631.9679177,41487342.5673884,-27783710.5994707
5048,Intolerable Cruelty,119940815,60000000,59940815,142172162.277621,71121158.6869516,71051003.59066941
5049,The Hunted,34234008,55000000,-20765992,40579371.9243062,65194395.463039,-24615023.538732804
5050,House of Sand and Fog,16942795,16500000,442795,20083186.8632581,19558318.6389117,524868.2243463993
5051,Stitch! The Movie,0,0,0,0.0,0.0,0.0
5052,Le Divorce,12991996,0,12991996,15400096.819604,0.0,15400096.819604
5053,National Lampoon Presents Dorm Daze,0,0,0,0.0,0.0,0.0
5054,Cabin Fever,30553394,1500000,29053394,36216546.3849826,1778028.96717379,34438517.41780881
5055,Runaway Jury,80154140,60000000,20154140,95010921.839269,71121158.6869516,23889763.152317405
5056,Code 46,0,7500000,-7500000,0.0,8890144.83586896,-8890144.83586896
5057,The Singing Detective,0,0,0,0.0,0.0,0.0
5058,Kangaroo Jack,0,0,0,0.0,0.0,0.0
5059,Monster,60378584,8000000,52378584,71569914.232624,9482821.15826022,62087093.074363776
5060,In the Cut,23,12000000,-11999977,27.2631108299981,14224231.737390302,-14224204.474279473
5061,The Gathering,0,0,0,0.0,0.0,0.0
5062,Bringing Down The House,132675402,20000000,112675402,157267138.65828502,23707052.895650502,133560085.76263452
5063,The Human Stain,0,30000000,-30000000,0.0,35560579.3434758,-35560579.3434758
5064,Gigli,7266209,54000000,-46733791,8613020.0556926,64009042.8182565,-55396022.7625639
5065,Gods and Generals,12923936,56000000,-43076064,15319421.7186001,66379748.107821494,-51060326.38922139
5066,The Sleeping Dictionary,0,0,0,0.0,0.0,0.0
5067,Shattered Glass,2,6000000,-5999998,2.37070528956505,7112115.86869516,-7112113.497989871
5068,Dumb and Dumberer: When Harry Met Lloyd,39267515,19000000,20267515,46545852.7592875,22521700.250868,24024152.5084195
5069,Girl with a Pearl Earring,31466789,0,31466789,37299241.563963704,0.0,37299241.563963704
5070,National Security,50097949,0,50097949,59383736.3453302,0.0,59383736.3453302
5071,Miracle Run,0,0,0,0.0,0.0,0.0
5072,Scorched,0,0,0,0.0,0.0,0.0
5073,The United States of Leland,343816,0,343816,407543.204918549,0.0,407543.204918549
5074,Malibu's Most Wanted,0,0,0,0.0,0.0,0.0
5075,Uptown Girls,37095657,20000000,17095657,43971435.1348954,23707052.895650502,20264382.239244897
5076,Party Monster,742898,5000000,-4257102,880596.10910365,5926763.22391264,-5046167.11480899
5077,Beyond Borders,0,35000000,-35000000,0.0,41487342.5673884,-41487342.5673884
5078,The Life of David Gale,38955598,50000000,-11044402,46176121.1183849,59267632.23912641,-13091511.120741509
5079,Anything Else,0,0,0,0.0,0.0,0.0
5080,Elephant,10012022,3000000,7012022,11867776.7573208,3556057.93434758,8311718.822973221
5081,Coffee and Cigarettes,7897645,0,7897645,9361494.3883035,0.0,9361494.3883035
5082,House of the Dead,13818181,7000000,6818181,16379417.394433599,8297468.51347769,8081948.880955909
5083,Whale Rider,41400000,8000000,33400000,49073599.4939966,9482821.15826022,39590778.33573638
5084,Deep Blue,0,0,0,0.0,0.0,0.0
5085,In America,0,0,0,0.0,0.0,0.0
5086,The Reckoning,0,0,0,0.0,0.0,0.0
5087,House of 1000 Corpses,16829545,7000000,9829545,19948945.6762365,8297468.51347769,11651477.162758809
5088,A Guy Thing,17432163,20000000,-2567837,20663260.516330104,23707052.895650502,-3043792.379320398
5089,Belly of the Beast,0,14000000,-14000000,0.0,16594937.026955301,-16594937.026955301
5090,Radio,52277485,32000000,20277485,61967255.10732889,37931284.63304079,24035970.4742881
5091,Young Adam,2500000,6400000,-3900000,2963381.61195632,7586256.92660817,-4622875.314651851
5092,Cold Creek Manor,21384035,0,21384035,25347622.4433721,0.0,25347622.4433721
5093,The Even Stevens Movie,0,0,0,0.0,0.0,0.0
5094,Battlestar Galactica,0,0,0,0.0,0.0,0.0
5095,Pieces of April,0,300000,-300000,0.0,355605.793434758,-355605.793434758
5096,The Land Before Time X: The Great Longneck Migration,0,0,0,0.0,0.0,0.0
5097,Hollywood Homicide,51142659,75000000,-23857341,60622086.1068609,88901448.3586895,-28279362.251828603
5098,Swimming Pool,22441323,7800000,14641323,26600881.5704689,9245750.62930371,17355130.941165186
5099,Head of State,0,0,0,0.0,0.0,0.0
5100,Cypher,0,7500000,-7500000,0.0,8890144.83586896,-8890144.83586896
5101,A Mighty Wind,18750246,6000000,12750246,22225653.686423,7112115.86869516,15113537.81772784
5102,The Cheetah Girls,0,0,0,0.0,0.0,0.0
5103,Secondhand Lions,0,0,0,0.0,0.0,0.0
5104,Destino,0,1500000,-1500000,0.0,1778028.96717379,-1778028.96717379
5105,Piglet's Big Movie,0,0,0,0.0,0.0,0.0
5106,Latter Days,819939,850000,-30061,971916.8622103409,1007549.74806514,-35632.88585479907
5107,The Station Agent,8679814,500000,8179814,10288640.4811204,592676.322391263,9695964.158729138
5108,Love Don't Cost a Thing,0,0,0,0.0,0.0,0.0
5109,The Fighting Temptations,30238577,15000000,15238577,35843377.2214101,17780289.6717379,18063087.549672205
5110,Shortcut to Happiness,0,0,0,0.0,0.0,0.0
5111,Intermission,4856298,5000000,-143702,5756425.678152099,5926763.22391264,-170337.5457605403
5112,Darkness Falls,0,0,0,0.0,0.0,0.0
5113,Dracula II: Ascension,0,0,0,0.0,0.0,0.0
5114,Batman: Dead End,0,0,0,0.0,0.0,0.0
5115,The In-Laws,20440627,0,20440627,24229351.2754631,0.0,24229351.2754631
5116,How to Deal,0,0,0,0.0,0.0,0.0
5117,Mimic: Sentinel,0,0,0,0.0,0.0,0.0
5118,Les Enfants de la Pluie,0,0,0,0.0,0.0,0.0
5119,Scooby-Doo! and the Monster of Mexico,0,0,0,0.0,0.0,0.0
5120,Absolon,0,0,0,0.0,0.0,0.0
5121,Angels in America,0,60000000,-60000000,0.0,71121158.6869516,-71121158.6869516
5122,Saints and Soldiers,0,780000,-780000,0.0,924575.0629303709,-924575.0629303709
5123,Inspector Gadget 2,0,80000000,-80000000,0.0,94828211.5826022,-94828211.5826022
5124,Willard,0,22000000,-22000000,0.0,26077758.1852156,-26077758.1852156
5125,The Challenge,0,0,0,0.0,0.0,0.0
5126,Scooby-Doo! And the Legend of the Vampire,0,0,0,0.0,0.0,0.0
5127,The Statement,0,0,0,0.0,0.0,0.0
5128,Calendar Girls,96542059,10000000,86542059,114436384.9684,11853526.447825199,102582858.52057481
5129,Dead End,0,0,0,0.0,0.0,0.0
5130,Foolproof,460978,8256269,-7795291,546421.49148656,9786590.29518599,-9240168.80369943
5131,My Life Without Me,9726954,0,9726954,11529870.6495779,0.0,11529870.6495779
5132,Kontroll,0,500000,-500000,0.0,592676.322391263,-592676.322391263
5133,Mambo Italiano,3031801,4361898,-1330097,3593753.33380431,5170387.33057161,-1576633.9967672997
5134,Capturing the Friedmans,3117985,0,3117985,3695911.76614225,0.0,3695911.76614225
5135,Agent Cody Banks,58795814,28000000,30795814,69693773.6270415,33189874.0539107,36503899.5731308
5136,The Big Empty,0,0,0,0.0,0.0,0.0
5137,De Zaak Alzheimer,0,0,0,0.0,0.0,0.0
5138,Biker Boyz,23510601,24000000,-489399,27868353.075776696,28448463.474780604,-580110.399003908
5139,The Good Thief,0,0,0,0.0,0.0,0.0
5140,The Ghost of Lord Farquaad,0,0,0,0.0,0.0,0.0
5141,Harvie Krumpet,0,0,0,0.0,0.0,0.0
5142,Ghosts of the Abyss,17040871,13000000,4040871,20199441.5092478,15409584.3821728,4789857.127074998
5143,American Splendor,6003587,0,6003587,7116367.728632,0.0,7116367.728632
5144,Hitler: The Rise of Evil,0,0,0,0.0,0.0,0.0
5145,Shade,0,6800000,-6800000,0.0,8060397.98452119,-8060397.98452119
5146,Hope Springs,0,0,0,0.0,0.0,0.0
5147,The Missing,0,60000000,-60000000,0.0,71121158.6869516,-71121158.6869516
5148,Stuck on You,33828318,55000000,-21171682,40098486.2098443,65194395.463039,-25095909.253194705
5149,Chouchou,0,0,0,0.0,0.0,0.0
5150,Fear X,0,0,0,0.0,0.0,0.0
5151,Aileen: Life and Death of a Serial Killer,0,0,0,0.0,0.0,0.0
5152,Le temps du loup,0,0,0,0.0,0.0,0.0
5153,After School Special,0,0,0,0.0,0.0,0.0
5154,The Second Renaissance Part I,0,0,0,0.0,0.0,0.0
5155,Out for a Kill,0,14000000,-14000000,0.0,16594937.026955301,-16594937.026955301
5156,Grind,0,0,0,0.0,0.0,0.0
5157,Dot the I,0,0,0,0.0,0.0,0.0
5158,Carolina,0,0,0,0.0,0.0,0.0
5159,Tiptoes,0,0,0,0.0,0.0,0.0
5160,The Corporation,4500000,0,4500000,5334086.90152137,0.0,5334086.90152137
5161,Owning Mahowny,0,0,0,0.0,0.0,0.0
5162,Kid's Story,5,10,-5,5.92676322391264,11.853526447825198,-5.926763223912558
5163,Frank Herbert's Children of Dune,0,20000000,-20000000,0.0,23707052.895650502,-23707052.895650502
5164,The Company,2281585,15000000,-12718415,2704482.81404614,17780289.6717379,-15075806.857691757
5165,Natural City,0,6000000,-6000000,0.0,7112115.86869516,-7112115.86869516
5166,Flywheel,0,0,0,0.0,0.0,0.0
5167,Crime Spree,0,0,0,0.0,0.0,0.0
5168,44 Minutes: The North Hollywood Shoot-Out,0,10000000,-10000000,0.0,11853526.447825199,-11853526.447825199
5169,DÃ©dales,0,0,0,0.0,0.0,0.0
5170,Charlie: The Life and Art of Charles Chaplin,0,0,0,0.0,0.0,0.0
5171,Alien Hunter,0,7000000,-7000000,0.0,8297468.51347769,-8297468.51347769
5172,Leprechaun: Back 2 tha Hood,0,0,0,0.0,0.0,0.0
5173,The Cooler,0,32000000,-32000000,0.0,37931284.63304079,-37931284.63304079
5174,Good Boy!,0,17000000,-17000000,0.0,20150994.9613029,-20150994.9613029
5175,Touching the Void,13885802,0,13885802,16459572.1256265,0.0,16459572.1256265
5176,Veronica Guerin,1569918,17000000,-15430082,1860906.45339169,20150994.9613029,-18290088.50791121
5177,Luther,0,0,0,0.0,0.0,0.0
5178,Rugrats Go Wild,0,0,0,0.0,0.0,0.0
5179,Soldier's Girl,0,0,0,0.0,0.0,0.0
5180,All the Real Girls,0,0,0,0.0,0.0,0.0
5181,Blind Horizon,0,0,0,0.0,0.0,0.0
5182,My Boss's Daughter,0,14000000,-14000000,0.0,16594937.026955301,-16594937.026955301
5183,Bright Young Things,0,0,0,0.0,0.0,0.0
5184,X2,214948780,110000000,104948780,254790104.86577702,130388790.926078,124401313.93969901
5185,Dickie Roberts: Former Child Star,0,0,0,0.0,0.0,0.0
5186,Wonderland,2466444,5000000,-2533556,2923605.91860799,5926763.22391264,-3003157.3053046498
5187,Northfork,0,0,0,0.0,0.0,0.0
5188,Love Object,0,0,0,0.0,0.0,0.0
5189,Nothing,0,0,0,0.0,0.0,0.0
5190,Helen of Troy,0,0,0,0.0,0.0,0.0
5191,Love Comes Softly,0,0,0,0.0,0.0,0.0
5192,Camp,1628154,0,1628154,1929936.65001325,0.0,1929936.65001325
5193,The Fog of War: Eleven Lessons from the Life of Robert S. McNamara,0,0,0,0.0,0.0,0.0
5194,The Shape of Things,0,0,0,0.0,0.0,0.0
5195,Alex & Emma,15368897,30000000,-14631103,18217562.706340197,35560579.3434758,-17343016.6371356
5196,From Justin to Kelly,4922166,12000000,-7077834,5834502.48615863,14224231.737390302,-8389729.251231672
5197,Deliver Us from Eva,0,0,0,0.0,0.0,0.0
5198,Les Clefs de bagnole,569217,569217,0,674722.876405176,674722.876405176,0.0
5199,Air Bud: Spikes Back,0,5000000,-5000000,0.0,5926763.22391264,-5926763.22391264
5200,August Underground's Mordum,0,300,-300,0.0,355.60579343475797,-355.60579343475797
5201,Undead,0,0,0,0.0,0.0,0.0
5202,Saw,0,0,0,0.0,0.0,0.0
5203,The Diary of Ellen Rimbauer,0,0,0,0.0,0.0,0.0
5204,Final Flight of the Osiris,0,0,0,0.0,0.0,0.0
5205,Interstella 5555: The 5tory of the 5ecret 5tar 5ystem,0,0,0,0.0,0.0,0.0
5206,I Capture the Castle,0,0,0,0.0,0.0,0.0
5207,Sylvia,10000000,7000000,3000000,11853526.447825199,8297468.51347769,3556057.9343475094
5208,The Foreigner,0,16700000,-16700000,0.0,19795389.1678682,-19795389.1678682
5209,Tupac: Resurrection,7808524,0,7808524,9255854.57524784,0.0,9255854.57524784
5210,De fem benspÃ¦nd,0,0,0,0.0,0.0,0.0
5211,Homeless to Harvard: The Liz Murray Story,0,0,0,0.0,0.0,0.0
5212,Chalte Chalte,0,0,0,0.0,0.0,0.0
5213,The Snow Walker,0,0,0,0.0,0.0,0.0
5214,"Buongiorno, notte",0,0,0,0.0,0.0,0.0
5215,Effroyables jardins,0,0,0,0.0,0.0,0.0
5216,Madea's Class Reunion,0,0,0,0.0,0.0,0.0
5217,Fear of the Dark,0,0,0,0.0,0.0,0.0
5218,Bienvenue chez les Rozes,0,0,0,0.0,0.0,0.0
5219,Indiana Jones: Making the Trilogy,0,0,0,0.0,0.0,0.0
5220,A Detective Story,0,0,0,0.0,0.0,0.0
5221,Gomez & TavarÃ¨s,0,0,0,0.0,0.0,0.0
5222,The Young Black Stallion,0,0,0,0.0,0.0,0.0
5223,The Saddest Music in the World,0,0,0,0.0,0.0,0.0
5224,The Room,0,0,0,0.0,0.0,0.0
5225,Eloise at Christmastime,0,0,0,0.0,0.0,0.0
5226,Turbo Charged Prelude to 2 Fast 2 Furious,0,0,0,0.0,0.0,0.0
5227,Matriculated,0,0,0,0.0,0.0,0.0
5228,The Second Renaissance Part II,0,0,0,0.0,0.0,0.0
5229,A Wrinkle in Time,0,0,0,0.0,0.0,0.0
5230,Eddie Izzard: Glorious,0,0,0,0.0,0.0,0.0
5231,Titanic,1845034188,200000000,1645034188,2506405735.41947,271692064.214419,2234713671.205051
5232,Hercules,252712101,85000000,167712101,343299361.863264,115469127.29112801,227830234.572136
5233,Men in Black,589390539,90000000,499390539,800663660.846796,122261428.89648798,678402231.9503081
5234,Gattaca,12532777,36000000,-23467223,17025280.2673449,48904571.5585954,-31879291.291250497
5235,The Fifth Element,263920180,90000000,173920180,358525092.46020496,122261428.89648798,236263663.56371698
5236,Batman & Robin,238207122,125000000,113207122,323594923.43377995,169807540.134012,153787383.29976794
5237,Drive,0,3500000,-3500000,0.0,4754611.12375233,-4754611.12375233
5238,Tomorrow Never Dies,333011068,110000000,223011068,452382322.35584104,149430635.31793,302951687.03791106
5239,Good Will Hunting,225933435,10000000,215933435,306921606.651021,13584603.2107209,293337003.4403001
5240,Jackie Brown,39673162,12000000,27673162,53894416.38846529,16301523.8528651,37592892.53560019
5241,Alien: Resurrection,162000000,70000000,92000000,220070572.013679,95092222.47504671,124978349.53863229
5242,The Game,109423648,50000000,59423648,148647683.99496,67923016.0536048,80724667.94135521
5243,Event Horizon,26673242,60000000,-33326758,36234540.891353704,81507619.2643258,-45273078.37297209
5244,Anastasia,139804348,53000000,86804348,189918659.471355,71998397.01682109,117920262.4545339
5245,Home Alone 3,79082515,32000000,47082515,107430458.718088,43470730.274307,63959728.443781
5246,Austin Powers: International Man of Mystery,67683989,16500000,51183989,91946013.4283802,22414595.297689497,69531418.13069071
5247,Starship Troopers,121214377,105000000,16214377,164664921.497974,142638333.71256998,22026587.785404027
5248,The Full Monty,257850122,3500000,254350122,350279159.520599,4754611.12375233,345524548.39684665
5249,Con Air,224012234,75000000,149012234,304311731.323717,101884524.080407,202427207.24331
5250,Face/Off,245676146,80000000,165676146,333741296.174915,108676825.68576701,225064470.48914802
5251,Donnie Brasco,41954997,35000000,6954997,56994198.69519879,47546111.237523295,9448087.457675494
5252,I Know What You Did Last Summer,125586134,17000000,108586134,170603779.91584298,23093825.4582256,147509954.45761737
5253,The Devil's Advocate,152944660,57000000,95944660,207769251.92986202,77432238.3011095,130337013.62875253
5254,Anaconda,136885767,45000000,91885767,185953882.98902,61130714.448244296,124823168.54077569
5255,Chasing Amy,12021272,250000,11771272,16330421.020815,339615.080268024,15990805.940546976
5256,Dante's Peak,178127760,116000000,62127760,241979494.04145297,157581397.24436298,84398096.79709
5257,Speed 2: Cruise Control,164508066,160000000,4508066,223477680.157309,217353651.371535,6124028.785773993
5258,L.A. Confidential,126216940,35000000,91216940,171460704.837137,47546111.237523295,123914593.59961373
5259,Scream 2,172363301,24000000,148363301,234148705.217506,32603047.705730297,201545657.5117757
5260,Liar Liar,181000000,45000000,136000000,245881318.11404902,61130714.448244296,184750603.6658047
5261,Beauty and the Beast: The Enchanted Christmas,0,0,0,0.0,0.0,0.0
5262,Contact,171120329,90000000,81120329,232460177.075302,122261428.89648798,110198748.17881402
5263,Lolita,1060056,62000000,-60939944,1440044.0141144,84224539.90647,-82784495.8923556
5264,The Rainmaker,45916769,40000000,5916769,62376108.7583333,54338412.842883795,8037695.915449508
5265,Volcano,0,90000000,-90000000,0.0,122261428.89648798,-122261428.89648798
5266,The Jackal,159330280,60000000,99330280,216443863.325307,81507619.2643258,134936244.0609812
5267,Grosse Pointe Blank,28084357,0,28084357,38151484.6273233,0.0,38151484.6273233
5268,Poison Ivy: The New Seduction,0,0,0,0.0,0.0,0.0
5269,Flubber,177977226,80000000,97977226,241774999.575481,108676825.68576701,133098173.88971399
5270,The Saint,118063304,68000000,50063304,160384313.858672,92375301.8329025,68009012.02576949
5271,Conspiracy Theory,136982834,75000000,61982834,186085744.657005,101884524.080407,84201220.57659802
5272,Air Force One,315156409,85000000,230156409,428127476.558069,115469127.29112801,312658349.26694095
5273,George of the Jungle,0,55000000,-55000000,0.0,74715317.65896529,-74715317.65896529
5274,Wag the Dog,64256513,15000000,49256513,87289923.2809533,20376904.8160814,66913018.4648719
5275,As Good as It Gets,314178011,50000000,264178011,426798361.696852,67923016.0536048,358875345.64324725
5276,Breakdown,50159144,36000000,14159144,68139206.8629415,48904571.5585954,19234635.304346107
5277,Seven Years in Tibet,131457682,70000000,61457682,178580044.897113,95092222.47504671,83487822.42206629
5278,My Best Friend's Wedding,299288605,38000000,261288605,406571694.44152004,51621492.2007396,354950202.2407804
5279,Boogie Nights,43101594,15000000,28101594,58551805.2239591,20376904.8160814,38174900.4078777
5280,Lost Highway,3675201,15000000,-11324799,4992614.73046449,20376904.8160814,-15384290.08561691
5281,Mad City,10541523,50000000,-39458477,14320240.719168803,67923016.0536048,-53602775.33443599
5282,"Honey, We Shrunk Ourselves",0,7000000,-7000000,0.0,9509222.24750467,-9509222.24750467
5283,Dobermann,0,0,0,0.0,0.0,0.0
5284,Annabelle's Wish,0,0,0,0.0,0.0,0.0
5285,Bean,251212670,18000000,233212670,341262444.34557796,24452285.7792977,316810158.56628025
5286,The Devil's Own,140807547,90000000,50807547,191281465.506994,122261428.89648798,69020036.61050603
5287,In & Out,0,35000000,-35000000,0.0,47546111.237523295,-47546111.237523295
5288,Murder at 1600,25804707,0,25804707,35054670.5563913,0.0,35054670.5563913
5289,The Edge,43312294,0,43312294,58838032.813609,0.0,58838032.813609
5290,Kiss the Girls,60527873,27000000,33527873,82224713.78939109,36678428.6689466,45546285.120444484
5291,Absolute Power,50068310,50000000,68310,68015812.47813721,67923016.0536048,92796.42453241348
5292,Vegas Vacation,36400360,25000000,11400360,49448444.732739896,33961508.0268024,15486936.705937497
5293,U Turn,6682098,19000000,-12317902,9077364.99451521,25810746.1003698,-16733381.10585459
5294,The Land Before Time V: The Mysterious Island,0,0,0,0.0,0.0,0.0
5295,Mimic,25480490,30000000,-4519510,34614234.6264743,40753809.6321629,-6139575.0056886
5296,One Eight Seven,5716080,20000000,-14283920,7765067.87207379,27169206.421441898,-19404138.549368106
5297,Fools Rush In,29481428,0,29481428,40049350.1465439,0.0,40049350.1465439
5298,Spawn,87840042,40000000,47840042,119327211.658306,54338412.842883795,64988798.81542221
5299,The Peacemaker,0,50000000,-50000000,0.0,67923016.0536048,-67923016.0536048
5300,Cube,501818,250000,251818,681699.8413997571,339615.080268024,342084.7611317331
5301,Kundun,5684789,28000000,-22315211,7722560.29016712,38036888.9900187,-30314328.699851584
5302,The Postman,17626234,80000000,-62373766,23944539.498931896,108676825.68576701,-84732286.18683511
5303,G.I. Jane,48169156,50000000,-1830844,65435887.1255319,67923016.0536048,-2487128.9280728996
5304,The Relic,33956608,60000000,-26043392,46128704.6061993,81507619.2643258,-35378914.658126496
5305,Jungle 2 Jungle,0,0,0,0.0,0.0,0.0
5306,Wilde,0,0,0,0.0,0.0,0.0
5307,Nightwatch,1179002,0,1179002,1601627.43546464,0.0,1601627.43546464
5308,A Life Less Ordinary,0,12000000,-12000000,0.0,16301523.8528651,-16301523.8528651
5309,Orgazmo,0,1000000,-1000000,0.0,1358460.32107209,-1358460.32107209
5310,Deconstructing Harry,0,0,0,0.0,0.0,0.0
5311,Geri's Game,0,0,0,0.0,0.0,0.0
5312,Hoodlum,0,30000000,-30000000,0.0,40753809.6321629,-40753809.6321629
5313,The Love Bug,0,0,0,0.0,0.0,0.0
5314,Fathers' Day,0,85000000,-85000000,0.0,115469127.29112801,-115469127.29112801
5315,Fire Down Below,16000000,60000000,-44000000,21735365.1371535,81507619.2643258,-59772254.1271723
5316,Double Team,0,30000000,-30000000,0.0,40753809.6321629,-40753809.6321629
5317,MouseHunt,122417389,38000000,84417389,166299165.565747,51621492.2007396,114677673.3650074
5318,The Sweet Hereafter,3263585,5000000,-1736415,4433450.72694607,6792301.60536048,-2358850.87841441
5319,Pooh's Grand Adventure: The Search for Christopher Robin,0,0,0,0.0,0.0,0.0
5320,Mr. Magoo,0,30000000,-30000000,0.0,40753809.6321629,-40753809.6321629
5321,The Apostle,0,5000000,-5000000,0.0,6792301.60536048,-6792301.60536048
5322,Cop Land,44862187,15000000,29862187,60943500.95601639,20376904.8160814,40566596.13993499
5323,Smilla's Sense of Snow,0,35000000,-35000000,0.0,47546111.237523295,-47546111.237523295
5324,Selena,60000000,20000000,40000000,81507619.2643258,27169206.421441898,54338412.8428839
5325,Spice World - The Movie,100000000,25000000,75000000,135846032.107209,33961508.0268024,101884524.0804066
5326,The Ice Storm,8038061,18000000,-9961939,10919386.926857,24452285.7792977,-13532898.852440698
5327,Trucks,0,0,0,0.0,0.0,0.0
5328,Air Bud,23144499,3000000,20144499,31440883.542592797,4075380.96321629,27365502.579376508
5329,Romy and Michele's High School Reunion,29235353,0,29235353,39715067.023035996,0.0,39715067.023035996
5330,The Shining,0,0,0,0.0,0.0,0.0
5331,Nothing to Lose,0,25000000,-25000000,0.0,33961508.0268024,-33961508.0268024
5332,Cats Don't Dance,3566637,32000000,-28433363,4845134.84416762,43470730.274307,-38625595.43013938
5333,Robinson Crusoe,0,0,0,0.0,0.0,0.0
5334,Mortal Kombat: Annihilation,51376861,30000000,21376861,69793427.0897364,40753809.6321629,29039617.457573503
5335,Casper: A Spirited Beginning,0,0,0,0.0,0.0,0.0
5336,Metro,31987563,55000000,-23012437,43453835.103293896,74715317.65896529,-31261482.555671394
5337,The Assignment,0,0,0,0.0,0.0,0.0
5338,Gridlock'd,0,0,0,0.0,0.0,0.0
5339,Snow White: A Tale of Terror,0,0,0,0.0,0.0,0.0
5340,Wishmaster,15738769,5000000,10738769,21380493.1890195,6792301.60536048,14588191.583659021
5341,For Richer or Poorer,31611225,35000000,-3388775,42942594.8629822,47546111.237523295,-4603516.374541096
5342,Red Corner,0,48000000,-48000000,0.0,65206095.41146059,-65206095.41146059
5343,Turbo: A Power Rangers Movie,17979739,10000000,7979739,24424762.014732502,13584603.2107209,10840158.804011602
5344,Beverly Hills Ninja,0,0,0,0.0,0.0,0.0
5345,The Borrowers,0,29000000,-29000000,0.0,39395349.3110908,-39395349.3110908
5346,The Swan Princess: Escape from Castle Mountain,273644,0,273644,371734.51609945204,0.0,371734.51609945204
5347,Money Talks,0,0,0,0.0,0.0,0.0
5348,The Man Who Knew Too Little,13801755,20000000,-6198245,18749136.528658397,27169206.421441898,-8420069.8927835
5349,Turbulence,11466088,55000000,-43533912,15576225.585920902,74715317.65896529,-59139092.07304439
5350,Bent,0,0,0,0.0,0.0,0.0
5351,The Night Flier,0,0,0,0.0,0.0,0.0
5352,In the Company of Men,0,0,0,0.0,0.0,0.0
5353,Fierce Creatures,9381260,0,9381260,12744069.4716608,0.0,12744069.4716608
5354,Steel,1686429,16000000,-14313571,2290946.88080529,21735365.1371535,-19444418.256348208
5355,The Pest,0,17000000,-17000000,0.0,23093825.4582256,-23093825.4582256
5356,Lawn Dogs,0,7000000,-7000000,0.0,9509222.24750467,-9509222.24750467
5357,Retroactive,0,0,0,0.0,0.0,0.0
5358,Private Parts,41230799,28000000,13230799,56010404.447599,38036888.9900187,17973515.4575803
5359,Suicide Kings,0,0,0,0.0,0.0,0.0
5360,Mrs Brown,0,0,0,0.0,0.0,0.0
5361,The Butcher Boy,0,0,0,0.0,0.0,0.0
5362,Playing God,4000000,12000000,-8000000,5433841.28428838,16301523.8528651,-10867682.56857672
5363,The Odyssey,0,0,0,0.0,0.0,0.0
5364,Picture Perfect,44332015,19000000,25332015,60223283.330673,25810746.1003698,34412537.2303032
5365,Anna Karenina,791830,35000000,-34208170,1075669.63603451,47546111.237523295,-46470441.601488784
5366,Free Willy 3: The Rescue,0,0,0,0.0,0.0,0.0
5367,Addicted to Love,34673095,0,34673095,47102023.7662633,0.0,47102023.7662633
5368,The Beautician and the Beast,0,16000000,-16000000,0.0,21735365.1371535,-21735365.1371535
5369,Eve's Bayou,0,0,0,0.0,0.0,0.0
5370,The Boxer,0,0,0,0.0,0.0,0.0
5371,Excess Baggage,0,0,0,0.0,0.0,0.0
5372,Most Wanted,11838218,25000000,-13161782,16081749.425201401,33961508.0268024,-17879758.601600997
5373,Nowhere,27354,0,27354,37159.3236226061,0.0,37159.3236226061
5374,The Spanish Prisoner,0,0,0,0.0,0.0,0.0
5375,Out to Sea,0,0,0,0.0,0.0,0.0
5376,Nil by Mouth,0,9000000,-9000000,0.0,12226142.8896488,-12226142.8896488
5377,Mean Guns,0,0,0,0.0,0.0,0.0
5378,The Wings of the Dove,0,0,0,0.0,0.0,0.0
5379,The Brave,0,0,0,0.0,0.0,0.0
5380,Midnight in the Garden of Good and Evil,25105255,35000000,-9894745,34104492.7678968,47546111.237523295,-13441618.469626494
5381,12 Angry Men,0,0,0,0.0,0.0,0.0
5382,Fever Pitch,0,0,0,0.0,0.0,0.0
5383,A Simple Wish,0,0,0,0.0,0.0,0.0
5384,Gone Fishin',0,53000000,-53000000,0.0,71998397.01682109,-71998397.01682109
5385,The 6th Man,0,0,0,0.0,0.0,0.0
5386,An American Werewolf in Paris,26570463,22000000,4570463,36094919.6980142,29886127.0635861,6208792.634428099
5387,Amistad,74000000,36000000,38000000,100526063.759335,48904571.5585954,51621492.2007396
5388,Trojan War,0,15000000,-15000000,0.0,20376904.8160814,-20376904.8160814
5389,Affliction,6330054,6000000,330054,8599127.18924371,8150761.92643258,448365.2628111299
5390,Rosewood,13130349,30000000,-16869651,17837058.1183286,40753809.6321629,-22916751.513834298
5391,The Lost World: Jurassic Park,229074524,73000000,156074524,311188651.422477,99167603.438263,212021047.984214
5392,Switchback,6482195,37000000,-30517805,8805804.70095194,50263031.8796675,-41457227.17871556
5393,B.A.P.S.,7240837,0,7240837,9836389.75585071,0.0,9836389.75585071
5394,"O Que Ã‰ Isso, Companheiro?",310724,0,310724,422106.224804806,0.0,422106.224804806
5395,Booty Call,20060051,0,20060051,27250783.322182603,0.0,27250783.322182603
5396,Gang Related,5790448,0,5790448,7866093.84923128,0.0,7866093.84923128
5397,She's So Lovely,0,18000000,-18000000,0.0,24452285.7792977,-24452285.7792977
5398,Tower of Terror,0,0,0,0.0,0.0,0.0
5399,Doodlebug,0,0,0,0.0,0.0,0.0
5400,RocketMan,0,16000000,-16000000,0.0,21735365.1371535,-21735365.1371535
5401,Gummo,0,1300000,-1300000,0.0,1765998.41739372,-1765998.41739372
5402,La vÃ©ritÃ© si je mens !,29456000,4000000,25456000,40014807.21749961,5433841.28428838,34580965.93321122
5403,Cinderella,0,0,0,0.0,0.0,0.0
5404,Wild America,0,0,0,0.0,0.0,0.0
5405,Hugo Pool,0,0,0,0.0,0.0,0.0
5406,Trekkies,0,0,0,0.0,0.0,0.0
5407,McHale's Navy,4529843,0,4529843,6153611.97618619,0.0,6153611.97618619
5408,Kull the Conqueror,0,0,0,0.0,0.0,0.0
5409,Toothless,0,0,0,0.0,0.0,0.0
5410,Leave it to Beaver,0,0,0,0.0,0.0,0.0
5411,Inventing the Abbotts,5926128,0,5926128,8050409.74559434,0.0,8050409.74559434
5412,Good Burger,0,0,0,0.0,0.0,0.0
5413,The Brave Little Toaster to the Rescue,0,0,0,0.0,0.0,0.0
5414,Soul Food,0,0,0,0.0,0.0,0.0
5415,The Castle,861789,786675,75114,1170706.1616363998,1068666.77307939,102039.38855700986
5416,Twin Town,0,0,0,0.0,0.0,0.0
5417,Didier,0,0,0,0.0,0.0,0.0
5418,Jack Frost,0,0,0,0.0,0.0,0.0
5419,Le Pari,0,0,0,0.0,0.0,0.0
5420,Henry Fool,1334786,0,1334786,1813253.81812254,0.0,1813253.81812254
5421,Les Randonneurs,0,0,0,0.0,0.0,0.0
5422,Frozen,1274219009,150000000,1124219009,1192711491.11985,140405002.911063,1052306488.208787
5423,Gravity,716392705,105000000,611392705,670567465.539932,98283502.0377446,572283963.5021874
5424,Thor: The Dark World,479765000,170000000,309765000,449076041.47750896,159125669.965872,289950371.511637
5425,Iron Man 3,1215439994,200000000,1015439994,1137692372.63862,187206670.54808402,950485702.0905359
5426,Now You See Me,117698894,75000000,42698894,110170090.36465901,70202501.4555318,39967588.909127206
5427,The Hunger Games: Catching Fire,847423452,130000000,717423452,793216614.966424,121684335.85625501,671532279.1101689
5428,The Wolf of Wall Street,392000694,100000000,292000694,366925723.881393,93603335.27404241,273322388.6073506
5429,Pacific Rim,407602906,180000000,227602906,381529914.68992,168486003.493276,213043911.196644
5430,Oblivion,286168572,120000000,166168572,267863327.89809904,112324002.32885,155539325.56924903
5431,The Hobbit: The Desolation of Smaug,958400000,250000000,708400000,897094365.2664231,234008338.185106,663086027.0813171
5432,Man of Steel,662845518,225000000,437845518,620445512.562503,210607504.366595,409838008.19590795
5433,Her,47351251,23000000,24351251,44322350.2299834,21528767.1130297,22793583.116953697
5434,Despicable Me 2,970761885,76000000,894761885,908665501.929164,71138534.8082722,837526967.1208918
5435,Star Trek Into Darkness,467365246,190000000,277365246,437469458.167733,177846337.02068,259623121.147053
5436,12 Years a Slave,187000000,20000000,167000000,175038236.962459,18720667.054808397,156317569.9076506
5437,Riddick,98337295,38000000,60337295,92046987.9382742,35569267.4041361,56477720.534138106
5438,The Conjuring,318000141,13000000,305000141,297658738.152157,12168433.585625501,285490304.5665315
5439,The Great Gatsby,351040419,105000000,246040419,328585540.343973,98283502.0377446,230302038.3062284
5440,Nymphomaniac: Vol. II,2227167,0,2227167,2084702.59412283,0.0,2084702.59412283
5441,Elysium,286140700,115000000,171140700,267837238.776492,107643835.565148,160193403.211344
5442,A Good Day to Die Hard,304654182,92000000,212654182,285166475.403851,86115068.452119,199051406.95173198
5443,The Purge,89328627,3000000,86328627,83614574.2265088,2808100.05822127,80806474.16828753
5444,Monsters University,743559607,200000000,543559607,695996591.902562,187206670.54808402,508789921.354478
5445,World War Z,531865000,200000000,331865000,497843379.155286,187206670.54808402,310636708.607202
5446,The Secret Life of Walter Mitty,188133322,90000000,98133322,176099064.153853,84243001.74663821,91856062.40721479
5447,Ender's Game,125537191,110000000,15537191,117506997.78534499,102963668.80144599,14543328.983898997
5448,We're the Millers,269994119,37000000,232994119,252723500.42776698,34633234.0513957,218090266.37637126
5449,2 Guns,131940411,61000000,70940411,123500625.270279,57098034.51716589,66402590.75311311
5450,About Time,87100449,0,87100449,81528925.30266629,0.0,81528925.30266629
5451,Rush,90247624,38000000,52247624,84474786.0695772,35569267.4041361,48905518.6654411
5452,G.I. Joe: Retaliation,371876278,130000000,241876278,348088599.30097,121684335.85625501,226404263.44471502
5453,Inside Llewyn Davis,32935319,11000000,21935319,30828557.0671454,10296366.8801446,20532190.1870008
5454,Olympus Has Fallen,161025640,70000000,91025640,150725369.686372,65522334.6918297,85203034.99454232
5455,Percy Jackson: Sea of Monsters,174578751,90000000,84578751,163411533.61576498,84243001.74663821,79168531.86912677
5456,Prisoners,122126687,46000000,76126687,114314652.29168999,43057534.2260595,71257118.0656305
5457,The World's End,0,20000000,-20000000,0.0,18720667.054808397,-18720667.054808397
5458,American Hustle,251171807,40000000,211171807,235105188.62008,37441334.1096169,197663854.5104631
5459,Warm Bodies,116980662,35000000,81980662,109497801.25765401,32761167.3459148,76736633.91173922
5460,Don Jon,0,6000000,-6000000,0.0,5616200.11644254,-5616200.11644254
5461,Hansel & Gretel: Witch Hunters,224803475,50000000,174803475,210423550.411948,46801667.63702121,163621882.77492678
5462,47 Ronin,150962475,175000000,-24037525,141305911.61224198,163805836.729574,-22499925.11733201
5463,"Batman: The Dark Knight Returns, Part 2",0,3500000,-3500000,0.0,3276116.73459148,-3276116.73459148
5464,The Mortal Instruments: City of Bones,90565421,60000000,30565421,84772254.660978,56162001.1644254,28610253.4965526
5465,Epic,268426634,100000000,168426634,251256282.187846,93603335.27404241,157652946.91380358
5466,Lone Survivor,149295601,40000000,109295601,139745661.953426,37441334.1096169,102304327.8438091
5467,Nymphomaniac: Vol. I,10285896,0,10285896,9627941.71881932,0.0,9627941.71881932
5468,Dallas Buyers Club,55198285,5000000,50198285,51667435.7740715,4680166.76370212,46987269.01036938
5469,R.I.P.D.,61648500,130000000,-68351500,57705052.146418005,121684335.85625501,-63979283.709837005
5470,RED 2,0,84000000,-84000000,0.0,78626801.63019559,-78626801.63019559
5471,Planes,219788712,50000000,169788712,205729564.987859,46801667.63702121,158927897.3508378
5472,Spring Breakers,31724284,5000000,26724284,29694987.9158094,4680166.76370212,25014821.15210728
5473,The English Teacher,104810,0,104810,98105.6557007239,0.0,98105.6557007239
5474,The Call,68572378,13000000,55572378,64186032.88472371,12168433.585625501,52017599.29909821
5475,Evil Dead,97542952,17000000,80542952,91303456.3967583,15912566.996587198,75390889.4001711
5476,Last Vegas,134402450,28000000,106402450,125805175.890027,26208933.876731798,99596242.0132952
5477,The Family,36894225,30000000,6894225,34534225.1235096,28081000.5822127,6453224.541296899
5478,Insidious: Chapter 2,0,5000000,-5000000,0.0,4680166.76370212,-4680166.76370212
5479,The Book Thief,76586316,0,76586316,71687346.13951759,0.0,71687346.13951759
5480,The Place Beyond the Pines,35485608,15000000,20485608,33215712.6302724,14040500.291106302,19175212.339166097
5481,Grown Ups 2,246984278,80000000,166984278,231185521.810513,74882668.21923392,156302853.5912791
5482,The Hangover Part III,362000072,103000000,259000072,338844141.086435,96411435.33226371,242432705.7541713
5483,The Croods,585178928,135000000,450178928,547746993.928887,126364502.619957,421382491.30893004
5484,Homefront,43058898,22000000,21058898,40304564.6602479,20592733.7602893,19711830.8999586
5485,Escape Plan,122915111,50000000,72915111,115052643.45179099,46801667.63702121,68250975.81476977
5486,Carrie,82394288,30000000,52394288,77123801.6433001,28081000.5822127,49042801.0610874
5487,Captain Phillips,95000000,55000000,40000000,88923168.51034029,51481834.40072329,37441334.109616995
5488,The Counselor,71009334,25000000,46009334,66467104.97988461,23400833.818510603,43066271.161374
5489,White House Down,205366737,150000000,55366737,192230115.375471,140405002.911063,51825112.46440801
5490,Begin Again,63464861,8000000,55464861,59405226.623035,7488266.82192339,51916959.80111161
5491,The Big Wedding,21819348,35000000,-13180652,20423637.46305,32761167.3459148,-12337529.8828648
5492,Life of Crime,1456675,12000000,-10543325,1363496.38410315,11232400.232885001,-9868903.84878185
5493,Short Term 12,1600000,0,1600000,1497653.36438467,0.0,1497653.36438467
5494,Jack the Giant Slayer,197687603,195000000,2687603,185042189.831308,182526503.78438202,2515686.046925992
5495,Runner Runner,62616646,30000000,32616646,58611269.0927403,28081000.5822127,30530268.510527596
5496,Bullet to the Head,9489829,55000000,-45510171,8882796.45580331,51481834.40072329,-42599037.94491998
5497,What If,7847000,11000000,-3153000,7345053.71895411,10296366.8801446,-2951313.1611904902
5498,Delivery Man,51164106,26000000,25164106,47891309.6791464,24336867.171251003,23554442.5078954
5499,This Is the End,126041322,32000000,94041322,117978881.21549499,29953067.2876935,88025813.92780149
5500,Jackass Presents: Bad Grandpa,151831537,15000000,136831537,142119382.629841,14040500.291106302,128078882.3387347
5501,Parker,46216641,35000000,11216641,43260317.4276305,32761167.3459148,10499150.0817157
5502,After Earth,243843127,130000000,113843127,228245299.70851898,121684335.85625501,106560963.85226397
5503,Only Lovers Left Alive,0,7000000,-7000000,0.0,6552233.46918297,-6552233.46918297
5504,The Heat,158674180,43000000,115674180,148524324.69873703,40249434.1678382,108274890.53089882
5505,Saving Mr. Banks,112544580,35000000,77544580,105345480.550162,32761167.3459148,72584313.2042472
5506,Kick-Ass 2,29000000,28000000,1000000,27144967.229472302,26208933.876731798,936033.3527405038
5507,Oculus,44030246,5000000,39030246,41213778.785365604,4680166.76370212,36533612.02166349
5508,The Lone Ranger,89289910,255000000,-165710090,83578333.8231908,238688504.948808,-155110171.1256172
5509,Gangster Squad,105200903,60000000,45200903,98471553.94641021,56162001.1644254,42309552.781984806
5510,Identity Thief,173965010,35000000,138965010,162837051.569821,32761167.3459148,130075884.2239062
5511,The Last Stand,0,30000000,-30000000,0.0,28081000.5822127,-28081000.5822127
5512,Stoker,12077441,12000000,77441,11304887.591754599,11232400.232885001,72487.35886959732
5513,Kill Your Darlings,0,1030064,-1030064,0.0,964174.259457213,-964174.259457213
5514,All Is Lost,6108720,9000000,-2891280,5717965.66255248,8424300.17466382,-2706334.5121113397
5515,Texas Chainsaw 3D,47241945,20000000,27241945,44220036.1683287,18720667.054808397,25499369.113520306
5516,The Spectacular Now,6854611,2500000,4354611,6416144.51606139,2340083.38185106,4076061.13421033
5517,Trance,24261569,20000000,4261569,22709637.773813102,18720667.054808397,3988970.7190047055
5518,Anchorman 2: The Legend Continues,173649015,50000000,123649015,162541269.710522,46801667.63702121,115739602.07350078
5519,Saving Santa,0,7500000,-7500000,0.0,7020250.14555318,-7020250.14555318
5520,Oz: The Great and Powerful,491868548,200000000,291868548,460405366.092004,187206670.54808402,273198695.54392
5521,Turbo,282570682,135000000,147570682,264495582.858608,126364502.619957,138131080.238651
5522,Redemption,8352885,20000000,-11647115,7818578.9516052,18720667.054808397,-10902088.103203196
5523,Pain & Gain,86175291,25000000,61175291,80662946.55811171,23400833.818510603,57262112.739601105
5524,Curse of Chucky,0,0,0,0.0,0.0,0.0
5525,Closed Circuit,5750401,0,5750401,5382567.12763189,0.0,5382567.12763189
5526,The Host,63327201,44000000,19327201,59276372.2716967,41185467.5205786,18090904.7511181
5527,Oldboy,4861022,30000000,-25138978,4550078.72040496,28081000.5822127,-23530921.86180774
5528,Labor Day,20275812,18000000,2275812,18978836.285894502,16848600.3493276,2130235.9365669005
5529,Mama,146497771,15000000,131497771,137126799.75812802,14040500.291106302,123086299.46702172
5530,The Colony,0,16000000,-16000000,0.0,14976533.643846698,-14976533.643846698
5531,The Physician,57284237,32000000,25284237,53619956.418287106,29953067.2876935,23666889.130593605
5532,Admission,18000000,13000000,5000000,16848600.3493276,12168433.585625501,4680166.7637021
5533,Pleasure or Pain,0,0,0,0.0,0.0,0.0
5534,The Butler,115922175,25000000,90922175,108507022.122212,23400833.818510603,85106188.30370139
5535,Movie 43,32438988,6000000,26438988,30363974.697146397,5616200.11644254,24747774.58070386
5536,21 & Over,48065672,13000000,35065672,44991072.1138815,12168433.585625501,32822638.528256
5537,Escape from Planet Earth,74597643,40000000,34597643,69825881.8838232,37441334.1096169,32384547.774206303
5538,Grudge Match,44907260,40000000,4907260,42034693.1401859,37441334.1096169,4593359.030569002
5539,Belle,16505460,10900000,5605460,15449661.0623229,10202763.5448706,5246897.5174523
5540,Tarzan,0,0,0,0.0,0.0,0.0
5541,Machete Kills,15008161,12000000,3008161,14048139.259298,11232400.232885001,2815739.0264129993
5542,Safe Haven,97594140,28000000,69594140,91351370.07201841,26208933.876731798,65142436.19528662
5543,Europa Report,0,125687,-125687,0.0,117647.224005885,-117647.224005885
5544,Company of Heroes,0,0,0,0.0,0.0,0.0
5545,Bad Words,7800000,9500000,-1700000,7301060.15137531,8892316.85103403,-1591256.6996587208
5546,The Bling Ring,19145732,15000000,4145732,17921043.7146296,14040500.291106302,3880543.4235232994
5547,Empire State,3639345,11000000,-7360655,3406548.3021291,10296366.8801446,-6889818.5780155
5548,Behind the Candelabra,15600000,23000000,-7400000,14602120.302750599,21528767.1130297,-6926646.810279101
5549,Cloudy with a Chance of Meatballs 2,248384621,78000000,170384621,232496289.563789,73010601.51375309,159485688.05003592
5550,Zulu,0,16000000,-16000000,0.0,14976533.643846698,-14976533.643846698
5551,Blue Jasmine,97505481,18000000,79505481,91268382.2909977,16848600.3493276,74419781.94167009
5552,Third Person,1021398,28000000,-26978602,956062.594422364,26208933.876731798,-25252871.282309435
5553,The Last Days on Mars,0,0,0,0.0,0.0,0.0
5554,Vehicle 19,0,0,0,0.0,0.0,0.0
5555,I Give It a Year,28234657,0,28234657,26428580.655185897,0.0,26428580.655185897
5556,A Haunted House,60141683,2500000,57641683,56294621.1779418,2340083.38185106,53954537.79609074
5557,Only God Forgives,10337387,4800000,5537387,9676139.01218528,4492960.09315403,5183178.919031249
5558,Side Effects,63372757,30000000,33372757,59319014.20711421,28081000.5822127,31238013.62490151
5559,Cold Comes the Night,16971,0,16971,15885.4220293577,0.0,15885.4220293577
5560,Are You Here,0,0,0,0.0,0.0,0.0
5561,La migliore offerta,19255873,13500000,5755873,18024139.3641338,12636450.2619957,5387689.102138102
5562,The Incredible Burt Wonderstone,27437881,30000000,-2562119,25682771.7445228,28081000.5822127,-2398228.8376899026
5563,Mud,21587700,10000000,11587700,20206807.208954398,9360333.52740424,10846473.681550158
5564,Mindscape,0,0,0,0.0,0.0,0.0
5565,The Trials of Cate McCall,0,7000000,-7000000,0.0,6552233.46918297,-6552233.46918297
5566,Adore,318982,16000000,-15681018,298577.790923846,14976533.643846698,-14677955.852922851
5567,The Railway Man,22309223,18000000,4309223,20882176.8017238,16848600.3493276,4033576.452396199
5568,Broken City,19701164,56000000,-36298836,18440946.5918089,52417867.7534637,-33976921.1616548
5569,Drinking Buddies,343341,0,343341,321378.62736325,0.0,321378.62736325
5570,The Machine,0,0,0,0.0,0.0,0.0
5571,Plush,0,0,0,0.0,0.0,0.0
5572,Walking With Dinosaurs,126546518,80000000,46546518,118451761.521166,74882668.21923392,43569093.30193208
5573,Puppy,0,0,0,0.0,0.0,0.0
5574,Odd Thomas,0,27000000,-27000000,0.0,25272900.5239914,-25272900.5239914
5575,No One Lives,74918,2900000,-2825082,70125.7467206071,2714496.72294723,-2644370.976226623
5576,Welcome to the Punch,9747,8500000,-8490253,9123.51708916092,7956283.49829361,-7947159.981204449
5577,Beautiful Creatures,60052138,60000000,52138,56210804.07137061,56162001.1644254,48802.906945206225
5578,The Frozen Ground,5496951,27220000,-21723049,5145329.47437983,25478827.8615943,-20333498.38721447
5579,The Smurfs 2,347434178,105000000,242434178,325209978.489953,98283502.0377446,226926476.4522084
5580,The Immigrant,5867686,16000000,-10132314,5492349.79940805,14976533.643846698,-9484183.844438648
5581,42,95020213,40000000,55020213,88942088.5524993,37441334.1096169,51500754.4428824
5582,Lovelace,1585582,10000000,-8414418,1484157.63550486,9360333.52740424,-7876175.891899379
5583,All Is Bright,0,0,0,0.0,0.0,0.0
5584,The Way Way Back,23198652,4600000,18598652,21714712.010618303,4305753.42260595,17408958.588012353
5585,The Fifth Estate,8555008,28000000,-19444992,8007772.82096115,26208933.876731798,-18201161.055770647
5586,The Adventurer: The Curse of the Midas Box,6399,25000000,-24993601,5989.67742418597,23400833.818510603,-23394844.14108642
5587,Blood Ties,2415472,25500000,-23084528,2260962.35461061,23868850.494880803,-21607888.140270192
5588,The Wolverine,415440673,120000000,295440673,388866326.01292795,112324002.32885,276542323.684078
5589,Snitch,42930462,35000000,7930462,40184344.2805554,32761167.3459148,7423176.934640598
5590,Free Birds,110000000,55000000,55000000,102963668.80144599,51481834.40072329,51481834.4007227
5591,Nebraska,17654912,12000000,5654912,16525586.471697101,11232400.232885001,5293186.2388121
5592,Horns,0,0,0,0.0,0.0,0.0
5593,Scary Movie 5,78378744,20000000,58378744,73365118.52990341,18720667.054808397,54644451.47509502
5594,Fading Gigolo,2681345,0,2681345,2509828.35020377,0.0,2509828.35020377
5595,The Art of the Steal,64065,0,64065,59966.9767433153,0.0,59966.9767433153
5596,Vikingdom,0,15600000,-15600000,0.0,14602120.302750599,-14602120.302750599
5597,Coherence,102617,0,102617,96052.9345581641,0.0,96052.9345581641
5598,Man of Tai Chi,2054941,25000000,-22945059,1923493.31391376,23400833.818510603,-21477340.504596844
5599,Baggage Claim,22456509,8500000,13956509,21020041.4101155,7956283.49829361,13063757.911821889
5600,Dom Hemingway,523511,0,523511,490023.756526492,0.0,490023.756526492
5601,Clear History,0,0,0,0.0,0.0,0.0
5602,The Numbers Station,0,10000000,-10000000,0.0,9360333.52740424,-9360333.52740424
5603,August: Osage County,74188937,25000000,49188937,69443319.43635811,23400833.818510603,46042485.6178475
5604,Frances Ha,4069826,0,4069826,3809492.87585015,0.0,3809492.87585015
5605,Ambushed,0,0,0,0.0,0.0,0.0
5606,All Cheerleaders Die,0,0,0,0.0,0.0,0.0
5607,Love Punch,0,0,0,0.0,0.0,0.0
5608,V/H/S/2,21833,0,21833,20436.4161903816,0.0,20436.4161903816
5609,Words and Pictures,3346257,0,3346257,3132208.15884111,0.0,3132208.15884111
5610,Romeo & Juliet,1162635,0,1162635,1088265.13706336,0.0,1088265.13706336
5611,Doctor Who: The Day of the Doctor,0,0,0,0.0,0.0,0.0
5612,Filth,0,5000000,-5000000,0.0,4680166.76370212,-4680166.76370212
5613,An Adventure in Space and Time,0,0,0,0.0,0.0,0.0
5614,The Necessary Death of Charlie Countryman,11650,0,11650,10904.7885594259,0.0,10904.7885594259
5615,Before Midnight,11176469,3000000,8176469,10461547.7498694,2808100.05822127,7653447.691648131
5616,The Kings of Summer,0,0,0,0.0,0.0,0.0
5617,A.C.O.D.,175705,0,175705,164465.740243256,0.0,164465.740243256
5618,Paranormal Activity: The Marked Ones,86362372,5000000,81362372,80838060.61377572,4680166.76370212,76157893.85007359
5619,The Returned,0,0,0,0.0,0.0,0.0
5620,Haunter,0,0,0,0.0,0.0,0.0
5621,Big Ass Spider!,0,0,0,0.0,0.0,0.0
5622,A Common Man,0,0,0,0.0,0.0,0.0
5623,Penthouse North,0,0,0,0.0,0.0,0.0
5624,Jobs,35931410,12000000,23931410,33632998.1709908,11232400.232885001,22400597.9381058
5625,Dark Skies,25174316,3500000,21674316,23563999.4084269,3276116.73459148,20287882.67383542
5626,In a World...,2963902,1000000,1963902,2774311.12625405,936033.3527404241,1838277.7735136258
5627,Iron Man & Hulk: Heroes United,0,0,0,0.0,0.0,0.0
5628,Paranoia,13785015,35000000,-21214985,12903233.808027001,32761167.3459148,-19857933.537887797
5629,Bounty Killer,0,0,0,0.0,0.0,0.0
5630,Green Street Hooligans: Underground,0,0,0,0.0,0.0,0.0
5631,Killing Season,39881,0,39881,37329.9461406408,0.0,37329.9461406408
5632,The Pirate Bay: Away From Keyboard,34664,0,34664,32446.660139394,0.0,32446.660139394
5633,Night Train to Lisbon,0,7700000,-7700000,0.0,7207456.81610127,-7207456.81610127
5634,In Secret,0,0,0,0.0,0.0,0.0
5635,Assault on Wall Street,0,0,0,0.0,0.0,0.0
5636,Repentance,1189612,5000000,-3810388,1113516.50882024,4680166.76370212,-3566650.25488188
5637,I Spit on Your Grave 2,809,0,809,757.2509823670031,0.0,757.2509823670031
5638,Hours,0,4000000,-4000000,0.0,3744133.41096169,-3744133.41096169
5639,Evidence,0,0,0,0.0,0.0,0.0
5640,Fruitvale Station,17385830,0,17385830,16273716.745075,0.0,16273716.745075
5641,Minions: Training Wheels,0,0,0,0.0,0.0,0.0
5642,Devil's Knot,0,15000000,-15000000,0.0,14040500.291106302,-14040500.291106302
5643,One Chance,10900434,0,10900434,10203169.7833457,0.0,10203169.7833457
5644,Out of the Furnace,15400000,22000000,-6600000,14414913.632202499,20592733.7602893,-6177820.128086802
5645,The To Do List,3566225,1500000,2066225,3338105.54337672,1404050.02911063,1934055.51426609
5646,The House of Magic,0,34000000,-34000000,0.0,31825133.993174396,-31825133.993174396
5647,Super Buddies,0,0,0,0.0,0.0,0.0
5648,Mr. Morgan's Last Love,0,8200000,-8200000,0.0,7675473.49247148,-7675473.49247148
5649,The Harvest,0,0,0,0.0,0.0,0.0
5650,Fast & Furious 6,788679850,160000000,628679850,738230644.234315,149765336.438467,588465307.795848
5651,Some Girl(s),0,0,0,0.0,0.0,0.0
5652,The Stag,0,600000,-600000,0.0,561620.011644254,-561620.011644254
5653,Raze,0,0,0,0.0,0.0,0.0
5654,Afternoon Delight,0,0,0,0.0,0.0,0.0
5655,A Teacher,0,100000,-100000,0.0,93603.3352740424,-93603.3352740424
5656,Battle of the Year,16549477,20000000,-3450523,15490862.4424105,18720667.054808397,-3229804.612397896
5657,Coldwater,0,0,0,0.0,0.0,0.0
5658,Jug Face,0,0,0,0.0,0.0,0.0
5659,Open Grave,0,0,0,0.0,0.0,0.0
5660,Very Good Girls,0,0,0,0.0,0.0,0.0
5661,Upstream Color,444098,100000,344098,415690.53988531703,93603.3352740424,322087.20461127465
5662,Dead Man Down,18074539,0,18074539,16918371.3394075,0.0,16918371.3394075
5663,30 Nights of Paranormal Activity With the Devil Inside the Girl With the Dragon Tattoo,0,0,0,0.0,0.0,0.0
5664,Nurse 3-D,10000000,0,10000000,9360333.52740424,0.0,9360333.52740424
5665,Trust Me,0,0,0,0.0,0.0,0.0
5666,à¸•à¹‰à¸¡à¸¢à¸³à¸à¸¸à¹‰à¸‡ 2,3302463,0,3302463,3091215.5141912,0.0,3091215.5141912
5667,My Little Pony: Equestria Girls,0,0,0,0.0,0.0,0.0
5668,Breakout,0,0,0,0.0,0.0,0.0
5669,Hammer of the Gods,641,0,641,599.997379106612,0.0,599.997379106612
5670,Some Velvet Morning,6420,0,6420,6009.334124593521,0.0,6009.334124593521
5671,Justice League: The Flashpoint Paradox,0,3500000,-3500000,0.0,3276116.73459148,-3276116.73459148
5672,Remember Sunday,0,0,0,0.0,0.0,0.0
5673,Khumba,27187375,20000000,7187375,25448289.7734612,18720667.054808397,6727622.718652803
5674,Jimmy P.,30283,10000000,-9969717,28345.8980210382,9360333.52740424,-9331987.6293832
5675,Generation Iron,0,0,0,0.0,0.0,0.0
5676,A Single Shot,18642,0,18642,17449.533761787,0.0,17449.533761787
5677,A Night in Old Mexico,0,2000000,-2000000,0.0,1872066.70548084,-1872066.70548084
5678,Rapture Palooza,0,0,0,0.0,0.0,0.0
5679,Black Nativity,7018189,17500000,-10481811,6569258.97983596,16380583.6729574,-9811324.69312144
5680,Killing Kennedy,0,0,0,0.0,0.0,0.0
5681,Concussion,0,0,0,0.0,0.0,0.0
5682,In the Name of the King III,0,3500000,-3500000,0.0,3276116.73459148,-3276116.73459148
5683,Red Line,0,0,0,0.0,0.0,0.0
5684,A Case of You,4187,0,4187,3919.17164792415,0.0,3919.17164792415
5685,Marvel One-Shot: Agent Carter,0,0,0,0.0,0.0,0.0
5686,The Last of Robin Hood,0,0,0,0.0,0.0,0.0
5687,Grand Piano,0,0,0,0.0,0.0,0.0
5688,Krrish 3,0,6218100,-6218100,0.0,5820348.99067523,-5820348.99067523
5689,Sharknado,0,1000000,-1000000,0.0,936033.3527404241,-936033.3527404241
5690,We Are What We Are,81381,0,81381,76175.3302793685,0.0,76175.3302793685
5691,Mary and Martha,0,0,0,0.0,0.0,0.0
5692,Mike Tyson: Undisputed Truth,0,0,0,0.0,0.0,0.0
5693,The Invisible Woman,1234254,0,1234254,1155302.90975328,0.0,1155302.90975328
5694,20 Feet from Stardom,0,1000000,-1000000,0.0,936033.3527404241,-936033.3527404241
5695,Skinwalker Ranch,0,0,0,0.0,0.0,0.0
5696,Dead in Tombstone,0,5200000,-5200000,0.0,4867373.4342502,-4867373.4342502
5697,The Sacrament,9221,4000000,-3990779,8631.163545619449,3744133.41096169,-3735502.2474160707
5698,Sparks,0,0,0,0.0,0.0,0.0
5699,Le Week-End,2225098,0,2225098,2082765.94111601,0.0,2082765.94111601
5700,Justin and the Knights of Valour,0,22000000,-22000000,0.0,20592733.7602893,-20592733.7602893
5701,Cheap Thrills,0,0,0,0.0,0.0,0.0
5702,Pawn Shop Chronicles,0,5000000,-5000000,0.0,4680166.76370212,-4680166.76370212
5703,Ain't Them Bodies Saints,1031243,0,1031243,965277.842780093,0.0,965277.842780093
5704,Sweetwater,6147,7000000,-6993853,5753.797019295389,6552233.46918297,-6546479.672163675
5705,Barbie in the Pink Shoes,0,0,0,0.0,0.0,0.0
5706,When Calls the Heart,0,0,0,0.0,0.0,0.0
5707,The Lifeguard,0,0,0,0.0,0.0,0.0
5708,As I Lay Dying,0,0,0,0.0,0.0,0.0
5709,It's a Disaster,0,0,0,0.0,0.0,0.0
5710,Tom and Jerry's Giant Adventure,0,0,0,0.0,0.0,0.0
5711,12 Rounds 2: Reloaded,0,4000000,-4000000,0.0,3744133.41096169,-3744133.41096169
5712,The Congress,455815,0,455815,426658.042679376,0.0,426658.042679376
5713,Phantom,1034589,10000000,-8965411,968409.810378363,9360333.52740424,-8391923.717025876
5714,L'Amour Est un Crime Parfait,0,0,0,0.0,0.0,0.0
5715,In Fear,0,0,0,0.0,0.0,0.0
5716,The Power of Few,0,0,0,0.0,0.0,0.0
5717,Hateship Loveship,0,0,0,0.0,0.0,0.0
5718,Bonnie & Clyde,0,0,0,0.0,0.0,0.0
5719,Wer,0,0,0,0.0,0.0,0.0
5720,The Devil's Violinist,11294,0,11294,10571.5606858503,0.0,10571.5606858503
5721,Child of God,0,0,0,0.0,0.0,0.0
5722,Wolf Creek 2,9630444,8000000,1630444,9014416.7856989,7488266.82192339,1526149.96377551
5723,LEGO Marvel Super Heroes: Maximum Overload,0,0,0,0.0,0.0,0.0
5724,1,0,0,0,0.0,0.0,0.0
5725,Panic in the Mailroom,0,0,0,0.0,0.0,0.0
5726,Death Race: Inferno,0,6500000,-6500000,0.0,6084216.79281276,-6084216.79281276
5727,Metallica: Through the Never,7972967,18000000,-10027033,7462963.03229876,16848600.3493276,-9385637.317028843
5728,Straight A's,0,7000000,-7000000,0.0,6552233.46918297,-6552233.46918297
5729,Another Me,0,0,0,0.0,0.0,0.0
5730,Riddle,0,7000000,-7000000,0.0,6552233.46918297,-6552233.46918297
5731,Superman: Unbound,2915767,0,2915767,2729255.16081989,0.0,2729255.16081989
5732,Legends of Oz: Dorothy's Return,18662027,70000000,-51337973,17468279.7017423,65522334.6918297,-48054054.9900874
5733,Vendetta,0,0,0,0.0,0.0,0.0
5734,The Last Keepers,0,0,0,0.0,0.0,0.0
5735,Enough Said,25288872,0,25288872,23671227.6451834,0.0,23671227.6451834
5736,A Madea Christmas,0,0,0,0.0,0.0,0.0
5737,Bad Milo!,19613,0,19613,18358.4221472979,0.0,18358.4221472979
5738,Last Passenger,0,0,0,0.0,0.0,0.0
5739,Battle of the Damned,0,8000000,-8000000,0.0,7488266.82192339,-7488266.82192339
5740,Lovestruck: The Musical,0,0,0,0.0,0.0,0.0
5741,Austenland,2159041,4900000,-2740959,2020934.38593403,4586563.42842808,-2565629.04249405
5742,Kevin Hart: Let Me Explain,32230907,0,32230907,30169203.9410748,0.0,30169203.9410748
5743,Knights of Badassdom,0,0,0,0.0,0.0,0.0
5744,Temptation: Confessions of a Marriage Counselor,0,0,0,0.0,0.0,0.0
5745,Eastern Boys,0,0,0,0.0,0.0,0.0
5746,The East,2401510,6500000,-4098490,2247893.45693965,6084216.79281276,-3836323.33587311
5747,CBGB,40400,0,40400,37815.7474507131,0.0,37815.7474507131
5748,1,0,0,0,0.0,0.0,0.0
5749,Goodbye World,0,0,0,0.0,0.0,0.0
5750,The Best Man Holiday,71625195,17000000,54625195,67043571.4165367,15912566.996587198,51131004.4199495
5751,Ice Soldiers,0,0,0,0.0,0.0,0.0
5752,PoziÅ£ia copilului,0,1104000,-1104000,0.0,1033380.82142542,-1033380.82142542
5753,The Haunting in Connecticut 2: Ghosts of Georgia,0,0,0,0.0,0.0,0.0
5754,Banshee Chapter,0,950000,-950000,0.0,889231.6851034029,-889231.6851034029
5755,The Philosophers,0,0,0,0.0,0.0,0.0
5756,Breathe In,15000,0,15000,14040.500291106298,0.0,14040.500291106298
5757,Barbie: Mariposa and The Fairy Princess,0,0,0,0.0,0.0,0.0
5758,Killing Lincoln,0,2000000,-2000000,0.0,1872066.70548084,-1872066.70548084
5759,Hell Baby,0,2500000,-2500000,0.0,2340083.38185106,-2340083.38185106
5760,Angels Sing,0,0,0,0.0,0.0,0.0
5761,Barbie: The Pearl Princess,0,0,0,0.0,0.0,0.0
5762,All Stars,0,0,0,0.0,0.0,0.0
5763,A Birder's Guide to Everything,0,0,0,0.0,0.0,0.0
5764,The Dyatlov Pass Incident,0,0,0,0.0,0.0,0.0
5765,And While We Were Here,0,0,0,0.0,0.0,0.0
5766,The Look of Love,0,0,0,0.0,0.0,0.0
5767,Suddenly,0,0,0,0.0,0.0,0.0
5768,Geography Club,0,0,0,0.0,0.0,0.0
5769,The ABCs of Death,21660,0,21660,20274.4824203576,0.0,20274.4824203576
5770,The Armstrong Lie,383294,0,383294,358775.967905288,0.0,358775.967905288
5771,Robosapien: Rebooted,0,0,0,0.0,0.0,0.0
5772,The Young and Prodigious T.S. Spivet,9494789,33000000,-23505211,8887439.181232901,30889100.640434004,-22001661.459201105
5773,The Crown and the Dragon,0,0,0,0.0,0.0,0.0
5774,Vi Ã¤r bÃ¤st!,180590,0,180590,169038.26317139302,0.0,169038.26317139302
5775,The Canyons,56825,250000,-193175,53190.0952694746,234008.33818510603,-180818.24291563142
5776,13 Eerie,0,0,0,0.0,0.0,0.0
5777,A Band Called Death,125,0,125,117.004169092553,0.0,117.004169092553
5778,The Reluctant Fundamentalist,519535,0,519535,486302.08791599603,0.0,486302.08791599603
5779,The Truth About Emanuel,0,0,0,0.0,0.0,0.0
5780,PionÃ©r,0,7500000,-7500000,0.0,7020250.14555318,-7020250.14555318
5781,Officer Down,0,12000000,-12000000,0.0,11232400.232885001,-11232400.232885001
5782,Patrick,0,0,0,0.0,0.0,0.0
5783,Pawn,0,83000000,-83000000,0.0,77690768.2774552,-77690768.2774552
5784,Love and Honor,0,0,0,0.0,0.0,0.0
5785,Make Your Move,122,15,107,114.196069034331,14.0405002911063,100.1555687432247
5786,Zombie Hunter,0,0,0,0.0,0.0,0.0
5787,The Face of Love,350006,4000000,-3649994,327617.289659265,3744133.41096169,-3416516.121302425
5788,The Ultimate Life,0,0,0,0.0,0.0,0.0
5789,Ghost Team One,9195,0,9195,8606.8266784482,0.0,8606.8266784482
5790,Scenic Route,0,0,0,0.0,0.0,0.0
5791,All Things To All Men,0,6000000,-6000000,0.0,5616200.11644254,-5616200.11644254
5792,Frequencies,0,0,0,0.0,0.0,0.0
5793,Riddick: Blindsided,0,0,0,0.0,0.0,0.0
5794,The Human Race,0,567000,-567000,0.0,530730.91100382,-530730.91100382
5795,Adult World,0,0,0,0.0,0.0,0.0
5796,Summer in February,0,0,0,0.0,0.0,0.0
5797,Inequality for All,0,0,0,0.0,0.0,0.0
5798,One Small Hitch,7965,0,7965,7455.50565457748,0.0,7455.50565457748
5799,The End of Love,8326,0,8326,7793.41369491677,0.0,7793.41369491677
5800,Alpha and Omega 2: A Howl-iday Adventure,0,0,0,0.0,0.0,0.0
5801,Breaking the Girls,0,0,0,0.0,0.0,0.0
5802,Kill for Me,0,0,0,0.0,0.0,0.0
5803,Contracted,0,0,0,0.0,0.0,0.0
5804,Almost Human,0,0,0,0.0,0.0,0.0
5805,The Smurfs: The Legend of Smurfy Hollow,0,0,0,0.0,0.0,0.0
5806,Blackfish,0,0,0,0.0,0.0,0.0
5807,Sanitarium,0,0,0,0.0,0.0,0.0
5808,Sound City,0,0,0,0.0,0.0,0.0
5809,Call Me Crazy: A Five Film,0,0,0,0.0,0.0,0.0
5810,Enemies Closer,0,5000000,-5000000,0.0,4680166.76370212,-4680166.76370212
5811,Force of Execution,0,10000000,-10000000,0.0,9360333.52740424,-9360333.52740424
5812,Parkland,653651,10000000,-9346349,611839.137052131,9360333.52740424,-8748494.390352108
5813,Ghost Shark,0,0,0,0.0,0.0,0.0
5814,The Borderlands,0,0,0,0.0,0.0,0.0
5815,Living on One Dollar,0,0,0,0.0,0.0,0.0
5816,I Declare War,0,0,0,0.0,0.0,0.0
5817,Crush,0,0,0,0.0,0.0,0.0
5818,100 Degrees Below Zero,0,500000,-500000,0.0,468016.67637021205,-468016.67637021205
5819,Hatchet III,0,0,0,0.0,0.0,0.0
5820,Syrup,0,6000000,-6000000,0.0,5616200.11644254,-5616200.11644254
5821,Michael Kohlhaas,0,0,0,0.0,0.0,0.0
5822,Torment,0,0,0,0.0,0.0,0.0
5823,The Demented,0,0,0,0.0,0.0,0.0
5824,Antisocial,0,0,0,0.0,0.0,0.0
5825,Miele,0,0,0,0.0,0.0,0.0
5826,The Wizards Return: Alex vs. Alex,0,0,0,0.0,0.0,0.0
5827,Jodorowsky's Dune,0,0,0,0.0,0.0,0.0
5828,The Inevitable Defeat of Mister & Pete,0,0,0,0.0,0.0,0.0
5829,How I Live Now,0,0,0,0.0,0.0,0.0
5830,Doctor Who: The Time of the Doctor,0,0,0,0.0,0.0,0.0
5831,Welcome to the Jungle,0,3500000,-3500000,0.0,3276116.73459148,-3276116.73459148
5832,Downloaded,0,0,0,0.0,0.0,0.0
5833,The Last Exorcism Part II,15179302,5000000,10179302,14208332.9433194,4680166.76370212,9528166.179617282
5834,InAPPropriate Comedy,228,0,228,213.41560442481602,0.0,213.41560442481602
5835,Dirty Wars,0,0,0,0.0,0.0,0.0
5836,The Suspect,0,0,0,0.0,0.0,0.0
5837,What Maisie Knew,1066471,6000000,-4933529,998252.425730433,5616200.11644254,-4617947.690712106
5838,Cottage Country,0,0,0,0.0,0.0,0.0
5839,Teen Beach Movie,0,0,0,0.0,0.0,0.0
5840,Mandela: Long Walk to Freedom,27330000,35000000,-7670000,25581791.530395802,32761167.3459148,-7179375.815518998
5841,Blue Caprice,0,0,0,0.0,0.0,0.0
5842,Louis C.K.: Oh My God,0,0,0,0.0,0.0,0.0
5843,Vamp U,0,0,0,0.0,0.0,0.0
5844,Zombie Night,0,1000000,-1000000,0.0,936033.3527404241,-936033.3527404241
5845,The Hunters,0,0,0,0.0,0.0,0.0
5846,Philomena,100129872,12000000,88129872,93724899.7976296,11232400.232885001,82492499.56474459
5847,Madly Madagascar,0,0,0,0.0,0.0,0.0
5848,Bettie Page Reveals All,0,0,0,0.0,0.0,0.0
5849,Family Weekend,0,0,0,0.0,0.0,0.0
5850,Return to Nim's Island,0,0,0,0.0,0.0,0.0
5851,Crazy Kind of Love,0,0,0,0.0,0.0,0.0
5852,Hross Ã­ oss,11,10,1,10.2963668801446,9.36033352740424,0.9360333527403597
5853,Sexy Evil Genius,0,0,0,0.0,0.0,0.0
5854,Magic Magic,0,0,0,0.0,0.0,0.0
5855,Prince Avalanche,0,725000,-725000,0.0,678624.180736808,-678624.180736808
5856,Louder Than Words,0,0,0,0.0,0.0,0.0
5857,Castello Cavalcanti,0,0,0,0.0,0.0,0.0
5858,The Crash Reel,0,0,0,0.0,0.0,0.0
5859,The Unknown Known,0,0,0,0.0,0.0,0.0
5860,Diana,21766271,15000000,6766271,20373955.620786604,14040500.291106302,6333455.329680301
5861,Test,0,0,0,0.0,0.0,0.0
5862,Touchy Feely,35022,0,35022,32781.7600796751,0.0,32781.7600796751
5863,The Marine 3: Homefront,0,0,0,0.0,0.0,0.0
5864,Forbidden Ground,0,0,0,0.0,0.0,0.0
5865,Dear Dumb Diary,0,0,0,0.0,0.0,0.0
5866,Jinxed,0,5000000,-5000000,0.0,4680166.76370212,-4680166.76370212
5867,Compulsion,0,4000000,-4000000,0.0,3744133.41096169,-3744133.41096169
5868,The Saratov Approach,0,0,0,0.0,0.0,0.0
5869,Dark Touch,0,0,0,0.0,0.0,0.0
5870,David Blaine: Real or Magic,0,0,0,0.0,0.0,0.0
5871,Tesis sobre un homicidio,0,0,0,0.0,0.0,0.0
5872,Alan Partridge: Alpha Papa,0,0,0,0.0,0.0,0.0
5873,Grave Halloween,0,0,0,0.0,0.0,0.0
5874,The Den,0,0,0,0.0,0.0,0.0
5875,Gimme Shelter,1359910,7500000,-6140090,1272921.11672523,7020250.14555318,-5747329.02882795
5876,The Challenger,0,0,0,0.0,0.0,0.0
5877,Drones,0,0,0,0.0,0.0,0.0
5878,Jack the Giant Killer,0,50000,-50000,0.0,46801.6676370212,-46801.6676370212
5879,The Right Kind of Wrong,0,0,0,0.0,0.0,0.0
5880,Particle Fever,0,0,0,0.0,0.0,0.0
5881,A Promise,0,0,0,0.0,0.0,0.0
5882,The Blue Umbrella,0,0,0,0.0,0.0,0.0
5883,A Field in England,32846,0,32846,30744.9515041119,0.0,30744.9515041119
5884,Free Ride,0,0,0,0.0,0.0,0.0
5885,Pete's Christmas,0,0,0,0.0,0.0,0.0
5886,Phil Spector,0,0,0,0.0,0.0,0.0
5887,Heatstroke,0,0,0,0.0,0.0,0.0
5888,Frankenstein's Army,0,0,0,0.0,0.0,0.0
5889,The Selfish Giant,0,0,0,0.0,0.0,0.0
5890,ëª½íƒ€ì£¼,0,0,0,0.0,0.0,0.0
5891,Proxy,0,0,0,0.0,0.0,0.0
5892,All Hallows' Eve,0,0,0,0.0,0.0,0.0
5893,AE: Apocalypse Earth,0,1000000,-1000000,0.0,936033.3527404241,-936033.3527404241
5894,DrogÃ³wka,0,1800000,-1800000,0.0,1684860.03493276,-1684860.03493276
5895,Hansel & Gretel,0,135000,-135000,0.0,126364.502619957,-126364.502619957
5896,The Wee Man,0,0,0,0.0,0.0,0.0
5897,No Half Measures: Creating the Final Season of Breaking Bad,0,0,0,0.0,0.0,0.0
5898,ì§‘ìœ¼ë¡œ ê°€ëŠ” ê¸¸,0,0,0,0.0,0.0,0.0
5899,Non-Stop,0,0,0,0.0,0.0,0.0
5900,Ninja: Shadow of a Tear,0,0,0,0.0,0.0,0.0
5901,Hotel Inferno,0,0,0,0.0,0.0,0.0
5902,The Hot Flashes,0,4000000,-4000000,0.0,3744133.41096169,-3744133.41096169
5903,Getaway,10501938,18000000,-7498062,9830164.23641207,16848600.3493276,-7018436.112915531
5904,Blutgletscher,0,0,0,0.0,0.0,0.0
5905,The Monkey's Paw,0,0,0,0.0,0.0,0.0
5906,Still Life,0,0,0,0.0,0.0,0.0
5907,Three Night Stand,0,0,0,0.0,0.0,0.0
5908,On the Job,466088,1052753,-586665,436273.913312079,985411.92019754,-549138.006885461
5909,Fright Night 2: New Blood,0,8000000,-8000000,0.0,7488266.82192339,-7488266.82192339
5910,Good Olâ€™ Freda,135039,0,135039,126401.00792071401,0.0,126401.00792071401
5911,The Class of '92,0,0,0,0.0,0.0,0.0
5912,Against the Wild,0,0,0,0.0,0.0,0.0
5913,Wrong Cops,0,0,0,0.0,0.0,0.0
5914,One Direction: This Is Us,0,10000000,-10000000,0.0,9360333.52740424,-9360333.52740424
5915,Phineas and Ferb: Mission Marvel,0,0,0,0.0,0.0,0.0
5916,Rushlights,0,0,0,0.0,0.0,0.0
5917,Social Nightmare,0,0,0,0.0,0.0,0.0
5918,Gerontophilia,4793,0,4793,4486.407859684849,0.0,4486.407859684849
5919,Chce siÄ™ Å¼yÄ‡,0,996519,-996519,0.0,932775.020639535,-932775.020639535
5920,The Food Guide to Love,0,0,0,0.0,0.0,0.0
5921,The Missing Picture,52164,0,52164,48827.2438123515,0.0,48827.2438123515
5922,Terms and Conditions May Apply,0,0,0,0.0,0.0,0.0
5923,Tropico,0,0,0,0.0,0.0,0.0
5924,Dear Mr. Watterson,0,0,0,0.0,0.0,0.0
5925,Beneath,0,89,-89,0.0,83.3069683938978,-83.3069683938978
5926,Chilling Visions: 5 Senses of Fear,0,0,0,0.0,0.0,0.0
5927,Crystal Fairy & the Magical Cactus,0,0,0,0.0,0.0,0.0
5928,Open Road,0,3000000,-3000000,0.0,2808100.05822127,-2808100.05822127
5929,Age of Dinosaurs,0,0,0,0.0,0.0,0.0
5930,500 MPH Storm,0,3000000,-3000000,0.0,2808100.05822127,-2808100.05822127
5931,A Haunting at Silver Falls,0,0,0,0.0,0.0,0.0
5932,Nothing Left to Fear,1675381,3000000,-1324619,1568212.4945476002,2808100.05822127,-1239887.5636736697
5933,Hansel & Gretel: Warriors of Witchcraft,0,0,0,0.0,0.0,0.0
5934,Prada: Candy,0,0,0,0.0,0.0,0.0
5935,The Cheshire Murders,0,0,0,0.0,0.0,0.0
5936,Swindle,0,0,0,0.0,0.0,0.0
5937,Absolute Deception,0,5000000,-5000000,0.0,4680166.76370212,-4680166.76370212
5938,Go Goa Gone,0,0,0,0.0,0.0,0.0
5939,Spiders,0,7000000,-7000000,0.0,6552233.46918297,-6552233.46918297
5940,Zombie Massacre,0,1000000,-1000000,0.0,936033.3527404241,-936033.3527404241
5941,Au bout du conte,0,0,0,0.0,0.0,0.0
5942,Madonna: MDNA World Tour,0,0,0,0.0,0.0,0.0
5943,The Stranger Within,0,800000,-800000,0.0,748826.6821923391,-748826.6821923391
5944,Quai d'Orsay,0,5112027,-5112027,0.0,4785027.77210957,-4785027.77210957
5945,The Wicked,0,800000,-800000,0.0,748826.6821923391,-748826.6821923391
5946,Cavemen,0,0,0,0.0,0.0,0.0
5947,Comedy Central Roast of James Franco,0,0,0,0.0,0.0,0.0
5948,Shadow People,0,0,0,0.0,0.0,0.0
5949,Prisoners of the Sun,0,18,-18,0.0,16.8486003493276,-16.8486003493276
5950,Hellbenders,0,0,0,0.0,0.0,0.0
5951,Dragonfyre,0,0,0,0.0,0.0,0.0
5952,The Bell Witch Haunting,0,0,0,0.0,0.0,0.0
5953,Chariot,0,0,0,0.0,0.0,0.0
5954,SAGA - Curse of the Shadow,0,0,0,0.0,0.0,0.0
5955,Get a Horse!,0,0,0,0.0,0.0,0.0
5956,Peeples,0,15,-15,0.0,14.0405002911063,-14.0405002911063
5957,We Steal Secrets: The Story of WikiLeaks,602042,0,602042,563531.39175055,0.0,563531.39175055
5958,Lego Batman: The Movie - DC Super Heroes Unite,0,0,0,0.0,0.0,0.0
5959,Muscle Shoals,0,0,0,0.0,0.0,0.0
5960,The Contractor,0,0,0,0.0,0.0,0.0
5961,The Frankenstein Theory,0,0,0,0.0,0.0,0.0
5962,Ego,0,0,0,0.0,0.0,0.0
5963,As Cool as I Am,0,0,0,0.0,0.0,0.0
5964,Sunshine on Leith,0,0,0,0.0,0.0,0.0
5965,Lucky Them,0,0,0,0.0,0.0,0.0
5966,Mischief Night,0,0,0,0.0,0.0,0.0
5967,Hansel and Gretel Get Baked,0,4500000,-4500000,0.0,4212150.08733191,-4212150.08733191
5968,The Makeover,0,8000000,-8000000,0.0,7488266.82192339,-7488266.82192339
5969,iSteve,0,0,0,0.0,0.0,0.0
5970,David Bowie: Five Years,0,0,0,0.0,0.0,0.0
5971,Birth of the Living Dead,0,0,0,0.0,0.0,0.0
5972,Top Gear: The Perfect Road Trip,0,0,0,0.0,0.0,0.0
5973,Drift,0,11000000,-11000000,0.0,10296366.8801446,-10296366.8801446
5974,The Haunting of Helena,0,0,0,0.0,0.0,0.0
5975,At Middleton,0,2500000,-2500000,0.0,2340083.38185106,-2340083.38185106
5976,House of Versace,0,0,0,0.0,0.0,0.0
5977,ìºì¹˜ë¯¸,0,0,0,0.0,0.0,0.0
5978,Nailbiter,0,0,0,0.0,0.0,0.0
5979,Legenda No. 17,0,7720000,-7720000,0.0,7226177.48315607,-7226177.48315607
5980,The Punk Singer,0,0,0,0.0,0.0,0.0
5981,Molly Maxwell,0,0,0,0.0,0.0,0.0
5982,Home Sweet Home,0,0,0,0.0,0.0,0.0
5983,C.O.G.,0,0,0,0.0,0.0,0.0
5984,Aningaaq,0,0,0,0.0,0.0,0.0
5985,Justin Bieber's Believe,0,0,0,0.0,0.0,0.0
5986,"Guten Tag, RamÃ³n",0,4000000,-4000000,0.0,3744133.41096169,-3744133.41096169
5987,Snow Bride,0,0,0,0.0,0.0,0.0
5988,I'll Follow You Down,0,0,0,0.0,0.0,0.0
5989,Scooby-Doo! Stage Fright,0,0,0,0.0,0.0,0.0
5990,Paranormal Whacktivity,0,3600000,-3600000,0.0,3369720.06986552,-3369720.06986552
5991,Salinger,0,0,0,0.0,0.0,0.0
5992,Amiche da morire,0,0,0,0.0,0.0,0.0
5993,Lights Out,0,0,0,0.0,0.0,0.0
5994,Girl Rising,0,0,0,0.0,0.0,0.0
5995,Tim's Vermeer,0,0,0,0.0,0.0,0.0
5996,Mystery Road,0,0,0,0.0,0.0,0.0
5997,Deep Dark Canyon,0,0,0,0.0,0.0,0.0
5998,Gori Tere Pyaar Mein,342000,0,342000,320123.406637225,0.0,320123.406637225
5999,Antarctica: A Year on Ice,0,1000000,-1000000,0.0,936033.3527404241,-936033.3527404241
6000,The Appearing,0,1000000,-1000000,0.0,936033.3527404241,-936033.3527404241
6001,The Jeffrey Dahmer Files,0,0,0,0.0,0.0,0.0
6002,Coffee Town,0,0,0,0.0,0.0,0.0
6003,Viaggio Sola,0,0,0,0.0,0.0,0.0
6004,Les grandes ondes (Ã  l'ouest),0,0,0,0.0,0.0,0.0
6005,Bo Burnham: what.,0,0,0,0.0,0.0,0.0
6006,Cutie and the Boxer,0,0,0,0.0,0.0,0.0
6007,Neverlake,0,232000,-232000,0.0,217159.737835778,-217159.737835778
6008,Crystal Lake Memories: The Complete History of Friday the 13th,0,0,0,0.0,0.0,0.0
6009,Interior. Leather Bar.,0,0,0,0.0,0.0,0.0
6010,Home Run,2861020,1200000,1661020,2678010.14285741,1123240.0232885,1554770.11956891
6011,Jimi: All Is by My Side,97,0,97,90.79523521582121,0.0,90.79523521582121
6012,Not Another Happy Ending,0,0,0,0.0,0.0,0.0
6013,Djinn,0,0,0,0.0,0.0,0.0
6014,Bridegroom,0,0,0,0.0,0.0,0.0
6015,La gran familia espaÃ±ola,0,0,0,0.0,0.0,0.0
6016,History of the Eagles,0,0,0,0.0,0.0,0.0
6017,Willow Creek,0,0,0,0.0,0.0,0.0
6018,The Unbelievers,0,0,0,0.0,0.0,0.0
6019,R'ha,0,0,0,0.0,0.0,0.0
6020,Death Comes to Pemberley,0,0,0,0.0,0.0,0.0
6021,See Girl Run,0,0,0,0.0,0.0,0.0
6022,Les rencontres d'aprÃ¨s minuit,0,0,0,0.0,0.0,0.0
6023,My Amityville Horror,0,0,0,0.0,0.0,0.0
6024,Narco Cultura,0,0,0,0.0,0.0,0.0
6025,Grace Unplugged,0,0,0,0.0,0.0,0.0
6026,uwantme2killhim?,0,0,0,0.0,0.0,0.0
6027,L'arbitro,0,0,0,0.0,0.0,0.0
6028,Paradise,0,0,0,0.0,0.0,0.0
6029,Toy Story of Terror!,0,0,0,0.0,0.0,0.0
6030,Is the Man Who Is Tall Happy?,0,0,0,0.0,0.0,0.0
6031,Porno,0,0,0,0.0,0.0,0.0
6032,Ass Backwards,0,3000000,-3000000,0.0,2808100.05822127,-2808100.05822127
6033,Russell Brand: Messiah Complex,0,0,0,0.0,0.0,0.0
6034,Five Dances,0,0,0,0.0,0.0,0.0
6035,Unhung Hero,0,0,0,0.0,0.0,0.0
6036,Pussy Riot: A Punk Prayer,0,0,0,0.0,0.0,0.0
6037,Computer Chess,0,0,0,0.0,0.0,0.0
6038,×›×™×“×•×Ÿ,0,0,0,0.0,0.0,0.0
6039,Mr. Jones,0,0,0,0.0,0.0,0.0
6040,The Vatican Exorcisms,0,0,0,0.0,0.0,0.0
6041,The Internship,44000000,58000000,-14000000,41185467.5205786,54289934.458944604,-13104466.938366003
6042,Life of a King,0,0,0,0.0,0.0,0.0
6043,Bombay Talkies,0,0,0,0.0,0.0,0.0
6044,Run,0,0,0,0.0,0.0,0.0
6045,The Story of Luke,0,0,0,0.0,0.0,0.0
6046,Gus,0,0,0,0.0,0.0,0.0
6047,95ers: Time Runners,0,750,-750,0.0,702.025014555318,-702.025014555318
6048,Zero Charisma,0,0,0,0.0,0.0,0.0
6049,Boss,0,0,0,0.0,0.0,0.0
6050,Jimi Hendrix: Hear My Train A Comin',0,0,0,0.0,0.0,0.0
6051,Aziz Ansari: Buried Alive,0,0,0,0.0,0.0,0.0
6052,KÃ¤nn ingen sorg,0,0,0,0.0,0.0,0.0
6053,The Dirties,0,0,0,0.0,0.0,0.0
6054,Sacro GRA,0,0,0,0.0,0.0,0.0
6055,Somm,0,0,0,0.0,0.0,0.0
6056,Yip Man: The Final Fight,37884,0,37884,35460.687535218196,0.0,35460.687535218196
6057,100% Cachemire,0,1400000,-1400000,0.0,1310446.69383659,-1310446.69383659
6058,Escape from Tomorrow,0,650,-650,0.0,608.421679281276,-608.421679281276
6059,The Stone Roses: Made of Stone,729043,0,729043,682408.563581937,0.0,682408.563581937
6060,TINY: A Story About Living Small,0,0,0,0.0,0.0,0.0
6061,The Starving Games,0,4500000,-4500000,0.0,4212150.08733191,-4212150.08733191
6062,I Know That Voice,0,0,0,0.0,0.0,0.0
6063,How to Be a Man,0,0,0,0.0,0.0,0.0
6064,ABE,0,0,0,0.0,0.0,0.0
6065,Ð¡Ñ‚Ð°Ð»Ð¸Ð½Ð³Ñ€Ð°Ð´,68129518,30000000,38129518,63771501.1541291,28081000.5822127,35690500.5719164
6066,A Viking Saga: The Darkest Day,0,0,0,0.0,0.0,0.0
6067,Beyonce: Life Is But A Dream,0,0,0,0.0,0.0,0.0
6068,A Very Merry Mix-Up,0,0,0,0.0,0.0,0.0
6069,Dark Circles,0,0,0,0.0,0.0,0.0
6070,Master of the Universe,0,0,0,0.0,0.0,0.0
6071,Portal: Survive!,0,500,-500,0.0,468.016676370212,-468.016676370212
6072,Minha MÃ£e Ã© uma PeÃ§a,0,0,0,0.0,0.0,0.0
6073,Bronies: The Extremely Unexpected Adult Fans of My Little Pony,0,348164,-348164,0.0,325893.116223517,-325893.116223517
6074,Russell Peters: Notorious,0,0,0,0.0,0.0,0.0
6075,Embrace of the Vampire,0,0,0,0.0,0.0,0.0
6076,Mistaken for Strangers,137460,0,137460,128667.14466769801,0.0,128667.14466769801
6077,Atlantic Rim,0,0,0,0.0,0.0,0.0
6078,Trophy Kids,0,0,0,0.0,0.0,0.0
6079,The Sound of Music Live!,0,0,0,0.0,0.0,0.0
6080,G.B.F.,0,0,0,0.0,0.0,0.0
6081,Back to the Future,381109762,19000000,362109762,772572771.713735,38516154.993062,734056616.720673
6082,The Breakfast Club,51525171,1000000,50525171,104450077.48842199,2027166.05226642,102422911.43615557
6083,Ladyhawke,18432000,20000000,-1568000,37364724.6753747,40543321.0453284,-3178596.3699536994
6084,Mad Max Beyond Thunderdome,36230219,12305523,23924696,73444670.0229779,24945338.480983604,48499331.5419943
6085,A View to a Kill,152427960,30000000,122427960,308996785.928224,60814981.567992605,248181804.36023143
6086,Legend,15502112,25000000,-9497888,31425355.1848319,50679151.306660496,-19253796.121828597
6087,The Goonies,61389680,19000000,42389680,124447075.25549799,38516154.993062,85930920.262436
6088,A Nightmare on Elm Street Part 2: Freddy's Revenge,29999213,3000000,26999213,60813386.1883095,6081498.15679926,54731888.03151024
6089,Rambo: First Blood Part II,300400432,44000000,256400432,608961557.836567,89195306.2997226,519766251.53684443
6090,Out of Africa,128499205,31000000,97499205,260489226.119223,62842147.620259106,197647078.4989639
6091,Rocky IV,300473716,31000000,269473716,609110116.673542,62842147.620259106,546267969.053283
6092,Brazil,0,15000000,-15000000,0.0,30407490.783996303,-30407490.783996303
6093,The Black Cauldron,21288692,25000000,-3711308,43155713.7195557,50679151.306660496,-7523437.587104797
6094,The Color Purple,146292009,15000000,131292009,296558194.36265403,30407490.783996303,266150703.57865772
6095,Commando,57500000,10000000,47500000,116562048.005319,20271660.5226642,96290387.4826548
6096,King Solomon's Mines,238227,12500000,-12261773,482925.687133273,25339575.6533302,-24856649.96619693
6097,The Return of the Living Dead,14237000,4000000,10237000,28860763.086117,8108664.20906569,20752098.87705131
6098,Witness,68706993,12000000,56706993,139280483.76290601,24325992.627197,114954491.13570902
6099,The Emerald Forest,24467000,0,24467000,49598671.8008025,0.0,49598671.8008025
6100,Cocoon,85313124,0,85313124,172943868.785595,0.0,172943868.785595
6101,D.A.R.Y.L.,7840873,0,7840873,15894751.5657323,0.0,15894751.5657323
6102,Fright Night,24922237,9000000,15922237,50521512.792938106,18244494.4703978,32277018.322540306
6103,National Lampoonâ€™s European Vacation,49364621,0,49364621,100070283.874198,0.0,100070283.874198
6104,Police Academy 2: Their First Assignment,55600000,0,55600000,112710432.50601299,0.0,112710432.50601299
6105,Red Sonja,6948633,17900000,-10951367,14086032.927258098,36286272.3355689,-22200239.4083108
6106,Day of the Dead,34000000,3500000,30500000,68923645.7770583,7095081.18293247,61828564.59412584
6107,Clue: The Movie,14643997,15000000,-356003,29685813.587891303,30407490.783996303,-721677.1961049996
6108,Friday the 13th: A New Beginning,21930418,2200000,19730418,44456598.8816124,4459765.31498612,39996833.56662628
6109,Santa Claus: The Movie,23717291,50000000,-26282709,48078887.1669239,101358302.61332099,-53279415.44639709
6110,Code of Silence,20345361,0,20345361,41243425.1403052,0.0,41243425.1403052
6111,The Quiet Earth,0,1000000,-1000000,0.0,2027166.05226642,-2027166.05226642
6112,American Ninja,0,1000000,-1000000,0.0,2027166.05226642,-2027166.05226642
6113,Fletch,0,0,0,0.0,0.0,0.0
6114,Weird Science,38934048,0,38934048,78925780.3829114,0.0,78925780.3829114
6115,Pale Rider,41410568,0,41410568,83946097.65467021,0.0,83946097.65467021
6116,The Purple Rose of Cairo,10631333,15000000,-4368667,21551477.3479397,30407490.783996303,-8856013.436056603
6117,Mask,42400000,0,42400000,85951840.6160963,0.0,85951840.6160963
6118,Phenomena,0,3800000,-3800000,0.0,7703230.998612401,-7703230.998612401
6119,The Jewel of the Nile,96773200,25000000,71773200,196175345.80918798,50679151.306660496,145496194.50252748
6120,Lifeforce,0,25000000,-25000000,0.0,50679151.306660496,-50679151.306660496
6121,Re-Animator,2023414,900000,1123414,4101796.17048061,1824449.44703978,2277346.7234408297
6122,Porky's Revenge,20518905,9000000,11518905,41595227.645679705,18244494.4703978,23350733.175281905
6123,The Man with One Red Shoe,0,0,0,0.0,0.0,0.0
6124,Real Genius,13000000,0,13000000,26353158.679463398,0.0,26353158.679463398
6125,The Sure Thing,0,0,0,0.0,0.0,0.0
6126,Spies Like Us,0,0,0,0.0,0.0,0.0
6127,Death Wish 3,0,0,0,0.0,0.0,0.0
6128,Private Resort,331816,0,331816,672646.130798835,0.0,672646.130798835
6129,After Hours,10609321,4500000,6109321,21506855.368797198,9122247.2351989,12384608.133598298
6130,Pee-wee's Big Adventure,40940662,6000000,34940662,82993520.1637139,12162996.3135985,70830523.8501154
6131,Prizzi's Honor,26657534,0,26657534,54039247.9619379,0.0,54039247.9619379
6132,Better Off Dead...,10297601,0,10297601,20874947.1669847,0.0,20874947.1669847
6133,Death of a Salesman,0,0,0,0.0,0.0,0.0
6134,Ewoks: The Battle for Endor,0,0,0,0.0,0.0,0.0
6135,A Chorus Line,14202899,0,14202899,28791634.6965687,0.0,28791634.6965687
6136,Cat's Eye,0,0,0,0.0,0.0,0.0
6137,Brewster's Millions,45833132,20000000,25833132,92911369.2594458,40543321.0453284,52368048.2141174
6138,Invasion U.S.A.,0,0,0,0.0,0.0,0.0
6139,Enemy Mine,12303411,0,12303411,24941057.1062812,0.0,24941057.1062812
6140,Silverado,0,26000000,-26000000,0.0,52706317.3589269,-52706317.3589269
6141,Alice in Wonderland,0,0,0,0.0,0.0,0.0
6142,The Protector,0,0,0,0.0,0.0,0.0
6143,Teen Wolf,0,0,0,0.0,0.0,0.0
6144,Kiss of the Spider Woman,0,0,0,0.0,0.0,0.0
6145,Silver Bullet,0,0,0,0.0,0.0,0.0
6146,St. Elmo's Fire,37803872,0,37803872,76634725.9626251,0.0,76634725.9626251
6147,Fandango,0,0,0,0.0,0.0,0.0
6148,Crimewave,0,3000000,-3000000,0.0,6081498.15679926,-6081498.15679926
6149,Gotcha!,8800000,0,8800000,17839061.259944502,0.0,17839061.259944502
6150,Loose Screws,0,945000,-945000,0.0,1915671.91939176,-1915671.91939176
6151,Young Sherlock Holmes,0,18000000,-18000000,0.0,36488988.9407956,-36488988.9407956
6152,Desperately Seeking Susan,27400000,5000000,22400000,55544349.8320999,10135830.2613321,45408519.5707678
6153,Summer Rental,24689703,0,24689703,50050127.7621404,0.0,50050127.7621404
6154,Flesh + Blood,0,6500000,-6500000,0.0,13176579.339731699,-13176579.339731699
6155,Mischief,8692426,0,8692426,17620990.899038002,0.0,17620990.899038002
6156,Runaway Train,7936012,9000000,-1063988,16087614.1167789,18244494.4703978,-2156880.3536188994
6157,The Journey of Natty Gann,2135577,0,2135577,4329169.19640097,0.0,4329169.19640097
6158,Volunteers,0,0,0,0.0,0.0,0.0
6159,The Falcon and the Snowman,0,0,0,0.0,0.0,0.0
6160,White Nights,42160849,0,42160849,85467041.8275307,0.0,85467041.8275307
6161,Return to Oz,11137801,25000000,-13862199,22578172.084099,50679151.306660496,-28100979.222561497
6162,Transylvania 6-5000,0,0,0,0.0,0.0,0.0
6163,My Science Project,4122748,0,4122748,8357494.78764928,0.0,8357494.78764928
6164,Jagged Edge,0,15000000,-15000000,0.0,30407490.783996303,-30407490.783996303
6165,Mishima: A Life in Four Chapters,502758,5000000,-4497242,1019173.95010536,10135830.2613321,-9116656.31122674
6166,Howling II: Stirba - Werewolf Bitch,0,0,0,0.0,0.0,0.0
6167,Remo Williams: The Adventure Begins...,14393902,0,14393902,29178829.4940497,0.0,29178829.4940497
6168,Once Bitten,10000000,3200000,6800000,20271660.5226642,6486931.36725255,13784729.15541165
6169,American Flyers,1400000,0,1400000,2838032.47317299,0.0,2838032.47317299
6170,Anne of Green Gables,0,0,0,0.0,0.0,0.0
6171,To Live and Die in L.A.,17307019,0,17307019,35084201.3827299,0.0,35084201.3827299
6172,The Last Dragon,25754284,10000000,15754284,52208210.225228205,20271660.5226642,31936549.702564005
6173,The Stuff,0,1700000,-1700000,0.0,3446182.28885291,-3446182.28885291
6174,Girls Just Want to Have Fun,0,0,0,0.0,0.0,0.0
6175,Explorers,9873044,25000000,-15126956,20014299.629332602,50679151.306660496,-30664851.677327894
6176,Shoah,0,0,0,0.0,0.0,0.0
6177,Year of the Dragon,0,24000000,-24000000,0.0,48651985.25439411,-48651985.25439411
6178,Perfect,12918858,19000000,-6081142,26188670.3716504,38516154.993062,-12327484.621411595
6179,Into the Night,6700000,114,6699886,13582012.550185,231.09692995837202,13581781.453255042
6180,Just One of the Guys,0,11500000,-11500000,0.0,23312409.6010638,-23312409.6010638
6181,"North and South, Book I",0,0,0,0.0,0.0,0.0
6182,Secret Admirer,8622757,0,8622757,17479760.2673426,0.0,17479760.2673426
6183,My Beautiful Laundrette,2451545,860000,1591545,4969688.79960348,1743362.80494912,3226325.99465436
6184,Scout Toujours,0,0,0,0.0,0.0,0.0
6185,Missing in Action 2: The Beginning,10755447,2410000,8345447,21803077.0353507,4885470.18596207,16917606.84938863
6186,The Legend of Billie Jean,0,0,0,0.0,0.0,0.0
6187,The Care Bears Movie,0,0,0,0.0,0.0,0.0
6188,A Zed & Two Noughts,0,0,0,0.0,0.0,0.0
6189,Vision Quest,0,0,0,0.0,0.0,0.0
6190,Harry Potter and the Goblet of Fire,895921036,150000000,745921036,1000352539.2268199,167484493.448174,832868045.7786459
6191,Batman Begins,374218673,150000000,224218673,417838832.575019,167484493.448174,250354339.126845
6192,"The Chronicles of Narnia: The Lion, the Witch and the Wardrobe",748806957,180000000,568806957,836090359.224091,200981392.137808,635108967.0862831
6193,V for Vendetta,132511035,54000000,78511035,147956957.155121,60294417.6413426,87662539.51377839
6194,Sin City,158733820,40000000,118733820,177236356.238624,44662531.5861797,132573824.6524443
6195,Charlie and the Chocolate Factory,474968763,150000000,324968763,530332684.498405,167484493.448174,362848191.050231
6196,Star Wars: Episode III - Revenge of the Sith,850000000,113000000,737000000,949078796.206319,126171651.730957,822907144.475362
6197,The Hitchhiker's Guide to the Galaxy,104478416,50000000,54478416,116656763.86685,55828164.482724704,60828599.3841253
6198,The Island,162949164,126000000,36949164,181943054.602289,140686974.49646598,41256080.10582301
6199,Madagascar,532680671,75000000,457680671,594771682.347123,83742246.724087,511029435.623036
6200,Fantastic Four,330579719,100000000,230579719,369113178.539698,111656328.965449,257456849.574249
6201,Constantine,230427240,100000000,130427240,257286597.120405,111656328.965449,145630268.15495598
6202,Wedding Crashers,285176741,40000000,245176741,318417880.06390697,44662531.5861797,273755348.4777273
6203,Ã†on Flux,52304001,62000000,-9695999,58400727.4186519,69226923.9585786,-10826196.5399267
6204,The Pacifier,113006880,56000000,57006880,126179333.68639,62527544.2206516,63651789.4657384
6205,War of the Worlds,591739379,132000000,459739379,660714467.634347,147386354.234393,513328113.39995396
6206,Memoirs of a Geisha,162242962,85000000,77242962,181154535.374009,94907879.6206319,86246655.75337711
6207,The 40 Year Old Virgin,109449237,26000000,83449237,122207000.11489399,29030645.531016804,93176354.58387718
6208,Chicken Little,314432665,150000000,164432665,351083970.807229,167484493.448174,183599477.35905498
6209,Hitch,368100420,70000000,298100420,411007415.8784,78159430.2758145,332847985.60258555
6210,Transporter 2,85167639,32000000,53167639,95095059.1739463,35730025.2689438,59365033.905002505
6211,Prime,0,0,0,0.0,0.0,0.0
6212,Nanny McPhee,122489822,25000000,97489822,136767638.601513,27914082.2413623,108853556.3601507
6213,Kingdom of Heaven,211643158,130000000,81643158,236312980.72934502,145153227.655084,91159753.07426101
6214,Monster-in-Law,154749918,43000000,111749918,172788077.515843,48012221.4551432,124775856.0606998
6215,King Kong,550000000,207000000,343000000,614109809.309971,231128600.95847997,382981208.351491
6216,Be Cool,95226116,53000000,42226116,106325985.34198001,59177854.351688094,47148130.990291916
6217,Into the Blue,44434439,50000000,-5565561,49613863.3837919,55828164.482724704,-6214301.098932803
6218,Pride & Prejudice,121147947,28000000,93147947,135269350.237208,31263772.1103258,104005578.12688221
6219,Brokeback Mountain,178043761,14000000,164043761,198797127.48461798,15631886.0551629,183165241.42945507
6220,Robots,260696994,75000000,185696994,291084693.223677,83742246.724087,207342446.49958998
6221,Kronk's New Groove,0,0,0,0.0,0.0,0.0
6222,xXx: State of the Union,71073932,87000000,-15926068,79358543.3225998,97141006.1999409,-17782462.877341107
6223,The Sisterhood of the Traveling Pants,39053061,25000000,14053061,43605214.26123761,27914082.2413623,15691132.019875307
6224,Mr. & Mrs. Smith,478207520,110000000,368207520,533948961.66871697,122821961.861994,411126999.806723
6225,Hooligans,3154346,0,3154346,3522026.94646849,0.0,3522026.94646849
6226,The Legend of Zorro,142400065,75000000,67400065,158998685.023413,83742246.724087,75256438.299326
6227,Lord of War,24127895,42000000,-17872105,26940321.8136382,46895658.165488705,-19955336.351850506
6228,Zathura: A Space Adventure,64321501,65000000,-678499,71819026.7520748,72576613.8275421,-757587.0754673034
6229,Elektra,56681566,43000000,13681566,63288555.795728296,48012221.4551432,15276334.340585098
6230,The Ring Two,161451538,0,161451538,180270860.389057,0.0,180270860.389057
6231,Corpse Bride,117195061,40000000,77195061,130855702.841419,44662531.5861797,86193171.2552393
6232,The Curse of the Were-Rabbit,192452832,30000000,162452832,214885767.20124298,33496898.689634804,181388868.51160818
6233,Rumor Has It...,88933562,70000000,18933562,99299950.5474118,78159430.2758145,21140520.271597296
6234,Lie with Me,0,2200000,-2200000,0.0,2456439.23723988,-2456439.23723988
6235,The Jacket,21126225,29000000,-7873775,23588767.283981,32380335.3999803,-8791568.1159993
6236,Jarhead,96889998,72000000,24889998,108183814.90149699,80392556.8551235,27791258.046373487
6237,The Descent,0,0,0,0.0,0.0,0.0
6238,Serenity,38869464,39000000,-130536,43400216.5909469,43545968.2965252,-145751.70557830483
6239,Saw II,152925093,4000000,148925093,170750544.910799,4466253.15861797,166284291.75218102
6240,Just Like Heaven,102854431,58000000,44854431,114843481.832901,64760670.7999606,50082811.0329404
6241,Herbie Fully Loaded,66002004,50000000,16002004,73695414.710029,55828164.482724704,17867250.227304302
6242,Elizabethtown,52034889,57000000,-4965111,58100246.8386464,63644107.510306105,-5543860.671659708
6243,Lilo & Stitch 2: Stitch has a Glitch,0,0,0,0.0,0.0,0.0
6244,Four Brothers,92374674,45000000,47374674,103142169.882201,50245348.0344522,52896821.8477488
6245,Hostel,80578934,4800000,75778934,89971479.62389229,5359503.79034157,84611975.83355072
6246,Kiss Kiss Bang Bang,15785148,15000000,785148,17625116.778563,16748449.344817402,876667.4337455984
6247,Cinderella Man,108539911,88000000,20539911,121191680.08496499,98257569.48959541,22934110.595369577
6248,Match Point,85306374,15000000,70306374,95249965.5819366,16748449.344817402,78501516.2371192
6249,Hoodwinked!,51053787,15000000,36053787,57004784.3620398,16748449.344817402,40256335.0172224
6250,Hide and Seek,122644820,25000000,97644820,136940703.678283,27914082.2413623,109026621.4369207
6251,Bewitched,131426169,85000000,46426169,146745635.605327,94907879.6206319,51837755.98469511
6252,In Her Shoes,83073883,0,83073883,92757248.0868525,0.0,92757248.0868525
6253,American Pie Presents: Band Camp,0,10000000,-10000000,0.0,11165632.8965449,-11165632.8965449
6254,Doom,55987321,60000000,-4012679,62513387.3147021,66993797.37926961,-4480410.064567506
6255,Just Friends,50817508,0,50817508,56740963.9045235,0.0,56740963.9045235
6256,Cheaper by the Dozen 2,129181830,60000000,69181830,144239689.068387,66993797.37926961,77245891.6891174
6257,Fever Pitch,50451307,30000000,20451307,56332077.3112888,33496898.689634804,22835178.621653993
6258,Must Love Dogs,58405313,30000000,28405313,65213228.4165803,33496898.689634804,31716329.726945493
6259,Proof,7535331,20000000,-12464669,8413673.96999548,22331265.7930898,-13917591.82309432
6260,The Interpreter,162944923,80000000,82944923,181938319.257378,89325063.1723595,92613256.08501852
6261,The Brothers Grimm,105316267,88000000,17316267,117592277.535651,98257569.48959541,19334708.046055585
6262,An Unfinished Life,18618284,30000000,-11381716,20788492.4307616,33496898.689634804,-12708406.258873202
6263,Hostage,77944725,52000000,25944725,87030218.5572148,58061291.06203361,28968927.495181188
6264,The Dukes of Hazzard,110803676,50000000,60803676,123719316.98037,55828164.482724704,67891152.49764529
6265,Munich,130358911,70000000,60358911,145553974.501937,78159430.2758145,67394544.2261225
6266,The Exorcism of Emily Rose,144216468,19000000,125216468,161026813.932432,21214702.5034353,139812111.42899668
6267,Thank You for Smoking,24793509,6500000,18293509,27683521.971118297,7257661.38275421,20425860.588364087
6268,Deuce Bigalow: European Gigolo,22400154,22000000,400154,25011189.6390072,24564392.3723988,446797.2666083984
6269,Syriana,94000000,50000000,44000000,104956949.227522,55828164.482724704,49128784.7447973
6270,Son of the Mask,0,84000000,-84000000,0.0,93791316.33097741,-93791316.33097741
6271,Derailed,57479076,22000000,35479076,64179026.184860595,24564392.3723988,39614633.81246179
6272,Oliver Twist,42093706,50000000,-7906294,47000286.8451091,55828164.482724704,-8827877.637615606
6273,The Skeleton Key,91974818,43000000,48974818,102695705.351453,48012221.4551432,54683483.89630981
6274,Chaos,10289,12000000,-11989711,11488.319687255,13398759.4758539,-13387271.156166645
6275,Racing Stripes,93772522,30000000,63772522,104702955.643518,33496898.689634804,71206056.9538832
6276,"Good Night, and Good Luck.",54600000,7000000,47600000,60964355.615135305,7815943.02758145,53148412.58755386
6277,Coach Carter,76669806,30000000,46669806,85606690.8045318,33496898.689634804,52109792.114897
6278,A History of Violence,60740827,32000000,28740827,67820977.6114545,35730025.2689438,32090952.3425107
6279,The Amityville Horror,108047131,19000000,89047131,120641460.02708998,21214702.5034353,99426757.52365468
6280,Fun with Dick and Jane,202026112,100000000,102026112,225574940.210827,111656328.965449,113918611.24537799
6281,Unleashed,50871113,45000000,5871113,56800817.279665396,50245348.0344522,6555469.245213196
6282,Rebound,16809014,45000000,-28190986,18768327.967688397,50245348.0344522,-31477020.066763803
6283,Guess Who,68915888,35000000,33915888,76948950.6147406,39079715.1379072,37869235.476833396
6284,Keeping Mum,18564702,169000,18395702,20728664.7365753,188699.19595160897,20539965.54062369
6285,Two for the Money,30526509,35000000,-4473491,34084779.3107075,39079715.1379072,-4994935.8271996975
6286,Harsh Times,5967038,2000000,3967038,6662575.57877337,2233126.57930898,4429448.99946439
6287,Flightplan,223387299,55000000,168387299,249426057.43847203,61410980.9309971,188015076.50747493
6288,Assault on Precinct 13,35294470,30000000,5294470,39408509.5298118,33496898.689634804,5911610.840176996
6289,The Perfect Man,0,0,0,0.0,0.0,0.0
6290,Broken Flowers,45742101,10000000,35742101,51073950.7682681,11165632.8965449,39908317.871723205
6291,The Weather Man,12482775,20000000,-7517225,13937808.3180168,22331265.7930898,-8393457.475073
6292,Revolver,0,0,0,0.0,0.0,0.0
6293,Wolf Creek,27762648,1000000,26762648,30998753.5803997,1116563.28965449,29882190.29074521
6294,Land of the Dead,46770602,15000000,31770602,52222337.228241,16748449.344817402,35473887.8834236
6295,Miss Congeniality 2: Armed and Fabulous,0,0,0,0.0,0.0,0.0
6296,Feast,658573,0,658573,735338.4353576291,0.0,735338.4353576291
6297,Walk the Line,186438883,28000000,158438883,208170812.521989,31263772.1103258,176907040.41166317
6298,The Family Stone,0,0,0,0.0,0.0,0.0
6299,A Lot Like Love,42886719,30000000,12886719,47885736.049127795,33496898.689634804,14388837.359492991
6300,Get Rich or Die Tryin',46442528,40000000,6442528,51856021.8435509,44662531.5861797,7193490.257371195
6301,Kicking & Screaming,56070433,45000000,11070433,62606187.1228318,50245348.0344522,12360839.0883796
6302,MirrorMask,866999,4000000,-3133001,968059.2555671559,4466253.15861797,-3498193.903050814
6303,Cursed,19294901,35000000,-15705099,21543978.1341177,39079715.1379072,-17535737.0037895
6304,Stay,8342132,50000000,-41657868,9314518.34865202,55828164.482724704,-46513646.134072684
6305,Ice Princess,27645491,25000000,2645491,30867940.3750737,27914082.2413623,2953858.1337114014
6306,The Longest Yard,190320568,82000000,108320568,212504959.494991,91558189.75166851,120946769.74332249
6307,Waiting...,18637690,3000000,15637690,20810160.457960602,3349689.86896348,17460470.588997122
6308,Are We There Yet?,97918663,32000000,65918663,109332384.47784899,35730025.2689438,73602359.20890519
6309,A Sound of Thunder,5989640,80000000,-74010360,6687812.14224614,89325063.1723595,-82637251.03011335
6310,London,0,0,0,0.0,0.0,0.0
6311,Three,0,9000000,-9000000,0.0,10049069.6068904,-10049069.6068904
6312,The Fog,46201432,18000000,28201432,51586822.9006684,20098139.2137808,31488683.686887596
6313,Stealth,76932943,135000000,-58067057,85900499.9188816,150736044.103356,-64835544.18447441
6314,The Wedding Date,47175038,15000000,32175038,52673915.6188557,16748449.344817402,35925466.2740383
6315,BloodRayne,2405420,25000000,-22594580,2685803.66820071,27914082.2413623,-25228278.57316159
6316,The World's Fastest Indian,0,25000000,-25000000,0.0,27914082.2413623,-27914082.2413623
6317,Breakfast on Pluto,0,0,0,0.0,0.0,0.0
6318,Casanova,37691644,0,37691644,42085106.017126,0.0,42085106.017126
6319,The Land Before Time XI: Invasion of the Tinysauruses,0,0,0,0.0,0.0,0.0
6320,Sahara,119269486,130000000,-10730514,133171929.64356,145153227.655084,-11981298.011524007
6321,The Matador,17297244,10000000,7297244,19313467.662596397,11165632.8965449,8147834.766051497
6322,Capote,49084830,7000000,42084830,54806319.2569315,7815943.02758145,46990376.229350045
6323,Valiant,19478106,35000000,-15521894,21748538.111598898,39079715.1379072,-17331177.0263083
6324,The Constant Gardener,82466670,25000000,57466670,92079256.3420515,27914082.2413623,64165174.1006892
6325,Imagine Me & You,2455831,0,2455831,2742090.74019548,0.0,2742090.74019548
6326,Hard Candy,7022209,950000,6072209,7840740.78168139,1060735.12517176,6780005.656509629
6327,House of Wax,68766121,40000000,28766121,76781726.2805389,44662531.5861797,32119194.6943592
6328,The Great Raid,10166502,80000000,-69833498,11351542.9173989,89325063.1723595,-77973520.2549606
6329,Domino,22944502,50000000,-27055498,25618988.6326041,55828164.482724704,-30209175.850120604
6330,The Batman vs Dracula,0,0,0,0.0,0.0,0.0
6331,The Sandlot 2,0,0,0,0.0,0.0,0.0
6332,Beauty Shop,36351350,25000000,11351350,40588582.9393818,27914082.2413623,12674500.6980195
6333,The Man,12382362,0,12382362,13825690.848412698,0.0,13825690.848412698
6334,Kinky Boots,0,0,0,0.0,0.0,0.0
6335,The Adventures of Sharkboy and Lavagirl,69425966,50000000,19425966,77518484.984401,55828164.482724704,21690320.5016763
6336,Tarzan II,0,0,0,0.0,0.0,0.0
6337,The Greatest Game Ever Played,15431177,25000000,-9568823,17229885.7543607,27914082.2413623,-10684196.487001602
6338,Little Manhattan,1117920,0,1117920,1248228.43277055,0.0,1248228.43277055
6339,Edison,0,0,0,0.0,0.0,0.0
6340,Urban Legends: Bloody Mary,0,3500000,-3500000,0.0,3907971.51379072,-3907971.51379072
6341,The Three Burials of Melquiades Estrada,12036149,15000000,-2963851,13439122.1222116,16748449.344817402,-3309327.222605802
6342,7 Seconds,0,13000000,-13000000,0.0,14515322.765508402,-14515322.765508402
6343,Santa's Slay,0,0,0,0.0,0.0,0.0
6344,Cry_Wolf,10047674,1000000,9047674,11218863.9348159,1116563.28965449,10102300.64516141
6345,Goal!: The Dream Begins,27610873,30000000,-2389127,30829287.187112395,33496898.689634804,-2667611.502522409
6346,White Noise,91196419,10000000,81196419,101826573.603349,11165632.8965449,90660940.7068041
6347,Enron: The Smartest Guys in the Room,0,0,0,0.0,0.0,0.0
6348,Brick,3919254,475000,3444254,4376095.13923153,530367.562585884,3845727.5766456462
6349,Dominion: Prequel to the Exorcist,251495,30000000,-29748505,280810.084531656,33496898.689634804,-33216088.605103146
6350,Tom and Jerry: The Fast and the Furry,0,0,0,0.0,0.0,0.0
6351,The New World,30536013,30000000,536013,34095391.128212295,33496898.689634804,598492.4385774918
6352,Manderlay,674918,14200000,-13525082,753588.6623270309,15855198.713093802,-15101610.050766772
6353,Love Wrecked,0,0,0,0.0,0.0,0.0
6354,Sky High,86369815,35000000,51369815,96437364.76325,39079715.1379072,57357649.625342794
6355,The Quiet,381420,900000,-518580,425879.569940017,1004906.96068904,-579027.3907490231
6356,Red Eye,57891803,26000000,31891803,64639862.0017099,29030645.531016804,35609216.4706931
6357,FrÃ¡giles,0,0,0,0.0,0.0,0.0
6358,The Ringer,40442437,0,40442437,45156540.4983646,0.0,45156540.4983646
6359,The Muppets' Wizard of Oz,0,0,0,0.0,0.0,0.0
6360,An American Haunting,0,0,0,0.0,0.0,0.0
6361,Aloha Scooby-Doo!,0,0,0,0.0,0.0,0.0
6362,Neverwas,0,0,0,0.0,0.0,0.0
6363,Romance & Cigarettes,2945242,0,2945242,3288549.09634858,0.0,3288549.09634858
6364,Beowulf & Grendel,92076,0,92076,102808.68145822699,0.0,102808.68145822699
6365,Everything is Illuminated,2697930,7000000,-4302070,3012409.59605754,7815943.02758145,-4803533.43152391
6366,The Madagascar Penguins in a Christmas Caper,0,0,0,0.0,0.0,0.0
6367,Barbie and the Magic of Pegasus 3-D,0,0,0,0.0,0.0,0.0
6368,Barbie Diaries,0,0,0,0.0,0.0,0.0
6369,The Ballad of Jack and Rose,712294,1500000,-787706,795321.331841158,1674844.93448174,-879523.602640582
6370,"Yours, Mine & Ours",72028752,45000000,27028752,80424660.2828277,50245348.0344522,30179312.248375505
6371,Pooh's Heffalump Movie,0,0,0,0.0,0.0,0.0
6372,Trust the Man,0,9000000,-9000000,0.0,10049069.6068904,-10049069.6068904
6373,Wild Things: Diamonds in the Rough,0,0,0,0.0,0.0,0.0
6374,One Man Band,0,0,0,0.0,0.0,0.0
6375,The Producers,38058335,45000000,-6941665,42494539.726372704,50245348.0344522,-7750808.308079496
6376,The Mistress of Spices,0,0,0,0.0,0.0,0.0
6377,Romanzo criminale,4851244,818418,4032826,5416720.95955662,913815.4943924509,4502905.465164169
6378,The Moguls,0,0,0,0.0,0.0,0.0
6379,Hustle & Flow,22201636,8000000,14201636,24789531.7278716,8932506.31723595,15857025.41063565
6380,Transamerica,13350369,1000000,12350369,14906531.928741299,1116563.28965449,13789968.639086809
6381,Dear Wendy,0,0,0,0.0,0.0,0.0
6382,The Devil's Rejects,0,0,0,0.0,0.0,0.0
6383,The 12 Dogs of Christmas,0,2000000,-2000000,0.0,2233126.57930898,-2233126.57930898
6384,Alone in the Dark,10442808,20000000,-9557192,11660056.0537102,22331265.7930898,-10671209.7393796
6385,Boogeyman,67192859,20000000,47192859,75025079.68633051,22331265.7930898,52693813.89324071
6386,Les PoupÃ©es Russes,23727301,13000000,10727301,26493033.2591823,14515322.765508402,11977710.493673898
6387,The Aristocrats,0,0,0,0.0,0.0,0.0
6388,Tideland,0,12000000,-12000000,0.0,13398759.4758539,-13398759.4758539
6389,Havoc,0,9000000,-9000000,0.0,10049069.6068904,-10049069.6068904
6390,The Best Man,0,11000000,-11000000,0.0,12282196.1861994,-12282196.1861994
6391,Hellraiser: Deader,0,4000000,-4000000,0.0,4466253.15861797,-4466253.15861797
6392,Twitches,0,0,0,0.0,0.0,0.0
6393,House of the Dead 2,0,6000000,-6000000,0.0,6699379.73792696,-6699379.73792696
6394,Shadowboxer,0,0,0,0.0,0.0,0.0
6395,The Crow IV: Wicked Prayer,0,0,0,0.0,0.0,0.0
6396,8MM 2,0,0,0,0.0,0.0,0.0
6397,Last Days,1928985,0,1928985,2153833.83729417,0.0,2153833.83729417
6398,Hellraiser: Hellworld,0,5000000,-5000000,0.0,5582816.44827246,-5582816.44827246
6399,The Cave,15007991,30000000,-14992009,16757371.802065,33496898.689634804,-16739526.887569804
6400,Rent,31670620,40000000,-8329380,35362251.6525974,44662531.5861797,-9300279.933582306
6401,Earthlings,0,0,0,0.0,0.0,0.0
6402,Kirikou et les bÃªtes sauvages,0,0,0,0.0,0.0,0.0
6403,A Little Trip to Heaven,0,12000000,-12000000,0.0,13398759.4758539,-13398759.4758539
6404,All About Anna,0,0,0,0.0,0.0,0.0
6405,Grizzly Man,0,0,0,0.0,0.0,0.0
6406,The Squid and the Whale,11098131,1500000,9598131,12391765.6583765,1674844.93448174,10716920.72389476
6407,Scooby-Doo! in Where's My Mummy?,0,0,0,0.0,0.0,0.0
6408,SorstalansÃ¡g,0,0,0,0.0,0.0,0.0
6409,Where the Truth Lies,0,25000000,-25000000,0.0,27914082.2413623,-27914082.2413623
6410,AntikÃ¶rper,0,1900000,-1900000,0.0,2121470.25034353,-2121470.25034353
6411,The Big White,0,18000000,-18000000,0.0,20098139.2137808,-20098139.2137808
6412,Paradise Now,3357075,0,3357075,3748386.70561686,0.0,3748386.70561686
6413,The Girl in the CafÃ©,0,0,0,0.0,0.0,0.0
6414,2001 Maniacs,0,3000000,-3000000,0.0,3349689.86896348,-3349689.86896348
6415,Submerged,0,15000000,-15000000,0.0,16748449.344817402,-16748449.344817402
6416,School Of Life,0,0,0,0.0,0.0,0.0
6417,Pretty Persuasion,0,0,0,0.0,0.0,0.0
6418,ìž‘ì—…ì˜ ì •ì„,0,0,0,0.0,0.0,0.0
6419,Boo,0,0,0,0.0,0.0,0.0
6420,Inside Deep Throat,653621,2000000,-1346379,729809.213947259,2233126.57930898,-1503317.3653617213
6421,Thumbsucker,1919197,0,1919197,2142904.91581503,0.0,2142904.91581503
6422,Roll Bounce,0,0,0,0.0,0.0,0.0
6423,Man-Thing,143000,7500000,-7357000,159668.550420592,8374224.672408701,-8214556.121988109
6424,Tau man ji D,7096000,1549000,5547000,7923133.10338828,1729556.53567481,6193576.567713469
6425,C.R.A.Z.Y.,0,0,0,0.0,0.0,0.0
6426,Loverboy,0,0,0,0.0,0.0,0.0
6427,Supercross,3102550,0,3102550,3464193.43431755,0.0,3464193.43431755
6428,Underclassman,0,0,0,0.0,0.0,0.0
6429,Reeker,0,0,0,0.0,0.0,0.0
6430,The Magic Roundabout,0,20000000,-20000000,0.0,22331265.7930898,-22331265.7930898
6431,Rize,0,0,0,0.0,0.0,0.0
6432,Tamara,206871,4750000,-4543129,230984.56429411398,5303675.62585884,-5072691.061564726
6433,House of Fury,0,0,0,0.0,0.0,0.0
6434,The Marksman,0,0,0,0.0,0.0,0.0
6435,Shopgirl,11588205,10284523,1303682,12938964.2959906,11483320.833407301,1455643.4625832979
6436,Nomad,0,25000000,-25000000,0.0,27914082.2413623,-27914082.2413623
6437,North Country,25224242,35000000,-9775758,28164462.626560997,39079715.1379072,-10915252.511346202
6438,The Gravedancers,0,0,0,0.0,0.0,0.0
6439,Today You Die,0,0,0,0.0,0.0,0.0
6440,í˜•ì‚¬ Duelist,0,0,0,0.0,0.0,0.0
6441,Babam ve oÄŸlum,0,0,0,0.0,0.0,0.0
6442,Lemming,793604,0,793604,886109.092922965,0.0,886109.092922965
6443,Diary of a Mad Black Woman,0,0,0,0.0,0.0,0.0
6444,Family Guy Presents Stewie Griffin: The Untold Story,0,0,0,0.0,0.0,0.0
6445,Conversations with Other Women,973525,450000,523525,1087002.27656089,502453.48034452205,584548.796216368
6446,Down in the Valley,852872,8000000,-7147128,952285.565974207,8932506.31723595,-7980220.751261744
6447,Go Figure,0,0,0,0.0,0.0,0.0
6448,Mozart and the Whale,84967,12000000,-11915033,94871.0330320733,13398759.4758539,-13303888.442821827
6449,Bad News Bears,34252847,30000000,4252847,38245471.526352,33496898.689634804,4748572.8367171995
6450,Mouth to Mouth,0,0,0,0.0,0.0,0.0
6451,Cake,0,0,0,0.0,0.0,0.0
6452,Confessions of a Sociopathic Social Climber,0,0,0,0.0,0.0,0.0
6453,The Triangle,0,0,0,0.0,0.0,0.0
6454,Junebug,0,0,0,0.0,0.0,0.0
6455,Into the Sun,0,15000000,-15000000,0.0,16748449.344817402,-16748449.344817402
6456,Dreamer: Inspired By a True Story,0,0,0,0.0,0.0,0.0
6457,The Long Weekend,0,0,0,0.0,0.0,0.0
6458,Odd Girl Out,0,0,0,0.0,0.0,0.0
6459,Star Wreck: In the Pirkinning,0,16398,-16398,0.0,18309.4048237543,-18309.4048237543
6460,Edmond,0,10,-10,0.0,11.1656328965449,-11.1656328965449
6461,Elvis,0,0,0,0.0,0.0,0.0
6462,Alive in Joburg,0,0,0,0.0,0.0,0.0
6463,The Business,0,0,0,0.0,0.0,0.0
6464,Because of Winn-Dixie,32645546,14000000,18645546,36450818.2343271,15631886.0551629,20818932.1791642
6465,Anthony Zimmer,0,0,0,0.0,0.0,0.0
6466,Bob the Butler,0,0,0,0.0,0.0,0.0
6467,Lords of Dogtown,13411957,25000000,-11588043,14975298.8286246,27914082.2413623,-12938783.4127377
6468,Saint-Jacques... La Mecque,0,0,0,0.0,0.0,0.0
6469,The Proposition,5048693,2000000,3048693,5637185.26453561,2233126.57930898,3404058.6852266295
6470,Mrs Henderson Presents,0,0,0,0.0,0.0,0.0
6471,Venom,0,0,0,0.0,0.0,0.0
6472,La tigre e la neve,0,35000000,-35000000,0.0,39079715.1379072,-39079715.1379072
6473,Stuart Little 3: Call of the Wild,0,0,0,0.0,0.0,0.0
6474,Archangel,0,0,0,0.0,0.0,0.0
6475,The Lost City,4386236,9600000,-5213764,4897510.09736096,10719007.5806831,-5821497.483322139
6476,Carlito's Way: Rise to Power,0,9000000,-9000000,0.0,10049069.6068904,-10049069.6068904
6477,No Direction Home: Bob Dylan,0,2000000,-2000000,0.0,2233126.57930898,-2233126.57930898
6478,House Of 9,0,6000000,-6000000,0.0,6699379.73792696,-6699379.73792696
6479,Dracula III: Legacy,0,3500000,-3500000,0.0,3907971.51379072,-3907971.51379072
6480,Dark Water,25473093,30000000,-4526907,28442320.517754804,33496898.689634804,-5054578.171879999
6481,Elizabeth I,0,0,0,0.0,0.0,0.0
6482,Me and You and Everyone We Know,0,0,0,0.0,0.0,0.0
6483,Shallow Ground,0,72000,-72000,0.0,80392.55685512349,-80392.55685512349
6484,The Ice Harvest,0,0,0,0.0,0.0,0.0
6485,Fierce People,0,0,0,0.0,0.0,0.0
6486,The Call of Cthulhu,0,50000,-50000,0.0,55828.1644827247,-55828.1644827247
6487,The Secret Life of Words,0,5000000,-5000000,0.0,5582816.44827246,-5582816.44827246
6488,Lassie,0,0,0,0.0,0.0,0.0
6489,The Chumscrubber,0,0,0,0.0,0.0,0.0
6490,Dead & Breakfast,0,0,0,0.0,0.0,0.0
6491,The Notorious Bettie Page,1410778,0,1410778,1575222.92465218,0.0,1575222.92465218
6492,Millions,6584159,0,6584159,7351630.23264824,0.0,7351630.23264824
6493,Ma vie en l'air,0,0,0,0.0,0.0,0.0
6494,Colour Me Kubrick: A True...ish Story,0,0,0,0.0,0.0,0.0
6495,Dirty,0,3000000,-3000000,0.0,3349689.86896348,-3349689.86896348
6496,Death Tunnel,0,1500000,-1500000,0.0,1674844.93448174,-1674844.93448174
6497,Happy Endings,0,0,0,0.0,0.0,0.0
6498,Man with the Screaming Brain,0,0,0,0.0,0.0,0.0
6499,The Truth About Love,0,0,0,0.0,0.0,0.0
6500,Dave Chappelle's Block Party,11718595,3000000,8718595,13084552.983328698,3349689.86896348,9734863.114365218
6501,Dirty Love,0,0,0,0.0,0.0,0.0
6502,Bee Season,6856989,14000000,-7143011,7656262.19496467,15631886.0551629,-7975623.86019823
6503,Le temps qui reste,0,0,0,0.0,0.0,0.0
6504,Mortuary,0,0,0,0.0,0.0,0.0
6505,Le Couperet,0,0,0,0.0,0.0,0.0
6506,The God Who Wasn't There,0,0,0,0.0,0.0,0.0
6507,Maurice Richard,2019009,8000000,-5980991,2254351.33088203,8932506.31723595,-6678154.986353921
6508,Dungeons & Dragons: Wrath of the Dragon God,0,0,0,0.0,0.0,0.0
6509,Kim Possible Movie: So the Drama,0,0,0,0.0,0.0,0.0
6510,The Upside of Anger,0,0,0,0.0,0.0,0.0
6511,Reefer Madness: The Movie Musical,0,0,0,0.0,0.0,0.0
6512,Die weisse Massai,0,7000000,-7000000,0.0,7815943.02758145,-7815943.02758145
6513,Brice de Nice,0,0,0,0.0,0.0,0.0
6514,9,0,0,0,0.0,0.0,0.0
6515,Man of the House,0,40000000,-40000000,0.0,44662531.5861797,-44662531.5861797
6516,Water,10422387,0,10422387,11637254.714772198,0.0,11637254.714772198
6517,Why We Fight,0,0,0,0.0,0.0,0.0
6518,Espace dÃ©tente,0,0,0,0.0,0.0,0.0
6519,Isolation,0,5000000,-5000000,0.0,5582816.44827246,-5582816.44827246
6520,Slipstream,0,0,0,0.0,0.0,0.0
6521,Return of the Living Dead: Rave to the Grave,0,0,0,0.0,0.0,0.0
6522,Black Dawn,0,16000000,-16000000,0.0,17865012.6344719,-17865012.6344719
6523,Aliens of the Deep,0,0,0,0.0,0.0,0.0
6524,DeVour,0,0,0,0.0,0.0,0.0
6525,Don't Come Knocking,0,11000000,-11000000,0.0,12282196.1861994,-12282196.1861994
6526,We Feed the World - Essen Global,0,0,0,0.0,0.0,0.0
6527,Human Trafficking,0,15000000,-15000000,0.0,16748449.344817402,-16748449.344817402
6528,U2: Vertigo 2005 - Live from Chicago,0,0,0,0.0,0.0,0.0
6529,Stone Cold,0,0,0,0.0,0.0,0.0
6530,Saw Rebirth,0,0,0,0.0,0.0,0.0
6531,Boudu,0,0,0,0.0,0.0,0.0
6532,Je vous trouve trÃ¨s beau,0,0,0,0.0,0.0,0.0
6533,The Comedians of Comedy,0,0,0,0.0,0.0,0.0
6534,"The Prize Winner of Defiance, Ohio",0,0,0,0.0,0.0,0.0
6535,The Poseidon Adventure,0,0,0,0.0,0.0,0.0
6536,Ellie Parker,0,0,0,0.0,0.0,0.0
6537,Feed,0,0,0,0.0,0.0,0.0
6538,Return of the Living Dead: Necropolis,0,0,0,0.0,0.0,0.0
6539,Tsotsi,9879971,3000000,6879971,11031612.921450999,3349689.86896348,7681923.052487519
6540,Wal-Mart: The High Cost of Low Price,0,0,0,0.0,0.0,0.0
6541,Alien Apocalypse,0,0,0,0.0,0.0,0.0
6542,Un amour Ã  taire,0,0,0,0.0,0.0,0.0
6543,La Moustache,0,0,0,0.0,0.0,0.0
6544,Left Behind III: World at War,0,0,0,0.0,0.0,0.0
6545,Duma,0,12000000,-12000000,0.0,13398759.4758539,-13398759.4758539
6546,George Carlin: Life Is Worth Losing,0,0,0,0.0,0.0,0.0
6547,Metal: A Headbanger's Journey,0,0,0,0.0,0.0,0.0
6548,Bubble,0,1600000,-1600000,0.0,1786501.26344719,-1786501.26344719
6549,The Devil and Daniel Johnston,0,0,0,0.0,0.0,0.0
6550,Wassup Rockers,634074,0,634074,707983.751324383,0.0,707983.751324383
6551,Mon petit doigt m'a dit...,0,0,0,0.0,0.0,0.0
6552,Quatre Ã©toiles,0,0,0,0.0,0.0,0.0
6553,Paheli,0,0,0,0.0,0.0,0.0
6554,Underworld: Evolution,111340801,50000000,61340801,120433910.50117901,54083457.9145786,66350452.58660041
6555,Pirates of the Caribbean: Dead Man's Chest,1065659812,200000000,865659812,1152691351.87119,216333831.658314,936357520.2128761
6556,Cars,461983149,120000000,341983149,499712923.92372,129800298.994988,369912624.92873204
6557,Casino Royale,599045960,150000000,449045960,647969539.331167,162250373.74373502,485719165.58743197
6558,The Da Vinci Code,758239851,125000000,633239851,820164661.414297,135208644.786446,684956016.627851
6559,Step Up,114194847,12000000,102194847,123521044.035724,12980029.8994988,110541014.1362252
6560,Ice Age: The Meltdown,660940780,80000000,580940780,714919257.183175,86533532.66332579,628385724.5198492
6561,Mission: Impossible III,397850012,150000000,247850012,430342087.606332,162250373.74373502,268091713.862597
6562,The Devil Wears Prada,326551094,35000000,291551094,353220246.986172,37858420.540205,315361826.445967
6563,The Departed,289847354,90000000,199847354,313518943.434219,97350224.24624151,216168719.1879775
6564,The Holiday,194168700,85000000,109168700,210026294.295568,91941878.45478371,118084415.84078428
6565,The Prestige,109676311,40000000,69676311,118633483.003894,43266766.33166289,75366716.67223111
6566,Night at the Museum,574480841,110000000,464480841,621398207.739104,118983607.412073,502414600.327031
6567,Babel,135330182,25000000,110330182,146382484.05538502,27041728.9572893,119340755.09809572
6568,Children of Men,69959751,76000000,-6040249,75673304.978458,82206856.0301595,-6533551.051701501
6569,American Pie Presents: The Naked Mile,0,0,0,0.0,0.0,0.0
6570,Superman Returns,391081192,270000000,121081192,423020463.774305,292050672.73872405,130969791.03558093
6571,Borat: Cultural Learnings of America for Make Benefit Glorious Nation of Kazakhstan,261572744,18000000,243572744,282935169.83449703,19470044.8492483,263465124.98524874
6572,Click,237681299,82500000,155181299,257092530.630977,89237705.5590547,167854825.0719223
6573,Brother Bear 2,0,0,0,0.0,0.0,0.0
6574,The Break-Up,204999686,52000000,152999686,221741837.80565602,56246796.231161706,165495041.5744943
6575,Inside Man,184376254,45000000,139376254,199434107.473133,48675112.1231207,150758995.3500123
6576,Over the Hedge,155019340,80000000,75019340,167679639.016715,86533532.66332579,81146106.3533892
6577,Perfume: The Story of a Murderer,132180323,50000000,82180323,142975378.722118,54083457.9145786,88891920.80753939
6578,Blood Diamond,170877916,100000000,70877916,184833371.57033798,108166915.829157,76666455.74118099
6579,Alpha Dog,15309302,0,15309302,16559599.808371399,0.0,16559599.808371399
6580,Crank,42931041,12000000,30931041,46437182.983051,12980029.8994988,33457153.083552204
6581,Lucky Number Slevin,56308881,27000000,29308881,60907579.915610306,29205067.2738724,31702512.641737904
6582,Eight Below,120455994,40000000,80455994,130293533.641154,43266766.33166289,87026767.30949111
6583,Final Destination 3,117719158,25000000,92719158,127333182.54865201,27041728.9572893,100291453.59136271
6584,Silent Hill,97607453,50000000,47607453,105578971.52949399,54083457.9145786,51495513.614915386
6585,She's the Man,33889159,20000000,13889159,36656858.090739205,21633383.1658314,15023474.924907807
6586,The Fountain,15304890,35000000,-19695110,16554827.4840451,37858420.540205,-21303593.056159902
6587,Happy Feet,384335608,100000000,284335608,415723973.606839,108166915.829157,307557057.777682
6588,Rocky Balboa,155721132,24000000,131721132,168438745.77865,25960059.7989977,142478685.9796523
6589,Van Wilder 2: The Rise of Taj,6086508,0,6086508,6583587.98529492,0.0,6583587.98529492
6590,Flushed Away,64459316,149000000,-84540684,69723654.0817705,161168704.585444,-91445050.50367351
6591,The Wild,37384046,80000000,-42615954,40437169.570353396,86533532.66332579,-46096363.09297239
6592,DÃ©jÃ  Vu,180557550,75000000,105557550,195303533.131688,81125186.87186791,114178346.25982009
6593,Eragon,249288105,100000000,149288105,269647254.707451,108166915.829157,161480338.878294
6594,The Lake House,114830111,40000000,74830111,124208189.511897,43266766.33166289,80941423.1802341
6595,Scary Movie 4,178262620,45000000,133262620,192821178.13025,48675112.1231207,144146066.0071293
6596,Monster House,140175006,75000000,65175006,151622980.75353602,81125186.87186791,70497793.8816681
6597,High School Musical,0,4200000,-4200000,0.0,4543010.464824599,-4543010.464824599
6598,Failure to Launch,88715192,50000000,38715192,95960487.0583152,54083457.9145786,41877029.1437366
6599,Apocalypto,120175290,40000000,80175290,129989904.781745,43266766.33166289,86723138.45008211
6600,The Ant Bully,55181129,50000000,5181129,59687725.35900871,54083457.9145786,5604267.444430105
6601,The Hills Have Eyes,69623713,15000000,54623713,75309823.03784399,16225037.3743735,59084785.66347049
6602,Garfield 2,141702264,0,141702264,153274968.62888998,0.0,153274968.62888998
6603,Just My Luck,38159905,28000000,10159905,41276392.3218363,30286736.432164002,10989655.889672298
6604,The Good Shepherd,59908565,85000000,-25091435,64801247.078005895,91941878.45478371,-27140631.376777813
6605,Ultraviolet,31070211,30000000,1070211,33607688.9803115,32450074.7487471,1157614.2315643989
6606,Penelope,0,15000000,-15000000,0.0,16225037.3743735,-16225037.3743735
6607,Miami Vice,163794509,135000000,28794509,177171468.68281102,146025336.36936203,31146132.313448995
6608,John Tucker Must Die,41009669,18000000,23009669,44358894.149046004,19470044.8492483,24888849.299797703
6609,Tristan & Isolde,28000000,31000000,-3000000,30286736.432164002,33531743.907038696,-3245007.474874694
6610,Flags of Our Fathers,65900249,90000000,-24099751,71282266.867035,97350224.24624151,-26067957.37920651
6611,Shortbus,5179037,2000000,3179037,5602004.59255091,2163338.31658314,3438666.2759677703
6612,Bordertown,0,21000000,-21000000,0.0,22715052.324123003,-22715052.324123003
6613,Curious George,69834815,50000000,19834815,75538165.5604977,54083457.9145786,21454707.6459191
6614,The Wicker Man,38755073,40000000,-1244927,41920167.1914384,43266766.33166289,-1346599.140224494
6615,Smokin' Aces,57103895,17000000,40103895,61767522.0398203,18388375.690956697,43379146.3488636
6616,Amazing Grace,0,0,0,0.0,0.0,0.0
6617,RV,87528173,50000000,37528173,94676525.21570909,54083457.9145786,40593067.30113049
6618,Glory Road,42647449,0,42647449,46130430.2631127,0.0,46130430.2631127
6619,We Are Marshall,43545364,65000000,-21454636,47101677.2253801,70308495.2889522,-23206818.0635721
6620,The Illusionist,86915017,40000000,46915017,94013293.28128771,43266766.33166289,50746526.94962482
6621,The Pink Panther,0,0,0,0.0,0.0,0.0
6622,Beerfest,19179969,17500000,1679969,20746380.924288396,18929210.2701025,1817170.6541858949
6623,The Contract,5549200,25000000,-19450800,6002398.49319159,27041728.9572893,-21039330.464097712
6624,All the King's Men,9450897,55000000,-45549103,10222743.803090302,59491803.7060365,-49269059.9029462
6625,Slither,0,15500000,-15500000,0.0,16765871.9535193,-16765871.9535193
6626,Big Momma's House 2,138259062,40000000,98259062,149550563.219722,43266766.33166289,106283796.88805911
6627,Basic Instinct 2,38629478,70000000,-31370522,41784314.9535028,75716841.0804101,-33932526.1269073
6628,Clerks II,26888376,5000000,21888376,29084327.0357473,5408345.79145786,23675981.244289443
6629,Talladega Nights: The Ballad of Ricky Bobby,162966177,72500000,90466177,176275487.505585,78421013.976139,97854473.52944602
6630,Undisputed II: Last Man Standing,0,0,0,0.0,0.0,0.0
6631,The Pursuit of Happyness,307077295,55000000,252077295,332156039.213103,59491803.7060365,272664235.5070665
6632,Marie Antoinette,60474340,40000000,20474340,65413228.44603829,43266766.33166289,22146462.114375398
6633,Freedomland,14655628,37665000,-23009372,15852540.8029944,40741068.847052,-24888528.0440576
6634,Lung fu moon,0,0,0,0.0,0.0,0.0
6635,Deck the Halls,47231070,0,47231070,51088391.7321103,0.0,51088391.7321103
6636,The Fall,3669465,0,3669465,3969147.11793038,0.0,3969147.11793038
6637,The Last King of Scotland,48027970,6000000,42027970,51950373.8843529,6490014.94974943,45460358.93460347
6638,Saw III,163876815,10000000,153876815,177260496.544553,10816691.5829157,166443804.96163732
6639,Idiocracy,495303,30000000,-29504697,535753.97910929,32450074.7487471,-31914320.76963781
6640,Nacho Libre,80197993,32000000,48197993,86747695.58498341,34613413.0653303,52134282.51965311
6641,The Black Dahlia,49111202,50000000,-888798,53122072.5300274,54083457.9145786,-961385.3845512047
6642,Air Buddies,0,9000000,-9000000,0.0,9735022.42462415,-9735022.42462415
6643,Poseidon,181674817,160000000,21674817,196512046.38716498,173067065.326651,23444981.060513973
6644,American Dreamz,7314027,17000000,-9685973,7911357.42881183,18388375.690956697,-10477018.262144867
6645,The Butterfly Effect 2,0,0,0,0.0,0.0,0.0
6646,Ultimate Avengers 2,7900000,0,7900000,8545186.35050342,0.0,8545186.35050342
6647,Fur: An Imaginary Portrait of Diane Arbus,2281089,16800000,-14518911,2467383.61861816,18172041.859298397,-15704658.240680236
6648,"You, Me and Dupree",130431368,54000000,76431368,141083588.03937802,58410134.5477449,82673453.49163312
6649,Little Miss Sunshine,100523181,8000000,92523181,108732824.581061,8653353.26633258,100079471.31472842
6650,Little Man,101595121,64000000,37595121,109892309.0186,69226826.1306606,40665482.88793941
6651,The Fox and the Hound 2,0,24000000,-24000000,0.0,25960059.7989977,-25960059.7989977
6652,Leroy & Stitch,0,0,0,0.0,0.0,0.0
6653,The Nativity Story,0,35000000,-35000000,0.0,37858420.540205,-37858420.540205
6654,Employee of the Month,38368909,12000000,26368909,41502465.5025959,12980029.8994988,28522435.603097104
6655,The Omen,119188334,25000000,94188334,128922344.91595401,27041728.9572893,101880615.95866472
6656,Letters from Iwo Jima,68673228,19000000,49673228,74281712.72792521,20551714.0075398,53729998.72038541
6657,Shark Bait,0,0,0,0.0,0.0,0.0
6658,A Scanner Darkly,5480996,8500000,-3019004,5928624.32991947,9194187.84547836,-3265563.51555889
6659,Save the Last Dance 2,0,0,0,0.0,0.0,0.0
6660,Stranger Than Fiction,53653224,30000000,23653224,58035037.643709205,32450074.7487471,25584962.894962106
6661,World Trade Center,162945894,63000000,99945894,176253548.010047,68145156.972369,108108391.03767799
6662,The Santa Clause 3: The Escape Clause,84500122,0,84500122,91401175.83927521,0.0,91401175.83927521
6663,A Good Year,42064105,35000000,7064105,45499445.0496383,37858420.540205,7641024.509433299
6664,Open Water 2: Adrift,0,1200000,-1200000,0.0,1298002.98994988,-1298002.98994988
6665,The Painted Veil,0,19400000,-19400000,0.0,20984381.670856502,-20984381.670856502
6666,Snow Cake,1381665,12000000,-10618335,1494504.41759092,12980029.8994988,-11485525.48190788
6667,Itâ€™s a Boy Girl Thing,7385434,15500000,-8114566,7988596.17839796,16765871.9535193,-8777275.775121339
6668,Date Movie,48548426,20000000,28548426,52513335.087800704,21633383.1658314,30879951.921969306
6669,Accepted,38505009,23000000,15505009,41649680.675039396,24878390.6407061,16771290.034333296
6670,Grandma's Boy,6538177,0,6538177,7072144.41235132,0.0,7072144.41235132
6671,Open Season,197309027,85000000,112309027,213423089.15841898,91941878.45478371,121481210.70363528
6672,Bo bui gai wak,0,0,0,0.0,0.0,0.0
6673,Barnyard,72779000,51000000,21779000,78722799.67130229,55165127.0728702,23557672.598432086
6674,Unknown,3338228,3700000,-361772,3610858.27094536,4002175.88567881,-391317.6147334501
6675,Bobby,0,0,0,0.0,0.0,0.0
6676,Dreamgirls,154937680,70000000,84937680,167591309.913249,75716841.0804101,91874468.8328389
6677,Snakes on a Plane,62022014,33000000,29022014,67087299.6789281,35695082.2236219,31392217.455306202
6678,Candy,2077763,0,2077763,2247452.15533937,0.0,2247452.15533937
6679,Friends with Money,13368437,6500000,6868437,14460225.9974639,7030849.52889522,7429376.468568681
6680,Jackass Number Two,72778712,11000000,61778712,78722488.1505847,11898360.741207302,66824127.409377396
6681,The Guardian,55011732,70000000,-14988268,59504493.848601505,75716841.0804101,-16212347.231808588
6682,The Breed,1675484,0,1675484,1812319.36801099,0.0,1812319.36801099
6683,Southland Tales,374743,17000000,-16625257,405347.94538565795,18388375.690956697,-17983027.74557104
6684,The Fast and the Furious: Tokyo Drift,158468292,85000000,73468292,171410264.023543,91941878.45478371,79468385.56875929
6685,Invincible,57806952,0,57806952,62527997.1132413,0.0,62527997.1132413
6686,Miss Potter,35078241,30000000,5078241,37943051.416818894,32450074.7487471,5492976.668071795
6687,Pulse,29907685,38000000,-8092315,32350220.460399397,41103428.01507971,-8753207.55468031
6688,Bambi II,0,0,0,0.0,0.0,0.0
6689,Black Snake Moan,10903846,15000000,-4096154,11794353.9249609,16225037.3743735,-4430683.449412599
6690,Goya's Ghosts,9448082,50000000,-40551918,10219698.9044097,54083457.9145786,-43863759.0101689
6691,Deep Sea 3D,0,0,0,0.0,0.0,0.0
6692,Stick It,0,0,0,0.0,0.0,0.0
6693,Mercenary for Justice,0,15000000,-15000000,0.0,16225037.3743735,-16225037.3743735
6694,The Hoax,11772461,25000000,-13227539,12733907.980890302,27041728.9572893,-14307820.976398999
6695,The Marine,22165608,20000000,2165608,23975854.5483809,21633383.1658314,2342471.382549502
6696,Hollow Man II,0,0,0,0.0,0.0,0.0
6697,Hatchet,0,0,0,0.0,0.0,0.0
6698,Running with Scissors,6754898,12000000,-5245102,7306564.83400542,12980029.8994988,-5673465.06549338
6699,The Shaggy Dog,61112916,50000000,11112916,66103956.410463504,54083457.9145786,12020498.495884903
6700,Stormbreaker,23937870,40000000,-16062130,25892855.694192998,43266766.33166289,-17373910.637469895
6701,Madea's Family Reunion,57231524,6000000,51231524,61905574.392823905,6490014.94974943,55415559.44307447
6702,Home of the Brave,0,12000000,-12000000,0.0,12980029.8994988,-12980029.8994988
6703,Half Light,0,0,0,0.0,0.0,0.0
6704,Little Children,0,26000000,-26000000,0.0,28123398.115580797,-28123398.115580797
6705,The Benchwarmers,0,0,0,0.0,0.0,0.0
6706,Catch a Fire,4291965,0,4291965,4642486.16896689,0.0,4642486.16896689
6707,Charlotte's Web,144,85000000,-84999856,155.760358793986,91941878.45478371,-91941722.69442491
6708,Take the Lead,34742066,30000000,4742066,37579421.2875302,32450074.7487471,5129346.5387830995
6709,Zoom,12506188,35000000,-22493812,13527557.8473961,37858420.540205,-24330862.692808904
6710,Dr. Dolittle 3,0,0,0,0.0,0.0,0.0
6711,Barbie Fairytopia: Mermaidia,0,0,0,0.0,0.0,0.0
6712,Mater and the Ghostlight,0,0,0,0.0,0.0,0.0
6713,I'll Always Know What You Did Last Summer,0,0,0,0.0,0.0,0.0
6714,Aquamarine,23006849,12000000,11006849,24885798.9927713,12980029.8994988,11905769.093272502
6715,The Librarian: Return to King Solomon's Mines,0,0,0,0.0,0.0,0.0
6716,Shadow Man,0,0,0,0.0,0.0,0.0
6717,Rescue Dawn,7177143,10000000,-2822857,7763294.22774825,10816691.5829157,-3053397.3551674495
6718,The Wind That Shakes the Barley,22889018,6500000,16389018,24758344.834180605,7030849.52889522,17727495.305285387
6719,Big Nothing,0,0,0,0.0,0.0,0.0
6720,16 Blocks,65664721,55000000,10664721,71027503.49352092,59491803.7060365,11535699.787484415
6721,Scoop,31584901,4000000,27584901,34164413.2793926,4326676.63316629,29837736.64622631
6722,Calibre 45,0,5000000,-5000000,0.0,5408345.79145786,-5408345.79145786
6723,Last Holiday,38399961,45000000,-6600039,41536053.4932992,48675112.1231207,-7139058.629821502
6724,The Last Kiss,0,20000000,-20000000,0.0,21633383.1658314,-21633383.1658314
6725,Notes on a Scandal,49469904,15000000,34469904,53510069.4204449,16225037.3743735,37285032.046071395
6726,United 93,76286096,15000000,61286096,82516317.24967009,16225037.3743735,66291279.87529659
6727,Kidulthood,165000,994000,-829000,178475.41111810898,1075179.14334182,-896703.732223711
6728,DOA: Dead or Alive,480314,21000000,-20519686,519540.840095658,22715052.324123003,-22195511.484027345
6729,Something New,11400000,0,11400000,12331028.4045239,0.0,12331028.4045239
6730,The Queen,123384128,15000000,108384128,133460805.880299,16225037.3743735,117235768.5059255
6731,The Thief Lord,0,0,0,0.0,0.0,0.0
6732,The Sentinel,77920346,60000000,17920346,84284035.0716081,64900149.4974943,19383885.574113794
6733,Man About Town,0,0,0,0.0,0.0,0.0
6734,The Good German,5914908,32000000,-26085092,6397973.55773209,34613413.0653303,-28215439.507598206
6735,Flyboys,17800000,60000000,-42200000,19253711.017589897,64900149.4974943,-45646438.479904406
6736,Lifted,0,0,0,0.0,0.0,0.0
6737,My Super Ex-Girlfriend,60896147,0,60896147,65869484.06868979,0.0,65869484.06868979
6738,Running Scared,9500000,15000000,-5500000,10275857.0037699,16225037.3743735,-5949180.370603599
6739,No Time for Nuts,0,0,0,0.0,0.0,0.0
6740,Breaking and Entering,8974829,0,8974829,9707795.73024079,0.0,9707795.73024079
6741,Wendy Wu: Homecoming Warrior,0,6000000,-6000000,0.0,6490014.94974943,-6490014.94974943
6742,Lonely Hearts,0,0,0,0.0,0.0,0.0
6743,Fauteuils d'orchestre,0,0,0,0.0,0.0,0.0
6744,Shooting Dogs,0,0,0,0.0,0.0,0.0
6745,Catch and Release,16158487,25000000,-8841513,17478137.0325553,27041728.9572893,-9563591.924734
6746,The Grudge 2,39143839,20000000,19143839,42340683.3834308,21633383.1658314,20707300.217599403
6747,The Texas Chainsaw Massacre: The Beginning,0,16000000,-16000000,0.0,17306706.5326651,-17306706.5326651
6748,Like Minds,0,0,0,0.0,0.0,0.0
6749,Altered,0,8000000,-8000000,0.0,8653353.26633258,-8653353.26633258
6750,Severance,0,0,0,0.0,0.0,0.0
6751,Second In Command,0,0,0,0.0,0.0,0.0
6752,Cashback,2294291,0,2294291,2481663.81484593,0.0,2481663.81484593
6753,10th & Wolf,143451,8000000,-7856549,155166.522426084,8653353.26633258,-8498186.743906496
6754,Copying Beethoven,0,11000000,-11000000,0.0,11898360.741207302,-11898360.741207302
6755,Firewall,82800000,45000000,37800000,89562206.3065422,48675112.1231207,40887094.1834215
6756,Seraphim Falls,1196307,18000000,-16803693,1294008.38574831,19470044.8492483,-18176036.463499993
6757,10 Items or Less,580527,0,580527,627938.1514555321,0.0,627938.1514555321
6758,The Ultimate Gift,0,0,0,0.0,0.0,0.0
6759,Eating Out 2: Sloppy Seconds,0,0,0,0.0,0.0,0.0
6760,The Little Matchgirl,0,0,0,0.0,0.0,0.0
6761,Everyone's Hero,16627188,0,16627188,17985116.448715698,0.0,17985116.448715698
6762,Sherrybaby,622806,2000000,-1377194,673670.041798941,2163338.31658314,-1489668.274784199
6763,Alatriste,23321954,24000000,-678046,25226638.352894697,25960059.7989977,-733421.4461030029
6764,Tenacious D in The Pick of Destiny,13405595,22000000,-8594405,14500418.660047699,23796721.482414603,-9296302.822366904
6765,Hollywoodland,16803753,0,16803753,18176101.363649398,0.0,18176101.363649398
6766,Ultimate Avengers,6700000,0,6700000,7247183.36055353,0.0,7247183.36055353
6767,The Night Listener,0,0,0,0.0,0.0,0.0
6768,Man of the Year,41237648,20000000,21237648,44605492.0020841,21633383.1658314,22972108.8362527
6769,Nos jours heureux,0,0,0,0.0,0.0,0.0
6770,The Covenant,37597471,20000000,17597471,40668024.8104618,21633383.1658314,19034641.6446304
6771,Hellboy Animated: Sword of Storms,0,0,0,0.0,0.0,0.0
6772,Behind Enemy Lines II: Axis of Evil,0,0,0,0.0,0.0,0.0
6773,Jeff Dunham: Arguing with Myself,0,0,0,0.0,0.0,0.0
6774,Find Me Guilty,0,0,0,0.0,0.0,0.0
6775,Rest Stop,0,0,0,0.0,0.0,0.0
6776,NapolÃ©on (et moi),0,0,0,0.0,0.0,0.0
6777,La tourneuse de pages,0,0,0,0.0,0.0,0.0
6778,Happily N'Ever After,0,0,0,0.0,0.0,0.0
6779,The Oh in Ohio,0,5000000,-5000000,0.0,5408345.79145786,-5408345.79145786
6780,Elephants Dream,0,150000,-150000,0.0,162250.373743735,-162250.373743735
6781,When a Stranger Calls,66966987,15000000,51966987,72436124.4616127,16225037.3743735,56211087.087239206
6782,Infamous,1151330,13000000,-11848670,1245358.15201583,14061699.057790399,-12816340.90577457
6783,Another Gay Movie,745327,500000,245327,806197.228741983,540834.579145786,265362.64959619695
6784,Skinwalkers,0,0,0,0.0,0.0,0.0
6785,Love and Other Disasters,0,0,0,0.0,0.0,0.0
6786,Dhoom 2,46396427,11000000,35396427,50185584.1408264,11898360.741207302,38287223.399619095
6787,Black Christmas,21510851,9000000,12510851,23267624.095305398,9735022.42462415,13532601.670681247
6788,The Astronaut Farmer,11130889,13000000,-1869111,12039939.3356669,14061699.057790399,-2021759.722123498
6789,La Sconosciuta,0,8000000,-8000000,0.0,8653353.26633258,-8653353.26633258
6790,Fast Food Nation,0,0,0,0.0,0.0,0.0
6791,Slipp Jimmy Fri,0,0,0,0.0,0.0,0.0
6792,Sweeney Todd,0,0,0,0.0,0.0,0.0
6793,Fido,426224,8000000,-7573776,461033.35532366706,8653353.26633258,-8192319.911008913
6794,The Abandoned,0,0,0,0.0,0.0,0.0
6795,ATL,21170563,20000000,1170563,22899545.060768697,21633383.1658314,1266161.8949372992
6796,Half Nelson,0,700000,-700000,0.0,757168.4108041009,-757168.4108041009
6797,Bug,8059140,4000000,4059140,8717323.18035394,4326676.63316629,4390646.54718765
6798,Hard Luck,0,0,0,0.0,0.0,0.0
6799,Lady in the Water,42285169,75000000,-32714831,45738563.1604469,81125186.87186791,-35386623.71142101
6800,Unaccompanied Minors,0,26000000,-26000000,0.0,28123398.115580797,-28123398.115580797
6801,Peaceful Warrior,0,0,0,0.0,0.0,0.0
6802,Behind the Mask: The Rise of Leslie Vernon,69136,0,69136,74782.2789276461,0.0,74782.2789276461
6803,Loving Annabelle,0,900000,-900000,0.0,973502.242462415,-973502.242462415
6804,The Detonator,0,15000000,-15000000,0.0,16225037.3743735,-16225037.3743735
6805,Material Girls,11449638,0,11449638,12384720.2982032,0.0,12384720.2982032
6806,London to Brighton,0,0,0,0.0,0.0,0.0
6807,Gridiron Gang,41480851,30000000,11480851,44868557.186388105,32450074.7487471,12418482.437641006
6808,Art School Confidential,0,0,0,0.0,0.0,0.0
6809,Black Sheep,4946225,0,4946225,5350179.03247073,0.0,5350179.03247073
6810,Unrest,0,0,0,0.0,0.0,0.0
6811,2:37,0,850000,-850000,0.0,919418.7845478359,-919418.7845478359
6812,Wristcutters: A Love Story,0,0,0,0.0,0.0,0.0
6813,Irresistible,0,0,0,0.0,0.0,0.0
6814,Driving Lessons,0,0,0,0.0,0.0,0.0
6815,é»‘ç¤¾ä¼š2ï¼šä»¥å’Œä¸ºè´µ,0,0,0,0.0,0.0,0.0
6816,Gone,0,0,0,0.0,0.0,0.0
6817,Ask the Dust,0,0,0,0.0,0.0,0.0
6818,Krrish,0,0,0,0.0,0.0,0.0
6819,Poultrygeist: Night of the Chicken Dead,0,0,0,0.0,0.0,0.0
6820,Minotaur,0,7000000,-7000000,0.0,7571684.10804101,-7571684.10804101
6821,Facing the Giants,10178331,100000,10078331,11009586.725583,108166.91582915699,10901419.809753843
6822,La Doublure,29326868,0,29326868,31721968.624888,0.0,31721968.624888
6823,The Ex,3091922,0,3091922,3344436.66724319,0.0,3344436.66724319
6824,Cow Belles,0,0,0,0.0,0.0,0.0
6825,Bernard and Doris,0,0,0,0.0,0.0,0.0
6826,See No Evil,0,8000000,-8000000,0.0,8653353.26633258,-8653353.26633258
6827,Hogfather,0,9364800,-9364800,0.0,10129615.3335689,-10129615.3335689
6828,Slaughtered Vomit Dolls,0,100000,-100000,0.0,108166.91582915699,-108166.91582915699
6829,The Lost Room,0,0,0,0.0,0.0,0.0
6830,Away from Her,0,0,0,0.0,0.0,0.0
6831,Red Road,1128345,0,1128345,1220495.9864125,0.0,1220495.9864125
6832,The History Boys,13401952,4000000,9401952,14496478.139304,4326676.63316629,10169801.50613771
6833,PokÃ©mon Ranger and the Temple of the Sea,0,0,0,0.0,0.0,0.0
6834,Starter for 10,210128,0,210128,227288.97689349102,0.0,227288.97689349102
6835,The Secret,0,0,0,0.0,0.0,0.0
6836,The Namesake,20138836,12000000,8138836,21783557.785092,12980029.8994988,8803527.8855932
6837,The Land Before Time XII: The Great Day of the Flyers,0,0,0,0.0,0.0,0.0
6838,An Inconvenient Truth,46243000,1000000,45243000,50019626.8868772,1081669.15829157,48937957.72858563
6839,Let's Go to Prison,4630045,4000000,630045,5008176.8780021,4326676.63316629,681500.2448358098
6840,Flight 93,0,0,0,0.0,0.0,0.0
6841,Inland Empire,849055,0,849055,918396.6071932509,0.0,918396.6071932509
6842,Wilderness,0,0,0,0.0,0.0,0.0
6843,Alien Autopsy,0,0,0,0.0,0.0,0.0
6844,Like Mike 2: Streetball,0,5000000,-5000000,0.0,5408345.79145786,-5408345.79145786
6845,Relative Strangers,0,0,0,0.0,0.0,0.0
6846,Tekkon kinkurÃ®to,0,0,0,0.0,0.0,0.0
6847,Cocaine Cowboys,163000,0,163000,176312.07280152602,0.0,176312.07280152602
6848,Return to Halloweentown,0,0,0,0.0,0.0,0.0
6849,Barbie in the 12 Dancing Princesses,0,0,0,0.0,0.0,0.0
6850,The Net 2.0,0,0,0,0.0,0.0,0.0
6851,This Is England,8176544,2380000,5796544,8844315.46621401,2574372.59673394,6269942.869480071
6852,Simon Says,0,0,0,0.0,0.0,0.0
6853,The Alibi,0,0,0,0.0,0.0,0.0
6854,The Cutting Edge: Going for the Gold,0,3000000,-3000000,0.0,3245007.47487471,-3245007.47487471
6855,Outsourced,0,0,0,0.0,0.0,0.0
6856,The Hamiltons,0,0,0,0.0,0.0,0.0
6857,School for Scoundrels,17807569,20000000,-2192431,19261898.171449102,21633383.1658314,-2371484.9943822958
6858,A Guide To Recognizing Your Saints,516139,0,516139,558291.637691454,0.0,558291.637691454
6859,Annapolis,17496992,26000000,-8503008,18925956.6092743,28123398.115580797,-9197441.506306496
6860,Attack Force,0,0,0,0.0,0.0,0.0
6861,IndigÃ¨nes,22963701,14500000,8463701,24839127.1319293,15684202.795227801,9154924.3367015
6862,Blind Dating,834457,0,834457,902606.4008205109,0.0,902606.4008205109
6863,Daft Punk's Electroma,0,0,0,0.0,0.0,0.0
6864,Jesse Stone: Night Passage,0,0,0,0.0,0.0,0.0
6865,EnfermÃ©s dehors,0,0,0,0.0,0.0,0.0
6866,Deliver Us from Evil,201275,0,201275,217712.95983513602,0.0,217712.95983513602
6867,The Woods,0,0,0,0.0,0.0,0.0
6868,Flicka,21000000,15000000,6000000,22715052.324123003,16225037.3743735,6490014.949749503
6869,The Dark,0,0,0,0.0,0.0,0.0
6870,Peter & the Wolf,0,2300000,-2300000,0.0,2487839.06407061,-2487839.06407061
6871,Stay Alive,27105095,9000000,18105095,29318745.294063102,9735022.42462415,19583722.869438954
6872,Les Brigades du Tigre,0,0,0,0.0,0.0,0.0
6873,The Return,11992014,15000000,-3007986,12971391.689600699,16225037.3743735,-3253645.6847728007
6874,Wicked Little Things,0,0,0,0.0,0.0,0.0
6875,Ten Canoes,300000,2000000,-1700000,324500.74748747103,2163338.31658314,-1838837.5690956688
6876,A Prairie Home Companion,0,0,0,0.0,0.0,0.0
6877,PrÃªte-moi ta main,0,0,0,0.0,0.0,0.0
6878,Poltergay,0,0,0,0.0,0.0,0.0
6879,The Darwin Awards,0,0,0,0.0,0.0,0.0
6880,Going to Pieces: The Rise and Fall of the Slasher Film,0,0,0,0.0,0.0,0.0
6881,The Road to Guantanamo,0,0,0,0.0,0.0,0.0
6882,Glass House: The Good Mother,0,0,0,0.0,0.0,0.0
6883,X-Men: The Last Stand,234360014,210000000,24360014,253499999.080581,227150523.24122998,26349475.83935103
6884,The Hard Corps,0,0,0,0.0,0.0,0.0
6885,Madame Irma,0,0,0,0.0,0.0,0.0
6886,The Dead Girl,0,0,0,0.0,0.0,0.0
6887,Right at Your Door,2043704,0,2043704,2210611.58547712,0.0,2210611.58547712
6888,The Prince & Me 2: The Royal Wedding,0,0,0,0.0,0.0,0.0
6889,Delirious,0,0,0,0.0,0.0,0.0
6890,Who Killed the Electric Car?,1678874,1000000,678874,1815986.2264576,1081669.15829157,734317.0681660301
6891,End Game,0,5000000,-5000000,0.0,5408345.79145786,-5408345.79145786
6892,Obsluhoval jsem anglickÃ©ho krÃ¡le,0,0,0,0.0,0.0,0.0
6893,Peiru Kokun,0,0,0,0.0,0.0,0.0
6894,Planet Earth,0,0,0,0.0,0.0,0.0
6895,The Tripper,0,0,0,0.0,0.0,0.0
6896,Akeelah and the Bee,18948425,8000000,10948425,20495926.920700897,8653353.26633258,11842573.654368317
6897,Turistas,0,10000000,-10000000,0.0,10816691.5829157,-10816691.5829157
6898,Mulberry Street,0,0,0,0.0,0.0,0.0
6899,Griffin & Phoenix,0,0,0,0.0,0.0,0.0
6900,The Black Hole,0,3500000,-3500000,0.0,3785842.0540205003,-3785842.0540205003
6901,Evil Aliens,0,500000,-500000,0.0,540834.579145786,-540834.579145786
6902,Factory Girl,0,7000000,-7000000,0.0,7571684.10804101,-7571684.10804101
6903,"Zidane, un portrait du 21e siÃ¨cle",0,0,0,0.0,0.0,0.0
6904,Gray Matters,0,0,0,0.0,0.0,0.0
6905,Superman: Brainiac Attacks,0,0,0,0.0,0.0,0.0
6906,Mini's First Time,0,0,0,0.0,0.0,0.0
6907,Teen Titans: Trouble in Tokyo,0,0,0,0.0,0.0,0.0
6908,Wedding Daze,0,0,0,0.0,0.0,0.0
6909,The Last Winter,0,0,0,0.0,0.0,0.0
6910,This Film Is Not Yet Rated,302179,0,302179,326857.704583389,0.0,326857.704583389
6911,Pink Floyd: Pulse,0,0,0,0.0,0.0,0.0
6912,Drake And Josh Go Hollywood,0,0,0,0.0,0.0,0.0
6913,Waist Deep,21353303,0,21353303,23097209.282754898,0.0,23097209.282754898
6914,Trailer Park Boys: The Movie,3833507,5000000,-1166493,4146586.28999485,5408345.79145786,-1261759.50146301
6915,Pledge This!,0,8300000,-8300000,0.0,8977854.01382005,-8977854.01382005
6916,10.5: Apocalypse,0,0,0,0.0,0.0,0.0
6917,Jesus Camp,0,0,0,0.0,0.0,0.0
6918,Hoot,0,0,0,0.0,0.0,0.0
6919,The Cheetah Girls 2,0,0,0,0.0,0.0,0.0
6920,Jesse Stone: Death in Paradise,0,0,0,0.0,0.0,0.0
6921,Old Joy,0,300000,-300000,0.0,324500.74748747103,-324500.74748747103
6922,First Snow,382267,8000000,-7617733,413486.42413264397,8653353.26633258,-8239866.842199936
6923,Bella,0,0,0,0.0,0.0,0.0
6924,The Bridge,0,0,0,0.0,0.0,0.0
6925,For Your Consideration,5542025,12000000,-6457975,5994637.51698085,12980029.8994988,-6985392.38251795
6926,Changement d'adresse,0,0,0,0.0,0.0,0.0
6927,Beer League,0,0,0,0.0,0.0,0.0
6928,L'Ivresse du pouvoir,0,0,0,0.0,0.0,0.0
6929,Venus,0,0,0,0.0,0.0,0.0
6930,Kiwi!,0,0,0,0.0,0.0,0.0
6931,Feng kuang de shi tou,0,0,0,0.0,0.0,0.0
6932,Thr3e,0,0,0,0.0,0.0,0.0
6933,Offside,0,2500,-2500,0.0,2704.17289572893,-2704.17289572893
6934,Jean-Philippe,0,0,0,0.0,0.0,0.0
6935,Imprint,0,0,0,0.0,0.0,0.0
6936,Dane Cook: Vicious Circle,0,0,0,0.0,0.0,0.0
6937,Doogal,0,0,0,0.0,0.0,0.0
6938,Read It and Weep,0,0,0,0.0,0.0,0.0
6939,Five Fingers,0,0,0,0.0,0.0,0.0
6940,Root of All Evil?,0,0,0,0.0,0.0,0.0
6941,Jane Eyre,0,0,0,0.0,0.0,0.0
6942,Lage Raho Munna Bhai,0,0,0,0.0,0.0,0.0
6943,Karla,0,0,0,0.0,0.0,0.0
6944,Strangers with Candy,0,0,0,0.0,0.0,0.0
6945,The Foot Fist Way,245000,79000,166000,265008.943781435,85451.8635050342,179557.08027640084
6946,Population 436,0,0,0,0.0,0.0,0.0
6947,Dark Ride,0,0,0,0.0,0.0,0.0
6948,Special,7202,1000000,-992798,7790.1812780159,1081669.15829157,-1073878.977013554
6949,Penny Dreadful,0,0,0,0.0,0.0,0.0
6950,Bring It On: All or Nothing,0,0,0,0.0,0.0,0.0
6951,Idlewild,0,0,0,0.0,0.0,0.0
6952,Comme t'y es belle,0,0,0,0.0,0.0,0.0
6953,The Protector,0,0,0,0.0,0.0,0.0
6954,Quand j'Ã©tais chanteur,0,0,0,0.0,0.0,0.0
6955,Desperation,0,0,0,0.0,0.0,0.0
6956,The Zodiac,0,0,0,0.0,0.0,0.0
6957,Deutschland. Ein SommermÃ¤rchen,0,0,0,0.0,0.0,0.0
6958,Hell,0,0,0,0.0,0.0,0.0
6959,How to Eat Fried Worms,13022756,0,13022756,14086313.521156501,0.0,14086313.521156501
6960,ì§íŒ¨,0,2700000,-2700000,0.0,2920506.72738724,-2920506.72738724
6961,Khosla Ka Ghosla!,0,0,0,0.0,0.0,0.0
6962,Harry Potter and the Prisoner of Azkaban,789804554,130000000,659804554,911786234.1159849,150077901.975579,761708332.1404059
6963,Kill Bill: Vol. 2,152159461,30000000,122159461,175659789.789346,34633361.994364396,141026427.7949816
6964,Bridget Jones: The Edge of Reason,40203020,50000000,-9796980,46412191.4975558,57722269.990607396,-11310078.493051596
6965,Eternal Sunshine of the Spotless Mind,72258126,20000000,52258126,83418061.15974659,23088907.9962429,60329153.16350369
6966,The Notebook,115603229,29000000,86603229,133457615.92248,33478916.5945523,99978699.32792771
6967,The Incredibles,631442092,92000000,539442092,728965418.357159,106208976.782717,622756441.574442
6968,The Bourne Supremacy,288500217,75000000,213500217,333057748.360456,86583404.9859111,246474343.3745449
6969,Troy,497409852,175000000,322409852,574232515.462641,202027944.967126,372204570.495515
6970,National Treasure,347451894,100000000,247451894,401114240.684318,115444539.98121399,285669700.703104
6971,"I, Robot",347234916,120000000,227234916,400863751.430357,138533447.97745702,262330303.45289996
6972,50 First Dates,196482882,75000000,121482882,226828759.26673302,86583404.9859111,140245354.28082192
6973,Mean Girls,129042871,17000000,112042871,148972948.804502,19625571.7968065,129347377.00769551
6974,Van Helsing,300257475,160000000,140257475,346630860.77296096,184711263.969943,161919596.80301797
6975,Hellboy,99318987,66000000,33318987,114658347.656152,76193396.3876018,38464951.2685502
6976,The Polar Express,305875730,165000000,140875730,353116829.412682,190483490.969004,162633338.443678
6977,Shrek 2,919838758,150000000,769838758,1061903622.7420199,173166809.971822,888736812.7701979
6978,The Butterfly Effect,96060858,13000000,83060858,110897015.62010801,15007790.1975579,95889225.42255011
6979,Resident Evil: Apocalypse,129394835,45000000,84394835,149379272.025202,51950042.9915466,97429229.0336554
6980,Ocean's Twelve,362744280,110000000,252744280,418768465.354169,126988993.97933601,291779471.374833
6981,Meet the Fockers,516642939,80000000,436642939,596436064.273978,92355631.98497191,504080432.2890061
6982,The Day After Tomorrow,544272402,125000000,419272402,628332770.733608,144305674.976518,484027095.75709
6983,The Aviator,102000000,116000000,-14000000,117753430.780839,133915666.37820901,-16162235.597370014
6984,Collateral,217764291,65000000,152764291,251396983.988304,75038950.9877896,176358033.0005144
6985,Shaun of the Dead,30039392,4000000,26039392,34678837.9075538,4617781.59924859,30061056.30830521
6986,Blade: Trinity,128905366,65000000,63905366,148814206.789801,75038950.9877896,73775255.8020114
6987,Starship Troopers 2: Hero of the Federation,0,7000000,-7000000,0.0,8081117.79868504,-8081117.79868504
6988,The Terminal,219417255,60000000,159417255,253305240.674159,69266723.9887289,184038516.6854301
6989,Lemony Snicket's A Series of Unfortunate Events,209073645,140000000,69073645,241364107.69220802,161622355.9737,79741751.71850803
6990,Million Dollar Baby,216763646,30000000,186763646,250241793.971209,34633361.994364396,215608431.9768446
6991,Garfield,200804534,50000000,150804534,231817870.53772202,57722269.990607396,174095600.5471146
6992,The Lion King 1Â½,0,0,0,0.0,0.0,0.0
6993,Shark Tale,367275019,75000000,292275019,423998956.150469,86583404.9859111,337415551.16455793
6994,Sky Captain and the World of Tomorrow,57958696,70000000,-12041304,66910149.97631071,80811177.9868504,-13901028.010539688
6995,Mulan II,0,0,0,0.0,0.0,0.0
6996,The SpongeBob SquarePants Movie,140161792,30000000,110161792,161809136.003827,34633361.994364396,127175774.00946261
6997,Species III,0,0,0,0.0,0.0,0.0
6998,Crash,98410061,6500000,91910061,113609042.216682,7503895.09877896,106105147.11790304
6999,Anchorman: The Legend of Ron Burgundy,90574188,26000000,64574188,104562954.67831999,30015580.3951158,74547374.2832042
7000,13 Going On 30,96455697,37000000,59455697,111352835.687324,42714479.7930495,68638355.8942745
7001,Ella Enchanted,27388767,31000000,-3611233,31618836.069676697,35787807.3941766,-4168971.324499905
7002,The Girl Next Door,30411183,25000000,5411183,35108050.3171954,28861134.995303698,6246915.321891703
7003,Scooby-Doo 2: Monsters Unleashed,181466833,0,181466833,209493550.575329,0.0,209493550.575329
7004,Finding Neverland,116766556,25000000,91766556,134800613.42610702,28861134.995303698,105939478.43080333
7005,A Cinderella Story,70067909,19000000,51067909,80889575.2195062,21934462.5964308,58955112.6230754
7006,AVP: Alien vs. Predator,171183863,70000000,101183863,197622423.16242298,80811177.9868504,116811245.17557259
7007,DodgeBall: A True Underdog Story,167722310,20000000,147722310,193626249.22536698,23088907.9962429,170537341.22912407
7008,Banlieue 13,9584131,12000000,-2415869,11064355.944147,13853344.7977457,-2788988.853598701
7009,Alexander,167298192,155000000,12298192,193136628.151289,178939036.970883,14197591.180405974
7010,Harold & Kumar Go to White Castle,23936908,9000000,14936908,27633853.326326597,10390008.5983093,17243844.728017297
7011,Saw,103911669,1200000,102711669,119960348.263852,1385334.47977457,118575013.78407744
7012,Spider-Man 2,783766341,200000000,583766341,904815446.895049,230889079.96242902,673926366.9326199
7013,EuroTrip,20796847,25000000,-4203153,24008824.349747,28861134.995303698,-4852310.6455566995
7014,Man on Fire,130293714,70000000,60293714,150416978.751739,80811177.9868504,69605800.7648886
7015,Along Came Polly,171963386,42000000,129963386,198522339.90382,48486706.792110205,150035633.1117098
7016,Closer,115505027,27000000,88505027,133344247.075328,31170025.794928003,102174221.28040001
7017,The Punisher,54700105,33000000,21700105,63148284.5864915,38096698.1938009,25051586.392690606
7018,Catwoman,82102379,100000000,-17897621,94782713.7501835,115444539.98121399,-20661826.231030494
7019,Christmas with the Kranks,0,60000000,-60000000,0.0,69266723.9887289,-69266723.9887289
7020,9 Songs,332323,1000000,-667677,383648.758601772,1154445.39981214,-770796.641210368
7021,Dawn of the Dead,102356381,28000000,74356381,118164853.186869,32324471.1947401,85840381.9921289
7022,Barbie as The Princess & the Pauper,0,0,0,0.0,0.0,0.0
7023,King Arthur,203567857,120000000,83567857,235007976.063267,138533447.97745702,96474528.08580998
7024,The Chronicles of Riddick,115772733,105000000,10772733,133653299.03553,121216766.980275,12436532.055254996
7025,Spanglish,55041367,80000000,-24958633,63542252.93252221,92355631.98497191,-28813379.052449703
7026,Secret Window,92913171,40000000,52913171,107263182.842909,46177815.9924859,61085366.85042309
7027,Layer Cake,11850214,6500000,5350214,13680425.0390895,7503895.09877896,6176529.940310541
7028,After the Sunset,61347797,60000000,1347797,70822682.0352595,69266723.9887289,1555958.0465306044
7029,Thunderbirds,28283637,57000000,-28716363,32651914.624606606,65803387.789292395,-33151473.16468579
7030,The Princess Diaries 2: Royal Engagement,95149435,40000000,55149435,109844827.530475,46177815.9924859,63667011.5379891
7031,The Alamo,25819961,145000000,-119180039,29807735.199778996,167394582.972761,-137586847.772982
7032,Before Sunset,15992615,2700000,13292615,18462600.8177167,3117002.5794928,15345598.2382239
7033,The Grudge,183474602,10000000,173474602,211811410.261264,11544453.998121401,200266956.2631426
7034,Cellular,56422687,25000000,31422687,65136911.4521907,28861134.995303698,36275776.456887
7035,The Manchurian Candidate,96105964,80000000,16105964,110949088.03431101,92355631.98497191,18593456.0493391
7036,The Machinist,8203235,5000000,3203235,9470186.90932801,5772226.99906074,3697959.91026727
7037,Seed of Chucky,24829644,12000000,12829644,28664468.294773303,13853344.7977457,14811123.497027602
7038,Taxi,36609966,25000000,11609966,42264206.835979104,28861134.995303698,13403071.840675406
7039,Alfie,13395939,60000000,-46604061,15464880.154714098,69266723.9887289,-53801843.834014796
7040,Sniper 3,0,0,0,0.0,0.0,0.0
7041,Shall We Dance?,170128460,50000000,120128460,196404018.024125,57722269.990607396,138681748.0335176
7042,Jersey Girl,36098382,35000000,1098382,41673611.0405616,40405588.9934252,1268022.0471364036
7043,The Stepford Wives,102000000,90000000,12000000,117753430.780839,103900085.98309301,13853344.797745988
7044,Primer,424760,7000,417760,490362.228024208,8081.117798685041,482281.11022552295
7045,ã‚¢ãƒƒãƒ—ãƒ«ã‚·ãƒ¼ãƒ‰,1461989,10000000,-8538011,1687786.47562596,11544453.998121401,-9856667.522495441
7046,Home on the Range,103951461,110000000,-6048539,120006285.955201,126988993.97933601,-6982708.024135008
7047,Hidalgo,108103450,100000000,8103450,124799530.556322,115444539.98121399,9354990.575108007
7048,I Heart Huckabees,0,22000000,-22000000,0.0,25397798.7958672,-25397798.7958672
7049,Fahrenheit 9/11,119114517,6000000,113114517,137511206.201495,6926672.39887289,130584533.80262211
7050,Win a Date with Tad Hamilton!,16980098,17000000,-19902,19602596.0244594,19625571.7968065,-22975.77234710008
7051,White Chicks,113086475,37000000,76086475,130552160.84472099,42714479.7930495,87837681.05167149
7052,Hotel Rwanda,38000000,17500000,20500000,43868925.1928616,20202794.4967126,23666130.696149003
7053,Wild Things 2,0,2800000,-2800000,0.0,3232447.11947401,-3232447.11947401
7054,Walking Tall,57223890,56000000,1223890,66061856.5698564,64648942.3894803,1412914.1803760976
7055,Twisted,25195000,50000000,-24805000,29086251.848266996,57722269.990607396,-28636018.1423404
7056,"Mickey, Donald, Goofy: The Three Musketeers",0,0,0,0.0,0.0,0.0
7057,Open Water,54667954,130000,54537954,63111168.012442105,150077.901975579,62961090.110466525
7058,Un long dimanche de fianÃ§ailles,0,47000000,-47000000,0.0,54258933.791170895,-54258933.791170895
7059,Team America: World Police,50907422,32000000,18907422,58769839.144195706,36942252.793988705,21827586.350207
7060,Tremors 4: The Legend Begins,0,5000000,-5000000,0.0,5772226.99906074,-5772226.99906074
7061,Mickey's Twice Upon a Christmas,0,0,0,0.0,0.0,0.0
7062,New York Minute,0,0,0,0.0,0.0,0.0
7063,Immortel (ad vitam),0,24665810,-24665810,0.0,28475330.8871404,-28475330.8871404
7064,(T)Raumschiff Surprise - Periode 1,0,0,0,0.0,0.0,0.0
7065,Sideways,109502303,16000000,93502303,126414429.967186,18471126.3969943,107943303.57019171
7066,Without a Paddle,69631118,19000000,50631118,80385323.8588769,21934462.5964308,58450861.2624461
7067,Saved!,0,0,0,0.0,0.0,0.0
7068,Starsky & Hutch,170268750,60000000,110268750,196565975.169264,69266723.9887289,127299251.1805351
7069,Five Children and It,0,0,0,0.0,0.0,0.0
7070,Confessions of a Teenage Drama Queen,29331068,15000000,14331068,33861116.5241773,17316680.997182198,16544435.5269951
7071,The Village,256697520,60000000,196697520,296343271.10718703,69266723.9887289,227076547.11845815
7072,The Whole Ten Yards,26155781,40000000,-13844219,30195421.053944,46177815.9924859,-15982394.938541904
7073,The Passion of the Christ,611899420,30000000,581899420,706404470.566721,34633361.994364396,671771108.5723566
7074,Anacondas: The Hunt for the Blood Orchid,70992898,20000000,50992898,81957424.515433,23088907.9962429,58868516.5191901
7075,Ray,124731534,40000000,84731534,143995745.63781202,46177815.9924859,97817929.64532611
7076,Dirty Dancing: Havana Nights,27685016,25000000,2685016,31960839.3649257,28861134.995303698,3099704.3696220033
7077,Anatomie de l'enfer,0,0,0,0.0,0.0,0.0
7078,Bride & Prejudice,0,7000000,-7000000,0.0,8081117.79868504,-8081117.79868504
7079,Birth,0,20000000,-20000000,0.0,23088907.9962429,-23088907.9962429
7080,Wimbledon,41512007,31000000,10512007,47923345.5181197,35787807.3941766,12135538.123943098
7081,Taking Lives,65470529,45000000,20470529,75582151.02731779,51950042.9915466,23632108.03577119
7082,The Perfect Score,0,0,0,0.0,0.0,0.0
7083,Salem's Lot,0,0,0,0.0,0.0,0.0
7084,The Phantom of the Opera,154648887,70000000,84648887,178533696.183218,80811177.9868504,97722518.1963676
7085,Cube Zero,0,825000,-825000,0.0,952417.4548450221,-952417.4548450221
7086,Garden State,26781723,2500000,24281723,30918036.9163932,2886113.49953037,28031923.41686283
7087,Napoleon Dynamite,46118097,400000,45718097,53240824.9297404,461778.159924859,52779046.76981554
7088,First Daughter,0,30000000,-30000000,0.0,34633361.994364396,-34633361.994364396
7089,Exorcist: The Beginning,78000586,80000000,-1999414,90047417.6903518,92355631.98497191,-2308214.2946201116
7090,Sleepover,0,0,0,0.0,0.0,0.0
7091,Wicker Park,13001257,30000000,-16998743,15009241.3354254,34633361.994364396,-19624120.658938996
7092,ArsÃ¨ne Lupin,0,23000000,-23000000,0.0,26552244.195679396,-26552244.195679396
7093,The Life Aquatic with Steve Zissou,34808403,50000000,-15191597,40184400.7181573,57722269.990607396,-17537869.272450097
7094,Around the World in 80 Days,72178895,110000000,-37821105,83326593.2962741,126988993.97933601,-43662400.68306191
7095,Barbershop 2:  Back in Business,65070412,18000000,47070412,75120237.7972812,20780017.1966186,54340220.600662604
7096,Blueberry,0,53000000,-53000000,0.0,61185606.1900438,-61185606.1900438
7097,The Prince & Me,0,0,0,0.0,0.0,0.0
7098,Les Dalton,0,0,0,0.0,0.0,0.0
7099,King Solomon's Mines,0,0,0,0.0,0.0,0.0
7100,Highwaymen,371396,0,371396,428756.40370863205,0.0,428756.40370863205
7101,Van Helsing: The London Assignment,0,0,0,0.0,0.0,0.0
7102,The Forgotten,117575636,42000000,75575636,135734652.11018702,48486706.792110205,87247945.31807682
7103,Surviving Christmas,14793624,45000000,-30206376,17078431.1733506,51950042.9915466,-34871611.818196
7104,The Libertine,0,0,0,0.0,0.0,0.0
7105,If Only,0,0,0,0.0,0.0,0.0
7106,Head in the Clouds,0,0,0,0.0,0.0,0.0
7107,In Good Company,0,0,0,0.0,0.0,0.0
7108,Ladies in Lavender,20377075,0,20377075,23524220.4953771,0.0,23524220.4953771
7109,Vera Drake,0,11000000,-11000000,0.0,12698899.3979336,-12698899.3979336
7110,In Enemy Hands,0,5400000,-5400000,0.0,6234005.1589856,-6234005.1589856
7111,The Librarian: Quest for the Spear,0,0,0,0.0,0.0,0.0
7112,Wake of Death,0,0,0,0.0,0.0,0.0
7113,Autobahnraser,0,7200000,-7200000,0.0,8312006.87864747,-8312006.87864747
7114,Flight of the Phoenix,21009180,45000000,-23990820,24253951.2048253,51950042.9915466,-27696091.7867213
7115,Beyond the Sea,0,23000000,-23000000,0.0,26552244.195679396,-26552244.195679396
7116,Godsend,30114487,25000000,5114487,34765530.9848527,28861134.995303698,5904395.989549004
7117,Noel,0,0,0,0.0,0.0,0.0
7118,It's All Gone Pete Tong,120620,2000000,-1879380,139249.204125341,2308890.79962429,-2169641.595498949
7119,Friday Night Lights,61255921,30000000,31255921,70716616.20970641,34633361.994364396,36083254.215342015
7120,The Ladykillers,0,0,0,0.0,0.0,0.0
7121,Melinda and Melinda,20085825,0,20085825,23187988.2726818,0.0,23187988.2726818
7122,Raising Helen,49718611,50000000,-281389,57397421.7539996,57722269.990607396,-324848.23660779744
7123,The Merchant of Venice,0,0,0,0.0,0.0,0.0
7124,A Good Woman,0,0,0,0.0,0.0,0.0
7125,She Hate Me,365134,8000000,-7634866,421527.266615009,9235563.19849719,-8814035.93188218
7126,Paparazzi,16605763,20000000,-3394237,19170446.7057207,23088907.9962429,-3918461.290522199
7127,Hawking,0,0,0,0.0,0.0,0.0
7128,Laws of Attraction,0,0,0,0.0,0.0,0.0
7129,Raise Your Voice,14867514,15000000,-132486,17163733.1439427,17316680.997182198,-152947.85323949903
7130,Ring of the Nibelungs,0,23000000,-23000000,0.0,26552244.195679396,-26552244.195679396
7131,L'enquÃªte corse,0,0,0,0.0,0.0,0.0
7132,Vanity Fair,16123851,23000000,-6876149,18614105.6142065,26552244.195679396,-7938138.581472896
7133,Balto III: Wings of Change,0,0,0,0.0,0.0,0.0
7134,Kinsey,0,0,0,0.0,0.0,0.0
7135,Deux frÃ¨res,62172050,74500000,-12327950,71774237.1193908,86006182.286005,-14231945.166614205
7136,The Assassination of Richard Nixon,3537961,0,3537961,4084382.80116478,0.0,4084382.80116478
7137,Scooby-Doo! and the Loch Ness Monster,0,0,0,0.0,0.0,0.0
7138,Cruel Intentions 3,0,0,0,0.0,0.0,0.0
7139,In My Father's Den,0,0,0,0.0,0.0,0.0
7140,The Clearing,12520799,0,12520799,14454578.8075225,0.0,14454578.8075225
7141,Metallica: Some Kind of Monster,0,0,0,0.0,0.0,0.0
7142,Torque,46546197,40000000,6546197,53735043.0054,46177815.9924859,7557227.012914099
7143,Miracle,64445708,28000000,36445708,74399051.1382369,32324471.1947401,42074579.94349679
7144,The Calcium Kid,0,0,0,0.0,0.0,0.0
7145,Mindhunters,21148829,27000000,-5851171,24415168.3504637,31170025.794928003,-6754857.444464304
7146,Control,0,6800000,-6800000,0.0,7850228.71872261,-7850228.71872261
7147,Mysterious Skin,1524966,0,1524966,1760489.98356993,0.0,1760489.98356993
7148,Pride,0,0,0,0.0,0.0,0.0
7149,The Life and Death of Peter Sellers,0,0,0,0.0,0.0,0.0
7150,Jack-Jack Attack,0,0,0,0.0,0.0,0.0
7151,Iron Jawed Angels,0,0,0,0.0,0.0,0.0
7152,Soul Plane,14822346,16000000,-1177654,17111589.154124,18471126.3969943,-1359537.242870301
7153,Le conseguenze dell'amore,0,0,0,0.0,0.0,0.0
7154,Madhouse,0,0,0,0.0,0.0,0.0
7155,Club Dread,5001655,8500000,-3498345,5774137.60619743,9812785.89840326,-4038648.292205831
7156,Haven,0,0,0,0.0,0.0,0.0
7157,Winnie the Pooh: Springtime with Roo,0,0,0,0.0,0.0,0.0
7158,Chasing Liberty,12,23000000,-22999988,13.8533447977457,26552244.195679396,-26552230.3423346
7159,Suspect Zero,13000000,27000000,-14000000,15007790.1975579,31170025.794928003,-16162235.597370103
7160,Eros,0,0,0,0.0,0.0,0.0
7161,The Big Bounce,6808550,50000000,-43191450,7860099.226891001,57722269.990607396,-49862170.76371639
7162,Dear Frankie,0,0,0,0.0,0.0,0.0
7163,Fighter in the Wind,0,6000000,-6000000,0.0,6926672.39887289,-6926672.39887289
7164,The Five People You Meet In Heaven,0,0,0,0.0,0.0,0.0
7165,Envy,0,40000000,-40000000,0.0,46177815.9924859,-46177815.9924859
7166,The Heart is Deceitful Above All Things,176153,74050,102103,203359.020513109,85486.6818560896,117872.33865701938
7167,Mr. 3000,21800302,30000000,-8199698,25167258.3584155,34633361.994364396,-9466103.635948896
7168,Six Shooter,0,200000,-200000,0.0,230889.07996242898,-230889.07996242898
7169,Connie and Carla,11341016,20000000,-8658984,13092583.7503959,23088907.9962429,-9996324.245847
7170,Breakin' All the Rules,0,0,0,0.0,0.0,0.0
7171,The Final Cut,548039,0,548039,632681.10246765,0.0,632681.10246765
7172,Spartan,8112712,19250000,-11137288,9365683.04840081,22223073.9463838,-12857390.89798299
7173,Agent Cody Banks 2: Destination London,28818995,26000000,2818995,33269956.204959303,30015580.3951158,3254375.809843503
7174,Johnson Family Vacation,31179516,12000000,19179516,35995048.814569205,13853344.7977457,22141704.016823504
7175,Frankenfish,0,0,0,0.0,0.0,0.0
7176,Riding the Bullet,0,5000000,-5000000,0.0,5772226.99906074,-5772226.99906074
7177,Stage Beauty,776691,0,776691,896647.352025497,0.0,896647.352025497
7178,Super Size Me,28575078,65000,28510078,32988367.346373305,75038.9509877896,32913328.395385515
7179,A Home at the End of the World,1548955,6500000,-4951045,1788183.97426602,7503895.09877896,-5715711.124512941
7180,Little Black Book,22034832,35000000,-12965168,25438010.4380335,40405588.9934252,-14967578.5553917
7181,Rois et reine,0,0,0,0.0,0.0,0.0
7182,Fat Albert,0,0,0,0.0,0.0,0.0
7183,Against the Ropes,6614280,39000000,-32385720,7635825.11906949,45023370.592673704,-37387545.47360422
7184,Non ti muovere,11837022,0,11837022,13665195.595375098,0.0,13665195.595375098
7185,Eating Out,0,50000,-50000,0.0,57722.269990607405,-57722.269990607405
7186,A Love Song for Bobby Long,1841260,0,1841260,2125634.13685811,0.0,2125634.13685811
7187,Suwingu gÃ¢ruzu,0,0,0,0.0,0.0,0.0
7188,Employee of the Month,0,0,0,0.0,0.0,0.0
7189,Saving Face,0,0,0,0.0,0.0,0.0
7190,Earthsea,0,0,0,0.0,0.0,0.0
7191,"Wake Up, Ron Burgundy: The Lost Movie",0,0,0,0.0,0.0,0.0
7192,A Dirty Shame,1914166,15000000,-13085834,2209800.13317682,17316680.997182198,-15106880.864005378
7193,Spartacus,0,0,0,0.0,0.0,0.0
7194,Out of Reach,0,20000000,-20000000,0.0,23088907.9962429,-23088907.9962429
7195,Modigliani,0,14,-14,0.0,16.162235597370003,-16.162235597370003
7196,The Football Factory,0,0,0,0.0,0.0,0.0
7197,Ladder 49,74541707,60000000,14541707,86054330.740295,69266723.9887289,16787606.751566097
7198,The 24th Day,0,0,0,0.0,0.0,0.0
7199,Halloweentown High,0,0,0,0.0,0.0,0.0
7200,Stuck in the Suburbs,0,0,0,0.0,0.0,0.0
7201,What the #$*! Do We (K)now!?,10000000,0,10000000,11544453.998121401,0.0,11544453.998121401
7202,Back to Gaya,0,0,0,0.0,0.0,0.0
7203,YÅ«giÅ Dyueru MonsutÄzu Hikari no Piramiddo,29170410,0,29170410,33675645.6351343,0.0,33675645.6351343
7204,LaLehet Al HaMayim,0,1400000,-1400000,0.0,1616223.5597370001,-1616223.5597370001
7205,Catch That Kid,16702864,18000000,-1297136,19282544.5084879,20780017.1966186,-1497472.6881307028
7206,Il cartaio,1479042,2600000,-1120958,1707473.23302896,3001558.03951158,-1294084.80648262
7207,A Boyfriend for Christmas,0,0,0,0.0,0.0,0.0
7208,The Chronicles of Riddick: Dark Fury,0,0,0,0.0,0.0,0.0
7209,The Woodsman,4678405,0,4678405,5400963.13070815,0.0,5400963.13070815
7210,Le Convoyeur,0,0,0,0.0,0.0,0.0
7211,Dead Birds,0,1500000,-1500000,0.0,1731668.09971822,-1731668.09971822
7212,My Summer of Love,0,0,0,0.0,0.0,0.0
7213,Undertow,143597,0,143597,165774.896076825,0.0,165774.896076825
7214,Unstoppable,0,0,0,0.0,0.0,0.0
7215,Farscape The Peacekeeper Wars,0,90,-90,0.0,103.90008598309299,-103.90008598309299
7216,The Door in the Floor,0,0,0,0.0,0.0,0.0
7217,Criminal,0,0,0,0.0,0.0,0.0
7218,The Toolbox Murders,0,0,0,0.0,0.0,0.0
7219,Inside I'm Dancing,0,0,0,0.0,0.0,0.0
7220,Superbabies: Baby Geniuses 2,9109322,0,9109322,10516214.8783076,0.0,10516214.8783076
7221,Riding Giants,3166000,2600000,566000,3654974.13580526,3001558.03951158,653416.0962936799
7222,Enduring Love,0,0,0,0.0,0.0,0.0
7223,Speak,0,1000000,-1000000,0.0,1154445.39981214,-1154445.39981214
7224,Mujhse Shaadi Karogi,0,0,0,0.0,0.0,0.0
7225,Mean Creek,603943,500000,103943,697219.218098748,577222.699906074,119996.51819267403
7226,Chin Kei Bin 2 - Fa Tou Tai Kam,0,0,0,0.0,0.0,0.0
7227,Ae Fond Kiss...,0,0,0,0.0,0.0,0.0
7228,We Don't Live Here Anymore,2037545,3000000,-962455,2352234.45216024,3463336.19943644,-1111101.7472762
7229,Dead Man's Shoes,0,0,0,0.0,0.0,0.0
7230,Frankenstein,0,0,0,0.0,0.0,0.0
7231,De-Lovely,0,20000000,-20000000,0.0,23088907.9962429,-23088907.9962429
7232,Dave Chappelle: For What it's Worth,0,0,0,0.0,0.0,0.0
7233,Vinci,0,0,0,0.0,0.0,0.0
7234,Welcome to Mooseport,14000000,30000000,-16000000,16162235.59737,34633361.994364396,-18471126.396994397
7235,Dracula 3000,0,0,0,0.0,0.0,0.0
7236,Chris Rock: Never Scared,0,0,0,0.0,0.0,0.0
7237,Bobby Jones: Stroke of Genius,0,0,0,0.0,0.0,0.0
7238,Creep,0,0,0,0.0,0.0,0.0
7239,Kim Possible: A Sitch in Time,0,0,0,0.0,0.0,0.0
7240,The Brown Bunny,0,10000000,-10000000,0.0,11544453.998121401,-11544453.998121401
7241,Gracie's Choice,0,0,0,0.0,0.0,0.0
7242,The Cutting Edge: The Magic of Movie Editing,0,0,0,0.0,0.0,0.0
7243,Eulogy,0,0,0,0.0,0.0,0.0
7244,Never Die Alone,5923000,3000000,2923000,6837780.10308735,3463336.19943644,3374443.9036509097
7245,Something the Lord Made,0,0,0,0.0,0.0,0.0
7246,Decoys,0,5000000,-5000000,0.0,5772226.99906074,-5772226.99906074
7247,The Power of Nightmares,0,0,0,0.0,0.0,0.0
7248,Satan's Little Helper,0,0,0,0.0,0.0,0.0
7249,Crimen Ferpecto,0,6000000,-6000000,0.0,6926672.39887289,-6926672.39887289
7250,Narco,823258,823258,0,950406.410958549,950406.410958549,0.0
7251,Zenon: Z3,0,0,0,0.0,0.0,0.0
7252,D.E.B.S.,0,3500000,-3500000,0.0,4040558.89934252,-4040558.89934252
7253,You Got Served,0,0,0,0.0,0.0,0.0
7254,Alone in the Wilderness,0,0,0,0.0,0.0,0.0
7255,Palindromes,0,0,0,0.0,0.0,0.0
7256,SoupÃ§ons,0,0,0,0.0,0.0,0.0
7257,Mensonges Et Trahisons Et Plus Si AffinitÃ©s...,0,0,0,0.0,0.0,0.0
7258,The I Inside,0,8800000,-8800000,0.0,10159119.5183469,-10159119.5183469
7259,Saint Ralph,0,0,0,0.0,0.0,0.0
7260,Bring It On Again,0,0,0,0.0,0.0,0.0
7261,Matando Cabos,0,0,0,0.0,0.0,0.0
7262,I Am David,0,0,0,0.0,0.0,0.0
7263,Khakee,0,0,0,0.0,0.0,0.0
7264,DiG!,127067,0,127067,146691.91361793,0.0,146691.91361793
7265,Cazuza - O tempo nÃ£o pÃ¡ra,0,0,0,0.0,0.0,0.0
7266,In questo mondo di ladri,0,0,0,0.0,0.0,0.0
7267,Long Way Round,0,0,0,0.0,0.0,0.0
7268,Born into Brothels,3515061,350000,3165061,4057946.00150909,404055.889934252,3653890.111574838
7269,The Godfather,245066411,6000000,239066411,1277913732.38977,31287365.5881737,1246626366.8015964
7270,Deliverance,46122355,2000000,44122355,240507830.44542202,10429121.8627245,230078708.5826975
7271,Conquest of the Planet of the Apes,9700000,1800000,7900000,50581241.034214206,9386209.67645213,41195031.357762076
7272,Cabaret,0,6000000,-6000000,0.0,31287365.5881737,-31287365.5881737
7273,Frenzy,12600000,3500000,9100000,65703467.735164896,18250963.259767998,47452504.4753969
7274,Joe Kidd,6330000,0,6330000,33008170.695523303,0.0,33008170.695523303
7275,Silent Running,0,1000000,-1000000,0.0,5214560.93136229,-5214560.93136229
7276,Slaughterhouse-Five,0,3200000,-3200000,0.0,16686594.980359301,-16686594.980359301
7277,Pink Flamingos,6000000,12000,5988000,31287365.5881737,62574.7311763475,31224790.856997352
7278,Everything You Always Wanted to Know About Sex *But Were Afraid to Ask,18016290,2000000,16016290,93947041.9620932,10429121.8627245,83517920.0993687
7279,Horror Express,0,300000,-300000,0.0,1564368.27940868,-1564368.27940868
7280,The Last House on the Left,0,90000,-90000,0.0,469310.48382260604,-469310.48382260604
7281,"What's Up, Doc?",0,0,0,0.0,0.0,0.0
7282,Jeremiah Johnson,0,0,0,0.0,0.0,0.0
7283,Chato's Land,0,0,0,0.0,0.0,0.0
7284,The Poseidon Adventure,84563118,5000000,79563118,440959531.356979,26072804.656811398,414886726.7001676
7285,The Mechanic,0,0,0,0.0,0.0,0.0
7286,Sleuth,0,0,0,0.0,0.0,0.0
7287,The Cowboys,7500000,0,7500000,39109206.985217206,0.0,39109206.985217206
7288,The Getaway,58831997,3352254,55479743,306783033.070223,17480532.7404029,289302500.3298201
7289,"Now You See Him, Now You Don't",0,0,0,0.0,0.0,0.0
7290,Tales from the Crypt,0,0,0,0.0,0.0,0.0
7291,"Play It Again, Sam",0,0,0,0.0,0.0,0.0
7292,Boxcar Bertha,0,600000,-600000,0.0,3128736.55881737,-3128736.55881737
7293,Pink Floyd: Live at Pompeii,0,0,0,0.0,0.0,0.0
7294,Carry On Abroad,0,0,0,0.0,0.0,0.0
7295,Avanti!,0,0,0,0.0,0.0,0.0
7296,Fritz the Cat,0,850000,-850000,0.0,4432376.79165795,-4432376.79165795
7297,The Candidate,0,0,0,0.0,0.0,0.0
7298,Across 110th Street,0,0,0,0.0,0.0,0.0
7299,"Snoopy, Come Home",0,0,0,0.0,0.0,0.0
7300,The Life and Times of Judge Roy Bean,0,0,0,0.0,0.0,0.0
7301,The Other,0,0,0,0.0,0.0,0.0
7302,Asylum,0,0,0,0.0,0.0,0.0
7303,Blacula,0,500000,-500000,0.0,2607280.46568114,-2607280.46568114
7304,Milano Calibro 9,0,0,0,0.0,0.0,0.0
7305,Carry On Matron,0,0,0,0.0,0.0,0.0
7306,Night of the Lepus,0,0,0,0.0,0.0,0.0
7307,Dr. Phibes Rises Again,0,75000,-75000,0.0,391092.06985217205,-391092.06985217205
7308,Fat City,0,0,0,0.0,0.0,0.0
7309,The Empire Strikes Back,538400000,18000000,520400000,1424626187.77282,47628661.5525832,1376997526.2202368
7310,The Shining,44017374,19000000,25017374,116471589.37108201,50274698.3055045,66196891.06557751
7311,Airplane!,83453539,3500000,79953539,220821131.35535,9261128.63522451,211560002.72012547
7312,The Blues Brothers,115229890,27000000,88229890,304902523.975077,71442992.3288748,233459531.64620218
7313,The Blue Lagoon,58853106,4500000,54353106,155727481.499572,11907165.3881458,143820316.1114262
7314,Raging Bull,23000000,18000000,5000000,60858845.3171896,47628661.5525832,13230183.764606394
7315,Superman II,108185706,54000000,54185706,286263354.21673703,142885984.657749,143377369.55898803
7316,Friday the 13th,59754601,550000,59204601,158112870.402147,1455320.21410671,156657550.1880403
7317,Fame,21202829,0,21202829,56103464.7999053,0.0,56103464.7999053
7318,Flash Gordon,27107960,35000000,-7892040,71728658.4567202,92611286.35224509,-20882627.89552489
7319,The Elephant Man,26010864,5000000,21010864,68825702.11923729,13230183.764606401,55595518.35463089
7320,Cheech & Chong's Next Movie,41675194,0,41675194,110274095.009124,0.0,110274095.009124
7321,Smokey and the Bandit II,66132626,0,66132626,174989358.963198,0.0,174989358.963198
7322,Private Benjamin,0,0,0,0.0,0.0,0.0
7323,The Gods Must Be Crazy,0,0,0,0.0,0.0,0.0
7324,The Fog,21378361,1000000,20378361,56567928.92321911,2646036.75292129,53921892.17029782
7325,Little Lord Fauntleroy,0,0,0,0.0,0.0,0.0
7326,Caddyshack,39846344,6000000,33846344,105434890.693544,15876220.517527698,89558670.1760163
7327,Dressed to Kill,31899000,6500000,25399000,84405926.3814362,17199238.8939883,67206687.4874479
7328,Used Cars,11715321,8000000,3715321,30999169.9382706,21168294.0233703,9830875.9149003
7329,Inferno,0,3000000,-3000000,0.0,7938110.25876387,-7938110.25876387
7330,Stir Crazy,101300000,0,101300000,268043523.07092598,0.0,268043523.07092598
7331,Bronco Billy,0,0,0,0.0,0.0,0.0
7332,Heaven's Gate,3484331,44000000,-40515669,9219667.88534299,116425617.12853602,-107205949.24319303
7333,Terror Train,0,3500000,-3500000,0.0,9261128.63522451,-9261128.63522451
7334,The Big Brawl,0,0,0,0.0,0.0,0.0
7335,The Final Countdown,16647800,0,16647800,44050690.655283004,0.0,44050690.655283004
7336,Permanent Vacation,0,0,0,0.0,0.0,0.0
7337,Somewhere in Time,0,5100000,-5100000,0.0,13494787.4398985,-13494787.4398985
7338,Popeye,0,20000000,-20000000,0.0,52920735.0584258,-52920735.0584258
7339,Herbie Goes Bananas,0,0,0,0.0,0.0,0.0
7340,Any Which Way You Can,70687344,0,70687344,187041310.19039,0.0,187041310.19039
7341,The Long Good Friday,0,0,0,0.0,0.0,0.0
7342,The Dogs of War,0,0,0,0.0,0.0,0.0
7343,Altered States,19853892,15000000,4853892,52534127.9205299,39690551.2938193,12843576.626710601
7344,Urban Cowboy,0,0,0,0.0,0.0,0.0
7345,The Exterminator,0,0,0,0.0,0.0,0.0
7346,The Mirror Crack'd,11000000,0,11000000,29106404.282134198,0.0,29106404.282134198
7347,The Big Red One,7206220,0,7206220,19067922.9696364,0.0,19067922.9696364
7348,American Gigolo,22743674,4800000,17943674,60180597.3004603,12700976.4140221,47479620.886438206
7349,Cruising,0,0,0,0.0,0.0,0.0
7350,Alligator,0,1500000,-1500000,0.0,3969055.12938193,-3969055.12938193
7351,Nine to Five,0,0,0,0.0,0.0,0.0
7352,Atlantic City,12729678,7200000,5529678,33683195.8408535,19051464.6210332,14631731.219820298
7353,å¸«å¼Ÿå‡ºé¦¬,0,0,0,0.0,0.0,0.0
7354,Ordinary People,0,6000000,-6000000,0.0,15876220.517527698,-15876220.517527698
7355,Stardust Memories,10389003,10000000,389003,27489683.764209498,26460367.5292129,1029316.2349965982
7356,Tom Horn,0,0,0,0.0,0.0,0.0
7357,My Bodyguard,22482952,0,22482952,59490717.306165196,0.0,59490717.306165196
7358,Bad Timing,0,0,0,0.0,0.0,0.0
7359,Saturn 3,0,0,0,0.0,0.0,0.0
7360,Shogun Assassin,0,0,0,0.0,0.0,0.0
7361,Prom Night,14796236,1000000,13796236,39151384.2608971,2646036.75292129,36505347.50797581
7362,ShÅgun,0,0,0,0.0,0.0,0.0
7363,Breaker Morant,0,0,0,0.0,0.0,0.0
7364,The Nude Bomb,0,0,0,0.0,0.0,0.0
7365,Brubaker,37121708,0,37121708,98225403.6992123,0.0,98225403.6992123
7366,The Ninth Configuration,0,0,0,0.0,0.0,0.0
7367,Battle Beyond the Stars,11000000,2000000,9000000,29106404.282134198,5292073.50584258,23814330.776291616
7368,Seems Like Old Times,0,0,0,0.0,0.0,0.0
7369,Coal Miner's Daughter,0,0,0,0.0,0.0,0.0
7370,Xanadu,22471595,20000000,2471595,59460666.266762294,52920735.0584258,6539931.208336495
7371,The Long Riders,15795189,10000000,5795189,41794650.613338,26460367.5292129,15334283.084125102
7372,Maniac,0,350000,-350000,0.0,926112.8635224509,-926112.8635224509
7373,Humanoids from the Deep,0,0,0,0.0,0.0,0.0
7374,The Watcher in the Woods,5000000,0,5000000,13230183.764606401,0.0,13230183.764606401
7375,The Hunter,0,0,0,0.0,0.0,0.0
7376,Where the Buffalo Roam,6659377,0,6659377,17620956.293558702,0.0,17620956.293558702
7377,Death Ship,0,0,0,0.0,0.0,0.0
7378,The Octagon,18971000,0,18971000,50197963.2396698,0.0,50197963.2396698
7379,Foxes,4400000,0,4400000,11642561.7128536,0.0,11642561.7128536
7380,Forbidden Zone,0,0,0,0.0,0.0,0.0
7381,The Changeling,12000000,0,12000000,31752441.035055395,0.0,31752441.035055395
7382,The Awakening,0,0,0,0.0,0.0,0.0
7383,Gloria,4059673,0,4059673,10742043.9628422,0.0,10742043.9628422
7384,Hopscotch,0,0,0,0.0,0.0,0.0
7385,The Stunt Man,0,0,0,0.0,0.0,0.0
7386,Motel Hell,0,3000000,-3000000,0.0,7938110.25876387,-7938110.25876387
7387,Pirates of the Caribbean: At World's End,961000000,300000000,661000000,1010653507.9089099,315500574.789463,695152933.119447
7388,Harry Potter and the Order of the Phoenix,938212738,150000000,788212738,986688860.379322,157750287.39473101,828938572.984591
7389,Ratatouille,623722818,150000000,473722818,655949691.961013,157750287.39473101,498199404.5662819
7390,The Bourne Ultimatum,442824138,70000000,372824138,465704233.56549597,73616800.78420821,392087432.7812878
7391,No Country for Old Men,171600000,25000000,146600000,180466328.779573,26291714.5657886,154174614.2137844
7392,I Am Legend,585349010,150000000,435349010,615593163.691478,157750287.39473101,457842876.29674697
7393,National Treasure: Book of Secrets,457363168,130000000,327363168,480994474.638433,136716915.7421,344277558.896333
7394,Spider-Man 3,890871626,258000000,632871626,936901700.2220801,271330494.318938,665571205.9031421
7395,The Mist,57096190,18000000,39096190,60046269.2109614,18930034.4873678,41116234.7235936
7396,Stardust,135560026,70000000,65560026,142564220.404915,73616800.78420821,68947419.6207068
7397,Death Proof,25037897,25000000,37897,26331569.650064602,26291714.5657886,39855.0842760019
7398,Live Free or Die Hard,383531464,110000000,273531464,403347991.139481,115683544.08947,287664447.05001104
7399,Rush Hour 3,258022233,140000000,118022233,271353876.066536,147233601.568416,124120274.49812001
7400,Into the Wild,56255142,15000000,41255142,59161765.45287629,15775028.739473099,43386736.713403195
7401,300,422610419,65000000,357610419,444446100.355053,68358457.8710504,376087642.4840026
7402,Ghost Rider,228738393,110000000,118738393,240556981.559727,115683544.08947,124873437.47025701
7403,Juno,231411584,7500000,223911584,243368292.5498,7887514.36973659,235480778.18006343
7404,Bridge to Terabithia,137587063,60000000,77587063,144695991.533647,63100114.9578927,81595876.5757543
7405,Shooter,95696996,61000000,34696996,100641524.145416,64151783.54052429,36489740.60489172
7406,Atonement,129266061,30000000,99266061,135945055.154232,31550057.478946302,104394997.6752857
7407,There Will Be Blood,76181545,25000000,51181545,80117737.4528313,26291714.5657886,53826022.8870427
7408,Species: The Awakening,0,3800000,-3800000,0.0,3996340.61399987,-3996340.61399987
7409,American Gangster,266465037,100000000,166465037,280232907.782652,105166858.263154,175066049.51949802
7410,Hot Fuzz,80573774,0,80573774,84736906.69985451,0.0,84736906.69985451
7411,Shrek the Third,798958165,160000000,638958165,840239200.967451,168266973.22104698,671972227.7464039
7412,Sweeney Todd: The Demon Barber of Fleet Street,152000000,50000000,102000000,159853624.559995,52583429.1315773,107270195.4284177
7413,Superbad,169860655,20000000,149860655,178637114.288716,21033371.6526309,157603742.6360851
7414,Alvin and the Chipmunks,361366633,60000000,301366633,380037934.737444,63100114.9578927,316937819.77955127
7415,Bee Movie,287594577,150000000,137594577,302454181.16610897,157750287.39473101,144703893.77137795
7416,Meet the Robinsons,169332978,150000000,19332978,178082172.966038,157750287.39473101,20331885.571306974
7417,P.S. I Love You,156835339,30000000,126835339,164938798.67266798,31550057.478946302,133388741.19372168
7418,Knocked Up,219076518,30000000,189076518,230395891.17291403,31550057.478946302,198845833.69396773
7419,The Number 23,77566815,30000000,47566815,81574582.3902933,31550057.478946302,50024524.911347
7420,Planet Terror,0,0,0,0.0,0.0,0.0
7421,4: Rise of the Silver Surfer,289047763,130000000,159047763,303982451.227029,136716915.7421,167265535.48492903
7422,Enchanted,340487652,85000000,255487652,358080166.382383,89391829.5236814,268688336.8587016
7423,Zodiac,84785914,65000000,19785914,89166682.0035001,68358457.8710504,20808224.1324497
7424,Drive Thru,0,0,0,0.0,0.0,0.0
7425,Ocean's Thirteen,311312624,85000000,226312624,327397706.037387,89391829.5236814,238005876.5137056
7426,TMNT,95608995,34000000,61608995,100548976.258476,35756731.8094725,64792244.4490035
7427,The Simpsons Movie,527068851,75000000,452068851,554301751.480407,78875143.69736591,475426607.7830411
7428,Charlie Wilson's War,119000410,75000000,44000410,125148992.517272,78875143.69736591,46273848.819906086
7429,28 Weeks Later,64238440,15000000,49238440,67557549.1452616,15775028.739473099,51782520.4057885
7430,The Kingdom,86658558,70000000,16658558,91136082.86475359,73616800.78420821,17519282.08054538
7431,Aliens vs Predator: Requiem,41797066,40000000,1797066,43956661.158377096,42066743.3052618,1889917.8531152979
7432,Sunshine,32017803,50000000,-17982197,33672117.499986,52583429.1315773,-18911311.631591298
7433,Mr. Bean's Holiday,229736344,25000000,204736344,241606495.273433,26291714.5657886,215314780.7076444
7434,Mr. Brooks,41637263,20000000,21637263,43788601.3638669,21033371.6526309,22755229.711236004
7435,30 Days of Night,75505973,30000000,45505973,79407259.60512571,31550057.478946302,47857202.12617941
7436,The Golden Compass,372234864,180000000,192234864,391467711.82892597,189300344.873678,202167366.95524797
7437,Once,20710513,160000,20550513,21780595.8522822,168266.973221047,21612328.87906115
7438,Fracture,39000000,0,39000000,41015074.7226303,0.0,41015074.7226303
7439,88 Minutes,16930884,30000000,-13069116,17805678.7789791,31550057.478946302,-13744378.699967202
7440,The Brave One,69766619,70000000,-233381,73371361.3187251,73616800.78420821,-245439.46548311412
7441,Disturbia,117760134,20000000,97760134,123844633.21428001,21033371.6526309,102811261.56164911
7442,Lions for Lambs,63215872,35000000,28215872,66482146.5060572,36808400.392104104,29673746.1139531
7443,3:10 to Yuma,70016220,55000000,15016220,73633858.8486185,57841772.044735,15792086.803883508
7444,August Rush,66122026,25000000,41122026,69538457.3641462,26291714.5657886,43246742.798357606
7445,Awake,14373825,86000000,-71626175,15116500.164743802,90443498.1063129,-75326997.9415691
7446,War,40452643,25000000,15452643,42542773.7275099,26291714.5657886,16251059.1617213
7447,Paranormal Activity,193355800,15000,193340800,203346220.12958798,15775.0287394731,203330445.1008485
7448,Evan Almighty,173000000,175000000,-2000000,181938664.795257,184042001.96052,-2103337.165262997
7449,I Now Pronounce You Chuck & Larry,186072214,85000000,101072214,195686301.564493,89391829.5236814,106294472.0408116
7450,Next,18211013,70000000,-51788987,19151950.229994603,73616800.78420821,-54464850.554213606
7451,Cinderella III: A Twist in Time,0,8000000,-8000000,0.0,8413348.66105236,-8413348.66105236
7452,Premonition,84146832,20000000,64146832,88494579.54237479,21033371.6526309,67461207.8897439
7453,Breach,33231264,0,33231264,34948276.3099347,0.0,34948276.3099347
7454,Saw IV,139352633,10000000,129352633,146552786.033084,10516685.826315401,136036100.2067686
7455,Fred Claus,97838349,100000000,-2161651,102893517.81984,105166858.263154,-2273340.443314001
7456,Are We Done Yet?,0,0,0,0.0,0.0,0.0
7457,Hairspray,90450008,50000000,40450008,95123431.71237199,52583429.1315773,42540002.58079469
7458,The Hills Have Eyes II,0,15000000,-15000000,0.0,15775028.739473099,-15775028.739473099
7459,High School Musical 2,7000000,0,7000000,7361680.07842082,0.0,7361680.07842082
7460,Shoot 'Em Up,26820641,39000000,-12179359,28206425.505739503,41015074.7226303,-12808649.216890797
7461,Eastern Promises,55112356,51500000,3612356,57959933.320005104,54160932.005524606,3799001.3144804984
7462,Beowulf,195735876,70000000,125735876,205849271.28306398,73616800.78420821,132232470.49885577
7463,No Reservations,92601050,28000000,64601050,97385615.00369291,29446720.313683197,67938894.69000971
7464,American Pie Presents: Beta House,0,0,0,0.0,0.0,0.0
7465,The Heartbreak Kid,127766650,60000000,67766650,134368171.71308002,63100114.9578927,71268056.75518732
7466,Surf's Up,149044513,85000000,64044513,156745431.735719,89391829.5236814,67353602.2120376
7467,1408,94679598,25000000,69679598,99571558.6327845,26291714.5657886,73279844.0669959
7468,Hitman,99965753,24000000,75965753,105130841.769205,25240045.983157102,79890795.7860479
7469,The Game Plan,147880543,22000000,125880543,155521321.05559298,23136708.817894,132384612.23769899
7470,Wild Hogs,253625427,0,253625427,266729893.33241,0.0,266729893.33241
7471,Grindhouse,25037897,67000000,-41962103,26331569.650064602,70461795.0363136,-44130225.38624899
7472,Run Fatboy Run,33000000,10000000,23000000,34705063.226840995,10516685.826315401,24188377.400525592
7473,The Messengers,1109660,16000000,-14890340,1166994.55940292,16826697.3221047,-15659702.76270178
7474,Transformers,709709780,150000000,559709780,746379478.412346,157750287.39473101,588629191.017615
7475,The Bucket List,175372502,45000000,130372502,184433750.61088702,47325086.2184195,137108664.39246753
7476,Hostel: Part II,35619521,10200000,25419521,37459931.164084494,10727019.542841699,26732911.621242795
7477,2 Days in Paris,19776159,0,19776159,20797965.105426002,0.0,20797965.105426002
7478,Blades of Glory,0,53000000,-53000000,0.0,55738434.8794719,-55738434.8794719
7479,The Hitcher,25399945,10000000,15399945,26712324.1570692,10516685.826315401,16195638.330753798
7480,The Girl Next Door,0,0,0,0.0,0.0,0.0
7481,Wrong Turn 2: Dead End,0,4000000,-4000000,0.0,4206674.33052618,-4206674.33052618
7482,I Know Who Killed Me,9620399,12000000,-2379601,10117471.380679902,12620022.9915785,-2502551.610898599
7483,Halloween,80253908,15000000,65253908,84400513.6770024,15775028.739473099,68625484.9375293
7484,Becoming Jane,37311672,16500000,20811672,39239513.2078531,17352531.613420498,21886981.594432604
7485,Family Guy Presents: Blue Harvest,0,0,0,0.0,0.0,0.0
7486,Funny Games,7938872,15000000,-7061128,8349062.26393326,15775028.739473099,-7425966.475539839
7487,In the Name of the King: A Dungeon Siege Tale,0,60000000,-60000000,0.0,63100114.9578927,-63100114.9578927
7488,Elizabeth: The Golden Age,74237563,25000000,49237563,78073312.6582301,26291714.5657886,51781598.0924415
7489,Northanger Abbey,0,0,0,0.0,0.0,0.0
7490,Feast of Love,5741608,0,5741608,6038268.74738594,0.0,6038268.74738594
7491,The Invasion,15071514,80000000,-64928486,15850237.7664915,84133486.6105236,-68283248.8440321
7492,Mr. Magorium's Wonder Emporium,69474661,0,69474661,73064318.2626771,0.0,73064318.2626771
7493,Then She Found Me,0,0,0,0.0,0.0,0.0
7494,Before the Devil Knows You're Dead,25005257,18000000,7005257,26297243.1875275,18930034.4873678,7367208.700159699
7495,Afro Samurai,0,0,0,0.0,0.0,0.0
7496,Daddy Day Camp,18197398,6000000,12197398,19137631.7622421,6310011.49578927,12827620.26645283
7497,Outlaw,0,0,0,0.0,0.0,0.0
7498,Waitress,22179430,2000000,20179430,23325409.7116755,2103337.16526309,21222072.54641241
7499,The Man from Earth,0,0,0,0.0,0.0,0.0
7500,Underdog,0,0,0,0.0,0.0,0.0
7501,P2,7766240,8000000,-233760,8167510.61317641,8413348.66105236,-245838.04787594918
7502,Resident Evil: Extinction,147717833,45000000,102717833,155350204.060513,47325086.2184195,108025117.8420935
7503,Diary of the Dead,5364858,2000000,3364858,5642052.60887951,2103337.16526309,3538715.4436164205
7504,The Assassination of Jesse James by the Coward Robert Ford,14711793,30000000,-15288207,15471930.492278699,31550057.478946302,-16078126.986667603
7505,A Mighty Heart,18928871,16000000,2928871,19906898.935385298,16826697.3221047,3080201.613280598
7506,Death at a Funeral,46,9000000,-8999954,48.3767548010511,9465017.24368391,-9464968.866929108
7507,The Reaping,62771059,40000000,22771059,66014350.648811094,42066743.3052618,23947607.343549296
7508,The World Unseen,0,0,0,0.0,0.0,0.0
7509,Perfect Stranger,73090611,60795000,12295611,76867099.2740437,63936191.4810848,12930907.792958893
7510,KatyÅ„,14723313,5200000,9523313,15484045.714350598,5468676.62968403,10015369.084666569
7511,Georgia Rule,0,20000000,-20000000,0.0,21033371.6526309,-21033371.6526309
7512,Norbit,95673607,60000000,35673607,100616926.668937,63100114.9578927,37516811.7110443
7513,Music and Lyrics,145896422,40000000,105896422,153434683.335753,42066743.3052618,111367940.0304912
7514,Rendition,24748670,27500000,-2751330,26027398.700915802,28920886.0223675,-2893487.3214516975
7515,Flawless,6819587,20000000,-13180413,7171945.39442251,21033371.6526309,-13861426.25820839
7516,The Life Before Her Eyes,0,8000000,-8000000,0.0,8413348.66105236,-8413348.66105236
7517,Big Stan,0,0,0,0.0,0.0,0.0
7518,Shrek the Halls,0,60000000,-60000000,0.0,63100114.9578927,-63100114.9578927
7519,Lucky You,5761917,0,5761917,6059627.08463061,0.0,6059627.08463061
7520,Martian Child,0,0,0,0.0,0.0,0.0
7521,In the Valley of Elah,29541790,23000000,6541790,31068172.4176987,24188377.4005255,6879795.017173201
7522,Control,8159508,0,8159508,8581098.21333076,0.0,8581098.21333076
7523,Good Luck Chuck,59192128,25000000,34192128,62250501.356705,26291714.5657886,35958786.7909164
7524,Battlestar Galactica: Razor,0,0,0,0.0,0.0,0.0
7525,The Nines,0,0,0,0.0,0.0,0.0
7526,Epic Movie,86865564,20000000,66865564,91353784.5713698,21033371.6526309,70320412.9187389
7527,Fallen: The Journey,0,0,0,0.0,0.0,0.0
7528,In the Land of Women,17500000,10000000,7500000,18404200.196052,10516685.826315401,7887514.369736599
7529,Flight of Fury,0,12000000,-12000000,0.0,12620022.9915785,-12620022.9915785
7530,The Seeker: The Dark Is Rising,0,0,0,0.0,0.0,0.0
7531,Battle for Terra,6101046,4000000,2101046,6416278.39938986,4206674.33052618,2209604.0688636806
7532,The Nanny Diaries,47738099,20000000,27738099,50204658.9128544,21033371.6526309,29171287.260223504
7533,Because I Said So,69485490,0,69485490,73075706.78175841,0.0,73075706.78175841
7534,The Great Debaters,30226144,15000000,15226144,31787886.018896997,15775028.739473099,16012857.279423898
7535,Trick 'r Treat,0,12000000,-12000000,0.0,12620022.9915785,-12620022.9915785
7536,Jackass 2.5,0,0,0,0.0,0.0,0.0
7537,Doctor Strange,0,0,0,0.0,0.0,0.0
7538,Freedom Writers,41170784,21000000,20170784,43298020.05510949,22085040.235262398,21212979.819847096
7539,Hotel Chevalier,0,0,0,0.0,0.0,0.0
7540,The Invisible,26810113,30000000,-3189887,28195353.5389015,31550057.478946302,-3354703.9400448017
7541,Across the Universe,0,0,0,0.0,0.0,0.0
7542,Mr. Woodcock,0,22000000,-22000000,0.0,23136708.817894,-23136708.817894
7543,Hot Rod,14334401,0,14334401,15075039.1825422,0.0,15075039.1825422
7544,The Hunting Party,0,0,0,0.0,0.0,0.0
7545,La terza madre,54947,3500000,-3445053,57786.0336098555,3680840.03921041,-3623054.0056005544
7546,We Own the Night,54926886,21000000,33926886,57764880.3479845,22085040.235262398,35679840.1127221
7547,The Kite Runner,73276047,20000000,53276047,77062116.4893325,21033371.6526309,56028744.8367016
7548,Vacancy,35300645,19000000,16300645,37124579.293129295,19981703.0699993,17142876.223129995
7549,Dan in Real Life,68377859,25000000,43377859,71910846.0579097,26291714.5657886,45619131.4921211
7550,Ex Drummer,0,0,0,0.0,0.0,0.0
7551,Sydney White,13620075,16500000,-2879925,14323804.9705853,17352531.613420498,-3028726.642835198
7552,The Condemned,8642858,0,8642858,9089422.22274571,0.0,9089422.22274571
7553,Cassandra's Dream,0,0,0,0.0,0.0,0.0
7554,The Jane Austen Book Club,0,0,0,0.0,0.0,0.0
7555,Captivity,2626800,17000000,-14373200,2762523.03285654,17878365.9047362,-15115842.87187966
7556,Goal! II: Living the Dream,0,230400,-230400,0.0,242304.44143830801,-242304.44143830801
7557,License to Wed,69307224,35000000,34307224,72888230.030207,36808400.392104104,36079829.63810289
7558,I Could Never Be Your Woman,9576495,24000000,-14423505,10071298.923228,25240045.983157102,-15168747.059929103
7559,Butterfly on a Wheel,0,20000000,-20000000,0.0,21033371.6526309,-21033371.6526309
7560,Reservation Road,0,0,0,0.0,0.0,0.0
7561,Michael Clayton,92991835,25000000,67991835,97796591.3107566,26291714.5657886,71504876.744968
7562,Lars and the Real Girl,11293663,12000000,-706337,11877190.5599283,12620022.9915785,-742832.4316502009
7563,Stuart: A Life Backwards,0,0,0,0.0,0.0,0.0
7564,Garfield Gets Real,0,0,0,0.0,0.0,0.0
7565,The Water Horse,103071443,45000000,58071443,108396998.369598,47325086.2184195,61071912.1511785
7566,Death Sentence,16974459,20000000,-3025541,17851505.2374672,21033371.6526309,-3181866.4151636995
7567,The Death and Life of Bobby Z,413454,22000000,-21586546,434816.582163343,23136708.817894,-22701892.23573066
7568,Blood and Chocolate,0,0,0,0.0,0.0,0.0
7569,The 11th Hour,0,0,0,0.0,0.0,0.0
7570,I Want Candy,0,0,0,0.0,0.0,0.0
7571,Return to House on Haunted Hill,0,0,0,0.0,0.0,0.0
7572,Rogue,0,0,0,0.0,0.0,0.0
7573,Black Water,0,700,-700,0.0,736.168007842082,-736.168007842082
7574,An American Crime,0,2000000,-2000000,0.0,2103337.16526309,-2103337.16526309
7575,Chapter 27,0,0,0,0.0,0.0,0.0
7576,The Lookout,5367030,16000000,-10632970,5644336.83304098,16826697.3221047,-11182360.489063721
7577,Contre-EnquÃªte,0,0,0,0.0,0.0,0.0
7578,Suburban Girl,0,0,0,0.0,0.0,0.0
7579,La hora frÃ­a,0,0,0,0.0,0.0,0.0
7580,Boogeyman 2,0,4500000,-4500000,0.0,4732508.62184195,-4732508.62184195
7581,Until Death,0,10000000,-10000000,0.0,10516685.826315401,-10516685.826315401
7582,Robot Chicken: Star Wars,0,0,0,0.0,0.0,0.0
7583,The Air I Breathe,0,0,0,0.0,0.0,0.0
7584,Timber Falls,0,2600000,-2600000,0.0,2734338.31484201,-2734338.31484201
7585,Sicko,24538513,9000000,15538513,25806383.1865957,9465017.24368391,16341365.94291179
7586,Pathfinder,30822861,45000000,-14177139,32415434.540519103,47325086.2184195,-14909651.677900396
7587,Gone Baby Gone,34619699,19000000,15619699,36408449.778460704,19981703.0699993,16426746.708461404
7588,The Savages,0,0,0,0.0,0.0,0.0
7589,Hellboy Animated: Blood and Iron,0,0,0,0.0,0.0,0.0
7590,Wind Chill,0,6000000,-6000000,0.0,6310011.49578927,-6310011.49578927
7591,Closing the Ring,0,23000000,-23000000,0.0,24188377.4005255,-24188377.4005255
7592,Young People Fucking,0,1500000,-1500000,0.0,1577502.87394731,-1577502.87394731
7593,Shelter,0,0,0,0.0,0.0,0.0
7594,Ten Inch Hero,0,0,0,0.0,0.0,0.0
7595,Walk Hard: The Dewey Cox Story,18317151,35000000,-16682849,19263572.230018,36808400.392104104,-17544828.162086103
7596,Lissi und der wilde Kaiser,0,0,0,0.0,0.0,0.0
7597,Boy A,0,0,0,0.0,0.0,0.0
7598,Meet Bill,346592,5000000,-4653408,364499.91739143204,5258342.91315773,-4893842.995766298
7599,First Born,0,0,0,0.0,0.0,0.0
7600,Manuale d'amore 2 (Capitoli successivi),0,0,0,0.0,0.0,0.0
7601,Things We Lost in the Fire,2849142,16000000,-13150858,2996353.128856,16826697.3221047,-13830344.1932487
7602,Death Defying Acts,3561,20000000,-19996439,3744.9918227509297,21033371.6526309,-21029626.66080815
7603,WÎ”Z,0,0,0,0.0,0.0,0.0
7604,The Babysitters,44852,0,44852,47169.4392681901,0.0,47169.4392681901
7605,Married Life,0,12000000,-12000000,0.0,12620022.9915785,-12620022.9915785
7606,Firehouse Dog,0,0,0,0.0,0.0,0.0
7607,Sleuth,0,0,0,0.0,0.0,0.0
7608,Tin Man,0,0,0,0.0,0.0,0.0
7609,Bratz,0,0,0,0.0,0.0,0.0
7610,The Last Mimzy,27297451,0,27297451,28707871.602624,0.0,28707871.602624
7611,Highlander V: The Source,0,13000000,-13000000,0.0,13671691.5742101,-13671691.5742101
7612,Reign Over Me,22222308,20000000,2222308,23370503.157161605,21033371.6526309,2337131.5045307055
7613,Love in the Time of Cholera,4607608,45000000,-40392392,4845676.57468177,47325086.2184195,-42479409.64373773
7614,Anamorph,0,0,0,0.0,0.0,0.0
7615,Redline,0,26000000,-26000000,0.0,27343383.1484202,-27343383.1484202
7616,Battle For Haditha,0,0,0,0.0,0.0,0.0
7617,I'm Not There.,4001121,20000000,-15998879,4207853.25100731,21033371.6526309,-16825518.401623588
7618,Nocturna,0,0,0,0.0,0.0,0.0
7619,Aqua Teen Hunger Force Colon Movie Film for Theaters,0,0,0,0.0,0.0,0.0
7620,Gracie,2955039,9000000,-6044961,3107721.67675094,9465017.24368391,-6357295.566932971
7621,Resurrecting the Champ,0,0,0,0.0,0.0,0.0
7622,Import/Export,0,0,0,0.0,0.0,0.0
7623,Your Friend the Rat,0,0,0,0.0,0.0,0.0
7624,Bury My Heart At Wounded Knee,0,0,0,0.0,0.0,0.0
7625,Storm Warning,0,0,0,0.0,0.0,0.0
7626,The Visitor,9234510,0,9234510,9711644.04299683,0.0,9711644.04299683
7627,Mansfield Park,0,0,0,0.0,0.0,0.0
7628,Cleaner,0,25000000,-25000000,0.0,26291714.5657886,-26291714.5657886
7629,King of California,1027699,0,1027699,1080798.75070185,0.0,1080798.75070185
7630,Earth,109000000,15000000,94000000,114631875.506838,15775028.739473099,98856846.76736489
7631,The Dukes of Hazzard: The Beginning,0,0,0,0.0,0.0,0.0
7632,Jeff Dunham: Spark of Insanity,0,0,0,0.0,0.0,0.0
7633,Silk,0,20000000,-20000000,0.0,21033371.6526309,-21033371.6526309
7634,Interview,0,0,0,0.0,0.0,0.0
7635,Flood,0,0,0,0.0,0.0,0.0
7636,How to Rob a Bank,0,0,0,0.0,0.0,0.0
7637,The Good Night,20380,15000000,-14979620,21433.0057140309,15775028.739473099,-15753595.733759068
7638,The Last Legion,25303038,67000000,-41696962,26610410.109732103,70461795.0363136,-43851384.92658149
7639,Prey,0,0,0,0.0,0.0,0.0
7640,FrontiÃ¨re(s),0,3000000,-3000000,0.0,3155005.74789463,-3155005.74789463
7641,White Noise 2: The Light,0,0,0,0.0,0.0,0.0
7642,In the Shadow of the Moon,0,2000000,-2000000,0.0,2103337.16526309,-2103337.16526309
7643,Whisper,5285197,12000000,-6714803,5558275.63791849,12620022.9915785,-7061747.353660011
7644,The Invincible Iron Man,5300000,0,5300000,5573843.48794719,0.0,5573843.48794719
7645,Babylon 5: The Lost Tales - Voices in the Dark,0,0,0,0.0,0.0,0.0
7646,The Land Before Time XIII: The Wisdom of Friends,0,0,0,0.0,0.0,0.0
7647,La HabitaciÃ³n de Fermat,0,0,0,0.0,0.0,0.0
7648,L'Auberge rouge,0,0,0,0.0,0.0,0.0
7649,The Cake Eaters,0,0,0,0.0,0.0,0.0
7650,Encounters at the End of the World,0,0,0,0.0,0.0,0.0
7651,Blonde Ambition,0,10000000,-10000000,0.0,10516685.826315401,-10516685.826315401
7652,The Pixar Story,0,0,0,0.0,0.0,0.0
7653,My Blueberry Nights,21786738,10000000,11786738,22912427.872624803,10516685.826315401,12395742.046309402
7654,You Kill Me,2426851,4000000,-1573149,2552242.95142795,4206674.33052618,-1654431.3790982296
7655,Barbie Fairytopia: Magic of the Rainbow,0,0,0,0.0,0.0,0.0
7656,Naam yi boon sik,0,0,0,0.0,0.0,0.0
7657,Youth Without Youth,0,0,0,0.0,0.0,0.0
7658,BloodRayne II: Deliverance,0,10000000,-10000000,0.0,10516685.826315401,-10516685.826315401
7659,Joe Strummer: The Future Is Unwritten,0,0,0,0.0,0.0,0.0
7660,Persuasion,0,0,0,0.0,0.0,0.0
7661,Evening,0,0,0,0.0,0.0,0.0
7662,Gabriel,0,0,0,0.0,0.0,0.0
7663,Seed,0,10000000,-10000000,0.0,10516685.826315401,-10516685.826315401
7664,Rise of the Footsoldier,0,4000000,-4000000,0.0,4206674.33052618,-4206674.33052618
7665,The Darjeeling Limited,24377151,16000000,8377151,25636683.8407651,16826697.3221047,8809986.5186604
7666,Broken English,0,2000000,-2000000,0.0,2103337.16526309,-2103337.16526309
7667,Stomp the Yard,75511123,13000000,62511123,79412675.69832629,13671691.5742101,65740984.12411619
7668,Virgin Territory,5410749,38000000,-32589251,5690314.73180505,39963406.139998704,-34273091.408193655
7669,Die FÃ¤lscher,0,0,0,0.0,0.0,0.0
7670,Hallam Foe,60641,8000000,-7939359,63774.2345193595,8413348.66105236,-8349574.426533
7671,Boarding Gate,0,0,0,0.0,0.0,0.0
7672,Sex and Death 101,0,0,0,0.0,0.0,0.0
7673,Gruz 200,121129,0,121129,127387.563745576,0.0,127387.563745576
7674,Pigs,0,0,0,0.0,0.0,0.0
7675,Dead Silence,22217407,20000000,2217407,23365348.929438103,21033371.6526309,2331977.276807204
7676,Postal,0,0,0,0.0,0.0,0.0
7677,Welcome,36500000,0,36500000,38385903.2660514,0.0,38385903.2660514
7678,Botched,0,0,0,0.0,0.0,0.0
7679,Une vieille maÃ®tresse,0,6500000,-6500000,0.0,6835845.78710505,-6835845.78710505
7680,Superman: Doomsday,0,3500000,-3500000,0.0,3680840.03921041,-3680840.03921041
7681,Joshua,719968,0,719968,757167.726100069,0.0,757167.726100069
7682,The Girl in the Park,0,0,0,0.0,0.0,0.0
7683,Savage Grace,0,4600000,-4600000,0.0,4837675.48010511,-4837675.48010511
7684,Perfect Creature,0,0,0,0.0,0.0,0.0
7685,The Signal,249905,50000,199905,262817.23714253603,52583.42913157731,210233.80801095872
7686,Barbie as the Island Princess,0,0,0,0.0,0.0,0.0
7687,Outpost,0,0,0,0.0,0.0,0.0
7688,The Contractor,0,0,0,0.0,0.0,0.0
7689,Cougar Club,0,0,0,0.0,0.0,0.0
7690,Nancy Drew,0,0,0,0.0,0.0,0.0
7691,Lake Placid 2,0,0,0,0.0,0.0,0.0
7692,St. Trinian's,0,0,0,0.0,0.0,0.0
7693,After Sex,0,825000,-825000,0.0,867626.580671025,-867626.580671025
7694,Delta Farce,0,12,-12,0.0,12.6200229915785,-12.6200229915785
7695,The Ten,0,0,0,0.0,0.0,0.0
7696,Rise: Blood Hunter,0,0,0,0.0,0.0,0.0
7697,Battle in Seattle,908847,8000000,-7091153,955805.836318932,8413348.66105236,-7457542.824733427
7698,Teeth,0,0,0,0.0,0.0,0.0
7699,The Comebacks,0,15000000,-15000000,0.0,15775028.739473099,-15775028.739473099
7700,Pars vite et reviens tard,0,0,0,0.0,0.0,0.0
7701,Smiley Face,8768,0,8768,9221.030132513391,0.0,9221.030132513391
7702,Stuck,0,5000000,-5000000,0.0,5258342.91315773,-5258342.91315773
7703,The Poughkeepsie Tapes,0,0,0,0.0,0.0,0.0
7704,Trade,0,12000000,-12000000,0.0,12620022.9915785,-12620022.9915785
7705,Helvetica,0,0,0,0.0,0.0,0.0
7706,Boy Culture,220151,500000,-279849,231525.890134917,525834.2913157729,-294308.40118085593
7707,Son of Rambow,6870249,4000000,2870249,7225225.02815579,4206674.33052618,3018550.69762961
7708,I Think I Love My Wife,13196245,11000000,2196245,13878076.2752086,11568354.408947,2309721.8662615996
7709,Gekijouban Clannad,0,0,0,0.0,0.0,0.0
7710,Arn: Tempelriddaren,0,25000000,-25000000,0.0,26291714.5657886,-26291714.5657886
7711,The King of Kong,0,0,0,0.0,0.0,0.0
7712,Louis C.K.: Shameless,0,0,0,0.0,0.0,0.0
7713,MoliÃ¨re,0,0,0,0.0,0.0,0.0
7714,December Boys,46474,4000000,-3953526,48875.2457092184,4206674.33052618,-4157799.084816961
7715,Kickin' It Old Skool,0,0,0,0.0,0.0,0.0
7716,Creepshow 3,0,0,0,0.0,0.0,0.0
7717,Hannibal Rising,82169884,50000000,32169884,86415485.4412785,52583429.1315773,33832056.309701204
7718,Taxi to the Dark Side,274661,1000000,-725339,288852.344574163,1051668.58263154,-762816.238057377
7719,Lezioni di cioccolato,0,0,0,0.0,0.0,0.0
7720,Borderland,0,0,0,0.0,0.0,0.0
7721,Urban Justice,0,12000000,-12000000,0.0,12620022.9915785,-12620022.9915785
7722,"Chill Out, Scooby-Doo!",0,0,0,0.0,0.0,0.0
7723,Zeitgeist,0,7000000,-7000000,0.0,7361680.07842082,-7361680.07842082
7724,Straightheads,0,0,0,0.0,0.0,0.0
7725,The Brothers Solomon,0,0,0,0.0,0.0,0.0
7726,Jesse Stone: Sea Change,0,0,0,0.0,0.0,0.0
7727,The Color of Freedom,0,30000000,-30000000,0.0,31550057.478946302,-31550057.478946302
7728,Balls of Fury,41098065,0,41098065,43221543.7674491,0.0,43221543.7674491
7729,The Three Investigators and The Secret Of Skeleton Island,0,11000000,-11000000,0.0,11568354.408947,-11568354.408947
7730,Jack Brooks: Monster Slayer,0,0,0,0.0,0.0,0.0
7731,The Flock,0,0,0,0.0,0.0,0.0
7732,Murder Party,0,0,0,0.0,0.0,0.0
7733,Why Did I Get Married?,55184721,15000000,40184721,58036037.31698729,15775028.739473099,42261008.577514194
7734,Shrooms,4910682,0,4910682,5164409.97869424,0.0,5164409.97869424
7735,Catacombs,0,0,0,0.0,0.0,0.0
7736,Grace is Gone,0,0,0,0.0,0.0,0.0
7737,Hellphone,0,0,0,0.0,0.0,0.0
7738,Gabriel Iglesias: Hot and Fluffy,0,0,0,0.0,0.0,0.0
7739,Ji jie hao,34786960,16000000,18786960,36584352.91726021,16826697.3221047,19757655.595155507
7740,Fallen,0,0,0,0.0,0.0,0.0
7741,Eichmann,0,8000000,-8000000,0.0,8413348.66105236,-8413348.66105236
7742,Live!,0,0,0,0.0,0.0,0.0
7743,The Haunting Hour: Don't Think About It,0,3000000,-3000000,0.0,3155005.74789463,-3155005.74789463
7744,Oliver Twist,0,0,0,0.0,0.0,0.0
7745,The Deaths of Ian Stone,0,0,0,0.0,0.0,0.0
7746,Eagle vs Shark,0,0,0,0.0,0.0,0.0
7747,Primeval,10597734,0,10597734,11145303.894886099,0.0,11145303.894886099
7748,Eden Log,0,0,0,0.0,0.0,0.0
7749,Highlander: The Search for Vengeance,0,0,0,0.0,0.0,0.0
7750,Angel,0,15000000,-15000000,0.0,15775028.739473099,-15775028.739473099
7751,Chacun son cinema ou Ce petit coup au coeur quand la lumiere s'eteint et que le film commence,0,0,0,0.0,0.0,0.0
7752,Irina Palm,0,0,0,0.0,0.0,0.0
7753,Paranoid Park,486021,0,486021,511133.016199166,0.0,511133.016199166
7754,End of the Line,0,0,0,0.0,0.0,0.0
7755,La ragazza del lago,0,0,0,0.0,0.0,0.0
7756,La Antena,0,0,0,0.0,0.0,0.0
7757,A Dog's Breakfast,0,120000,-120000,0.0,126200.229915785,-126200.229915785
7758,The Tracey Fragments,31576,700000,-668424,33207.4871651737,736168.0078420821,-702960.5206769083
7759,Heima,0,0,0,0.0,0.0,0.0
7760,In Tranzit,0,0,0,0.0,0.0,0.0
7761,Daddy's Little Girls,31609243,10000000,21609243,33242447.7838661,10516685.826315401,22725761.957550697
7762,Jump In!,0,0,0,0.0,0.0,0.0
7763,The Beautiful Ordinary,0,0,0,0.0,0.0,0.0
7764,Talk to Me,4778376,0,4778376,5025267.91520059,0.0,5025267.91520059
7765,Hounddog,0,0,0,0.0,0.0,0.0
7766,Daniel Tosh: Completely Serious,0,0,0,0.0,0.0,0.0
7767,Doctor Who: The Runaway Bride,0,0,0,0.0,0.0,0.0
7768,Enfin veuve,0,0,0,0.0,0.0,0.0
7769,Futurama: Bender's Big Score,0,0,0,0.0,0.0,0.0
7770,Sublime,0,0,0,0.0,0.0,0.0
7771,Les Deux mondes,0,0,0,0.0,0.0,0.0
7772,Transmorphers,0,0,0,0.0,0.0,0.0
7773,The Secret Life of Brian,0,0,0,0.0,0.0,0.0
7774,Super High Me,0,0,0,0.0,0.0,0.0
7775,The Mad,0,0,0,0.0,0.0,0.0
7776,My Name Is Bruce,173066,1500000,-1326934,182008.07492171103,1577502.87394731,-1395494.799025599
7777,September Dawn,0,11000000,-11000000,0.0,11568354.408947,-11568354.408947
7778,Full of It,0,0,0,0.0,0.0,0.0
7779,Flight of the Living Dead: Outbreak on a Plane,0,0,0,0.0,0.0,0.0
7780,Jacquou Le Croquant,0,0,0,0.0,0.0,0.0
7781,In Search of a Midnight Kiss,0,25000,-25000,0.0,26291.7145657886,-26291.7145657886
7782,The Go-Getter,0,0,0,0.0,0.0,0.0
7783,This Christmas,0,13000000,-13000000,0.0,13671691.5742101,-13671691.5742101
7784,Return of the Ghostbusters,0,0,0,0.0,0.0,0.0
7785,Reno 911!: Miami,20342161,10000000,10342161,21393211.6265327,10516685.826315401,10876525.800217299
7786,Ballet Shoes,0,0,0,0.0,0.0,0.0
7787,Johnny Kapahala - Back on Board,0,0,0,0.0,0.0,0.0
7788,Shotgun Stories,0,0,0,0.0,0.0,0.0
7789,Joy Division,0,0,0,0.0,0.0,0.0
7790,Steak,0,0,0,0.0,0.0,0.0
7791,Validation,0,0,0,0.0,0.0,0.0
7792,I'm Reed Fish,0,0,0,0.0,0.0,0.0
7793,The Gene Generation,0,2500000,-2500000,0.0,2629171.45657886,-2629171.45657886
7794,It's a Free World...,0,0,0,0.0,0.0,0.0
7795,Holiday in Handcuffs,0,0,0,0.0,0.0,0.0
7796,How to Hook Up Your Home Theater,0,0,0,0.0,0.0,0.0
7797,Code Name: The Cleaner,10337477,20000000,-9662523,10871599.7845762,21033371.6526309,-10161771.8680547
7798,Zach Galifianakis: Live at the Purple Onion,0,0,0,0.0,0.0,0.0
7799,They Wait,0,0,0,0.0,0.0,0.0
7800,Michou d'Auber,0,0,0,0.0,0.0,0.0
7801,Heyy Babyy,12000000,0,12000000,12620022.9915785,0.0,12620022.9915785
7802,He Was a Quiet Man,0,0,0,0.0,0.0,0.0
7803,On the Doll,0,0,0,0.0,0.0,0.0
7804,Brand Upon the Brain! A Remembrance in 12 Chapters,0,0,0,0.0,0.0,0.0
7805,Magicians,1752038,0,1752038,1842563.3201766002,0.0,1842563.3201766002
7806,Le prix Ã  payer,0,0,0,0.0,0.0,0.0
7807,Steel Trap,0,0,0,0.0,0.0,0.0
7808,Partner,1030375,441892,588483,1083613.01582897,464723.93331621896,618889.082512751
7809,Fallen: The Destiny,0,0,0,0.0,0.0,0.0
7810,Margot at the Wedding,0,10000000,-10000000,0.0,10516685.826315401,-10516685.826315401
7811,Namastey London,0,0,0,0.0,0.0,0.0
7812,Buried Alive,0,0,0,0.0,0.0,0.0
7813,Loose Change: Final Cut,6000,6000,0,6310.01149578927,6310.01149578927,0.0
7814,Transformers: Beginnings,0,0,0,0.0,0.0,0.0
7815,Ho Voglia Di Te,0,0,0,0.0,0.0,0.0
7816,Rocket Science,0,0,0,0.0,0.0,0.0
7817,Bring It On: In It To Win It,0,0,0,0.0,0.0,0.0
7818,Twitches Too,0,0,0,0.0,0.0,0.0
7819,No End in Sight,1431623,2000000,-568377,1505592.93127272,2103337.16526309,-597744.2339903698
7820,Beneath,0,0,0,0.0,0.0,0.0
7821,Testosteron,0,1100000,-1100000,0.0,1156835.4408947,-1156835.4408947
7822,The Union: The Business Behind Getting High,0,200000,-200000,0.0,210333.71652630897,-210333.71652630897
7823,Ce soir je dors chez toi,0,0,0,0.0,0.0,0.0
7824,For the Bible Tells Me So,312751,0,312751,328910.400886598,0.0,328910.400886598
7825,Alien,104931801,11000000,93931801,315273262.68425,33050094.027517498,282223168.6567325
7826,Apocalypse Now,83471511,31500000,51971511,250794662.469905,94643451.0788001,156151211.39110488
7827,Mad Max,100000000,400000,99600000,300455400.25015897,1201821.60100063,299253578.64915836
7828,Star Trek: The Motion Picture,139000000,35000000,104000000,417633006.347721,105159390.087555,312473616.260166
7829,Moonraker,210300000,34000000,176300000,631857706.726084,102154836.08505401,529702870.64102995
7830,Life of Brian,20045115,4000000,16045115,60226630.5038547,12018216.010006301,48208414.4938484
7831,Beneath the Valley of the Ultra-Vixens,0,239000,-239000,0.0,718088.40659788,-718088.40659788
7832,The Warriors,22490039,0,22490039,67572536.6938669,0.0,67572536.6938669
7833,Rocky II,200182160,7000000,193182160,601458110.0574139,21031878.017511103,580426232.0399028
7834,Caligola,23438120,17500000,5938120,70421097.25711259,52579695.04377779,17841402.2133348
7835,Manhattan,39946780,0,39946780,120022257.73605,0.0,120022257.73605
7836,Phantasm,11988469,300000,11688469,36020002.51781621,901366.200750477,35118636.31706573
7837,Hair,0,11000000,-11000000,0.0,33050094.027517498,-33050094.027517498
7838,The Amityville Horror,86432000,0,86432000,259689611.544217,0.0,259689611.544217
7839,Escape from Alcatraz,43000000,8000000,35000000,129195822.107568,24036432.0200127,105159390.08755529
7840,All That Jazz,37823676,0,37823676,113643277.115123,0.0,113643277.115123
7841,Nosferatu: Phantom der Nacht,0,0,0,0.0,0.0,0.0
7842,The Black Hole,35841901,20000000,15841901,107688927.106815,60091080.050031796,47597847.0567832
7843,Being There,30177511,0,30177511,90669961.46058579,0.0,90669961.46058579
7844,Meatballs,0,0,0,0.0,0.0,0.0
7845,The Villain,0,0,0,0.0,0.0,0.0
7846,Salem's Lot,0,4000000,-4000000,0.0,12018216.010006301,-12018216.010006301
7847,The Concorde... Airport '79,13015688,14000000,-984312,39106337.4757119,42063756.03502221,-2957418.5593103096
7848,Kramer vs. Kramer,106260000,8000000,98260000,319263908.305819,24036432.0200127,295227476.2858063
7849,The China Syndrome,51718367,0,51718367,155390626.572696,0.0,155390626.572696
7850,The Jerk,73961419,0,73961419,222221077.48714703,0.0,222221077.48714703
7851,1941,31755742,35000000,-3244258,95411841.7285079,105159390.087555,-9747548.3590471
7852,...And Justice for All,33300000,0,33300000,100051648.28330301,0.0,100051648.28330301
7853,Time After Time,0,0,0,0.0,0.0,0.0
7854,Breaking Away,20000000,2300000,17700000,60091080.050031796,6910474.20575366,53180605.844278134
7855,Quadrophenia,0,0,0,0.0,0.0,0.0
7856,Tess,0,0,0,0.0,0.0,0.0
7857,The Frisco Kid,0,0,0,0.0,0.0,0.0
7858,The First Great Train Robbery,0,6000000,-6000000,0.0,18027324.0150095,-18027324.0150095
7859,10,0,0,0,0.0,0.0,0.0
7860,The Black Stallion,37799643,2700000,35099643,113571068.66878101,8112295.80675429,105458772.86202672
7861,The Electric Horseman,61801971,0,61801971,185687359.33053702,0.0,185687359.33053702
7862,The Bugs Bunny/Road Runner Movie,0,0,0,0.0,0.0,0.0
7863,All Quiet on the Western Front,0,0,0,0.0,0.0,0.0
7864,The Apple Dumpling Gang Rides Again,0,0,0,0.0,0.0,0.0
7865,Meteor,0,0,0,0.0,0.0,0.0
7866,Scum,0,420000,-420000,0.0,1261912.68105066,-1261912.68105066
7867,Hardcore,0,0,0,0.0,0.0,0.0
7868,Hanover Street,0,0,0,0.0,0.0,0.0
7869,Love at First Bite,43885000,0,43885000,131854852.399782,0.0,131854852.399782
7870,The Brood,0,1355000,-1355000,0.0,4071170.67338965,-4071170.67338965
7871,Stridulum,0,800000,-800000,0.0,2403643.20200127,-2403643.20200127
7872,Richard Pryor: Live in Concert,0,0,0,0.0,0.0,0.0
7873,When a Stranger Calls,0,0,0,0.0,0.0,0.0
7874,The Onion Field,0,0,0,0.0,0.0,0.0
7875,The Wanderers,0,0,0,0.0,0.0,0.0
7876,Over the Edge,0,0,0,0.0,0.0,0.0
7877,Tourist Trap,0,0,0,0.0,0.0,0.0
7878,Rock 'n' Roll High School,0,300000,-300000,0.0,901366.200750477,-901366.200750477
7879,Norma Rae,22228000,0,22228000,66785226.3676053,0.0,66785226.3676053
7880,Dracula,0,0,0,0.0,0.0,0.0
7881,The Champ,0,0,0,0.0,0.0,0.0
7882,The Terminator,78371200,6400000,71971200,164504443.46209198,13433869.050842501,151070574.4112495
7883,Indiana Jones and the Temple of Doom,333000000,28000000,305000000,698980999.051652,58773177.097436205,640207821.9542158
7884,Ghostbusters,295212467,30000000,265212467,619663378.727216,62971261.1758245,556692117.5513915
7885,Gremlins,153083102,11000000,142083102,321327866.588246,23089462.431135602,298238404.1571104
7886,The Neverending Story,20158808,27000000,-6841192,42314185.4520434,56674135.058242105,-14359949.606198706
7887,Beverly Hills Cop,316360478,15000000,301360478,664053942.8615559,31485630.587912202,632568312.2736437
7888,Once Upon a Time in America,0,30000000,-30000000,0.0,62971261.1758245,-62971261.1758245
7889,Amadeus,51973029,18000000,33973029,109093572.77525601,37782756.7054947,71310816.0697613
7890,The Karate Kid,90815558,8000000,82815558,190625674.054874,16792336.3135532,173833337.7413208
7891,A Nightmare on Elm Street,25504513,1800000,23704513,53535044.97617371,3778275.67054947,49756769.30562424
7892,Conan the Destroyer,31042035,18000000,13042035,65158536.44713621,37782756.7054947,27375779.741641507
7893,2010,40400657,28000000,12400657,84802677.4540635,58773177.097436205,26029500.3566273
7894,Dune,30925690,40000000,-9074310,64914323.401086204,83961681.56776609,-19047358.16667988
7895,Romancing the Stone,86572238,10000000,76572238,181718766.989121,20990420.391941503,160728346.59717947
7896,Police Academy,81198894,4500000,76698894,170439892.042069,9445689.17637368,160994202.8656953
7897,Red Dawn,38376497,0,38376497,80553880.5200082,0.0,80553880.5200082
7898,Star Trek III: The Search for Spock,87000000,18000000,69000000,182616657.40989098,37782756.7054947,144833900.70439628
7899,Moscow on the Hudson,25100000,0,25100000,52685955.183773205,0.0,52685955.183773205
7900,Footloose,80035402,8200000,71835402,167997673.421803,17212144.721392002,150785528.700411
7901,Friday the 13th: The Final Chapter,32,0,32,67.1693452542128,0.0,67.1693452542128
7902,Repo Man,2300000,1500000,800000,4827796.69014655,3148563.05879122,1679233.6313553294
7903,Nineteen Eighty-Four,0,0,0,0.0,0.0,0.0
7904,Supergirl,0,35000000,-35000000,0.0,73466471.3717953,-73466471.3717953
7905,The Adventures of AndrÃ© and Wally B.,0,0,0,0.0,0.0,0.0
7906,Starman,28744356,22000000,6744356,60335611.633562595,46178924.862271294,14156686.7712913
7907,Bachelor Party,38435947,6000000,32435947,80678668.56923829,12594252.2351649,68084416.3340734
7908,This Is Spinal Tap,4736202,0,4736202,9941487.10411542,0.0,9941487.10411542
7909,Tightrope,48143579,0,48143579,101055396.238264,0.0,101055396.238264
7910,Cheech & Chong's The Corsican Brothers,0,0,0,0.0,0.0,0.0
7911,Sixteen Candles,23686027,6500000,17186027,49717966.414487705,13643773.2547619,36074193.1597258
7912,The Killing Fields,34700291,14400000,20300291,72837369.5812705,30226205.364395697,42611164.21687481
7913,Night of the Comet,14418922,3000000,11418922,30265923.4378614,6297126.11758245,23968797.32027895
7914,The Woman in Red,0,25300000,-25300000,0.0,53105763.591612,-53105763.591612
7915,The Ewok Adventure,0,0,0,0.0,0.0,0.0
7916,The Last Starfighter,28733290,15000000,13733290,60312383.63435689,31485630.587912202,28826753.04644469
7917,A Christmas Carol,0,0,0,0.0,0.0,0.0
7918,Sheena,5778353,25000000,-19221647,12129005.8643036,52476050.979853794,-40347045.11555019
7919,Blood Simple,0,1500000,-1500000,0.0,3148563.05879122,-3148563.05879122
7920,Splash,69821334,8000000,61821334,146557915.298616,16792336.3135532,129765578.9850628
7921,"Paris, Texas",2181987,1746964,435023,4580082.44197513,3666950.87695877,913131.5650163596
7922,Body Double,8801940,10000000,-1198060,18475642.0864645,20990420.391941503,-2514778.3054770045
7923,The Adventures of Buckaroo Banzai Across the 8th Dimension,0,0,0,0.0,0.0,0.0
7924,City Heat,38348988,25000000,13348988,80496137.972552,52476050.979853794,28020086.992698207
7925,Dreamscape,12145169,0,12145169,25493220.3041176,0.0,25493220.3041176
7926,The Bounty,0,8600000,-8600000,0.0,18051761.5370697,-18051761.5370697
7927,The Cotton Club,25928721,58000000,-32071279,54425475.401536204,121744438.27326001,-67318962.8717238
7928,Trancers,0,0,0,0.0,0.0,0.0
7929,The Muppets Take Manhattan,0,8000000,-8000000,0.0,16792336.3135532,-16792336.3135532
7930,Top Secret!,20458340,9000000,11458340,42942915.7121273,18891378.352747303,24051537.359379996
7931,Against All Odds,0,0,0,0.0,0.0,0.0
7932,Blame It on Rio,0,0,0,0.0,0.0,0.0
7933,Stranger Than Paradise,0,0,0,0.0,0.0,0.0
7934,"Greystoke: The Legend of Tarzan, Lord of the Apes",45858563,0,45858563,96259051.5940335,0.0,96259051.5940335
7935,Birdy,0,0,0,0.0,0.0,0.0
7936,Purple Rain,68392977,7200000,61192977,143559733.908638,15113102.6821978,128446631.2264402
7937,Falling in Love,11129057,0,11129057,23360358.4995879,0.0,23360358.4995879
7938,Missing in Action,22812411,2550000,20262411,47884209.7043751,5352557.19994508,42531652.504430026
7939,All of Me,0,0,0,0.0,0.0,0.0
7940,The Natural,47951979,28000000,19951979,100653219.783555,58773177.097436205,41880042.6861188
7941,Revenge of the Nerds,0,0,0,0.0,0.0,0.0
7942,Children of the Corn,14000000,800000,13200000,29386588.548718102,1679233.63135532,27707354.917362783
7943,Frankenweenie,0,0,0,0.0,0.0,0.0
7944,The Toxic Avenger,0,0,0,0.0,0.0,0.0
7945,The Hills Have Eyes Part II,0,700000,-700000,0.0,1469329.4274358999,-1469329.4274358999
7946,A Passage to India,27187653,8000000,19187653,57068026.594023,16792336.3135532,40275690.2804698
7947,Streets of Fire,8089290,14500000,-6410710,16979759.7772328,30436109.568315197,-13456349.791082397
7948,Stop Making Sense,4978922,1200000,3778922,10450966.5878686,2518850.44703298,7932116.140835619
7949,Savage Streets,0,0,0,0.0,0.0,0.0
7950,Cloak & Dagger,0,0,0,0.0,0.0,0.0
7951,Johnny Dangerously,0,0,0,0.0,0.0,0.0
7952,Cannonball Run II,28078073,0,28078073,58937055.606562205,0.0,58937055.606562205
7953,Breakin',0,0,0,0.0,0.0,0.0
7954,Rhinestone,0,28000000,-28000000,0.0,58773177.097436205,-58773177.097436205
7955,Crimes of Passion,0,0,0,0.0,0.0,0.0
7956,Breakin' 2: Electric Boogaloo,0,0,0,0.0,0.0,0.0
7957,"Silent Night, Deadly Night",0,1065000,-1065000,0.0,2235479.77174177,-2235479.77174177
7958,Suburbia,0,0,0,0.0,0.0,0.0
7959,Hot Dog... The Movie,0,0,0,0.0,0.0,0.0
7960,The Philadelphia Experiment,0,0,0,0.0,0.0,0.0
7961,Tank,14134877,0,14134877,29669701.0418385,0.0,29669701.0418385
7962,A Soldier's Story,0,0,0,0.0,0.0,0.0
7963,Firestarter,0,0,0,0.0,0.0,0.0
7964,Threads,0,0,0,0.0,0.0,0.0
7965,Bolero,0,7000000,-7000000,0.0,14693294.274358999,-14693294.274358999
7966,Rats - Notte di terrore,0,0,0,0.0,0.0,0.0
7967,Runaway,0,0,0,0.0,0.0,0.0
7968,C.H.U.D.,3412497,1250000,2162497,7162974.66162392,2623802.54899269,4539172.11263123
7969,Ghoulies,35000000,1000000,34000000,73466471.3717953,2099042.03919415,71367429.33260114
7970,Places in the Heart,0,0,0,0.0,0.0,0.0
7971,Best Defense,19265302,18000000,1265302,40438678.7957711,37782756.7054947,2655922.0902763978
7972,The Pope of Greenwich Village,0,0,0,0.0,0.0,0.0
7973,Airwolf: The Movie,0,0,0,0.0,0.0,0.0
7974,The Ice Pirates,0,9000000,-9000000,0.0,18891378.352747303,-18891378.352747303
7975,Razorback,801000,5500000,-4699000,1681332.67339451,11544731.215567801,-9863398.54217329
7976,The Lonely Guy,0,0,0,0.0,0.0,0.0
7977,Forbrydelsens element,0,0,0,0.0,0.0,0.0
7978,Broadway Danny Rose,10600497,8000000,2600497,22250888.839351397,16792336.3135532,5458552.525798198
7979,Gwendoline,1337274,0,1337274,2806994.34392132,0.0,2806994.34392132
7980,Ninja III: The Domination,0,0,0,0.0,0.0,0.0
7981,The Times of Harvey Milk,0,0,0,0.0,0.0,0.0
7982,Beat Street,0,0,0,0.0,0.0,0.0
7983,Electric Dreams,0,0,0,0.0,0.0,0.0
7984,The Hit,0,0,0,0.0,0.0,0.0
7985,Under the Volcano,0,0,0,0.0,0.0,0.0
7986,The Company of Wolves,0,2000000,-2000000,0.0,4198084.0783883,-4198084.0783883
7987,Return of the Jedi,572700000,32350000,540350000,1253818981.11608,70824243.1274759,1182994737.988604
7988,Scarface,65884703,25000000,40884703,144242170.746632,54732799.9439536,89509370.8026784
7989,Never Say Never Again,160000000,36000000,124000000,350289919.641303,78815231.9192932,271474687.7220098
7990,Octopussy,183700000,27500000,156200000,402176613.988171,60206079.938348904,341970534.0498221
7991,A Christmas Story,19294144,0,19294144,42240900.945673294,0.0,42240900.945673294
7992,Superman III,75800000,39000000,36800000,165949849.430067,85383167.91256759,80566681.51749942
7993,Trading Places,90400000,40600000,49800000,197913804.59733602,88886067.1089806,109027737.48835543
7994,WarGames,79567667,12000000,67567667,174198447.996724,26271743.9730977,147926704.0236263
7995,National Lampoon's Vacation,61399552,15000000,46399552,134422775.850575,32839679.966372102,101583095.8842029
7996,Jaws 3,87987055,20500000,67487055,192631115.158905,44880895.9540419,147750219.2048631
7997,The Meaning of Life,0,0,0,0.0,0.0,0.0
7998,Terms of Endearment,0,8000000,-8000000,0.0,17514495.9820651,-17514495.9820651
7999,Private School,0,0,0,0.0,0.0,0.0
8000,Sudden Impact,67642693,22000000,45642693,148090959.34557,48164863.9506791,99926095.3948909
8001,Risky Business,63541777,6200000,57341777,139112774.744972,13573734.3861004,125539040.3588716
8002,The Right Stuff,21500000,27000000,-5500000,47070207.9518001,59111423.9394698,-12041215.987669699
8003,Breathless,19910002,0,19910002,43589206.2539886,0.0,43589206.2539886
8004,Yellowbeard,4300000,0,4300000,9414041.59036002,0.0,9414041.59036002
8005,Mickey's Christmas Carol,21000000,3000000,18000000,45975551.952921,6567935.99327443,39407615.959646575
8006,Still Smokin,15543000,0,15543000,34028476.381154805,0.0,34028476.381154805
8007,The Hunger,5979292,0,5979292,13090535.7136992,0.0,13090535.7136992
8008,Christine,21200000,0,21200000,46413414.3524726,0.0,46413414.3524726
8009,The Outsiders,25697647,10000000,15697647,56260166.8912535,21893119.9775814,34367046.913672104
8010,Porky's II: The Next Day,33759266,6500000,27259266,73909566.08930859,14230527.9854279,59679038.10388069
8011,Under Fire,0,0,0,0.0,0.0,0.0
8012,The Man with Two Brains,0,10100000,-10100000,0.0,22112051.1773572,-22112051.1773572
8013,The Day After,0,0,0,0.0,0.0,0.0
8014,Cujo,0,5000000,-5000000,0.0,10946559.9887907,-10946559.9887907
8015,Yentl,30400000,12000000,18400000,66555084.731847495,26271743.9730977,40283340.7587498
8016,Blue Thunder,42313354,22000000,20313354,92637133.5775875,48164863.9506791,44472269.6269084
8017,The Dead Zone,20766616,10000000,10766616,45464601.56163621,21893119.9775814,23571481.58405481
8018,Valley Girl,0,350000,-350000,0.0,766259.19921535,-766259.19921535
8019,All the Right Moves,17233166,0,17233166,37728777.0831577,0.0,37728777.0831577
8020,Zelig,11798616,0,11798616,25830851.5657412,0.0,25830851.5657412
8021,Gorky Park,16175602,0,16175602,35413439.5295606,0.0,35413439.5295606
8022,Screwballs,0,0,0,0.0,0.0,0.0
8023,Flashdance,92921203,4000000,88921203,203433504.57402,8757247.99103257,194676256.58298743
8024,Silkwood,0,0,0,0.0,0.0,0.0
8025,Curse of the Pink Panther,4491986,0,4491986,9834358.84356161,0.0,9834358.84356161
8026,Smokey and the Bandit Part 3,5678950,0,5678950,12432993.3696686,0.0,12432993.3696686
8027,Amityville 3-D,6333135,0,6333135,13865208.438922001,0.0,13865208.438922001
8028,Twilight Zone: The Movie,29450919,10000000,19450919,64477250.3117032,21893119.9775814,42584130.33412179
8029,To Be or Not to Be,13030214,0,13030214,28527203.843556102,0.0,28527203.843556102
8030,Educating Rita,0,0,0,0.0,0.0,0.0
8031,Krull,0,27,-27,0.0,59.1114239394699,-59.1114239394699
8032,Rumble Fish,2494480,10000000,-7505520,5461194.99216773,21893119.9775814,-16431924.98541367
8033,Staying Alive,64892670,22000000,42892670,142070300.99756002,48164863.9506791,93905437.04688093
8034,Lone Wolf McQuade,12232628,5000000,7232628,26781039.244512197,10946559.9887907,15834479.255721496
8035,The Big Chill,0,0,0,0.0,0.0,0.0
8036,Psycho II,34725000,5000000,29725000,76023859.1221515,10946559.9887907,65077299.133360796
8037,Losin' It,0,0,0,0.0,0.0,0.0
8038,V,0,0,0,0.0,0.0,0.0
8039,Videodrome,2120439,5952000,-3831561,4642302.54321428,13030785.010656402,-8388482.467442121
8040,Two of a Kind,23646952,0,23646952,51770555.7240109,0.0,51770555.7240109
8041,The Osterman Weekend,6486797,0,6486797,14201622.4991215,0.0,14201622.4991215
8042,Deathstalker,8890685,0,8890685,19464483.3387883,0.0,19464483.3387883
8043,Michael Jackson's Thriller,0,1100000,-1100000,0.0,2408243.19753395,-2408243.19753395
8044,Local Hero,0,0,0,0.0,0.0,0.0
8045,Never Cry Wolf,0,0,0,0.0,0.0,0.0
8046,Fire and Ice,760883,1200000,-439117,1665810.28079021,2627174.39730977,-961364.1165195599
8047,Rock & Rule,0,8000000,-8000000,0.0,17514495.9820651,-17514495.9820651
8048,The Star Chamber,0,0,0,0.0,0.0,0.0
8049,Bad Boys,9190819,0,9190819,20121570.3059235,0.0,20121570.3059235
8050,Brainstorm,10219460,15000000,-4780540,22373586.3886094,32839679.966372102,-10466093.577762704
8051,Class,0,0,0,0.0,0.0,0.0
8052,Strange Brew,0,0,0,0.0,0.0,0.0
8053,Acqua e sapone,0,0,0,0.0,0.0,0.0
8054,The Keep,3661757,6000000,-2338243,8016728.53297487,13135871.9865488,-5119143.45357393
8055,Eddie and the Cruisers,4685097,0,4685097,10257139.0727606,0.0,10257139.0727606
8056,Mr. Mom,64783827,0,64783827,141832009.711788,0.0,141832009.711788
8057,BMX Bandits,0,980385,-980385,0.0,2146368.64292211,-2146368.64292211
8058,Something Wicked This Way Comes,5656087,19000000,-13343913,12382939.1294638,41596927.9574047,-29213988.827940904
8059,Sleepaway Camp,0,350000,-350000,0.0,766259.19921535,-766259.19921535
8060,Meantime,0,0,0,0.0,0.0,0.0
8061,The House on Sorority Row,10604986,425000,10179986,23217623.0858571,930457.5990472109,22287165.48680989
8062,Metalstorm: The Destruction of Jared-Syn,0,0,0,0.0,0.0,0.0
8063,Hercules,10676194,0,10676194,23373519.6145935,0.0,23373519.6145935
8064,Uncommon Valor,27900000,0,27900000,61081804.737452194,0.0,61081804.737452194
8065,Eddie Murphy: Delirious,0,0,0,0.0,0.0,0.0
8066,Spacehunter: Adventures in the Forbidden Zone,16500000,15000000,1500000,36123647.9630093,32839679.966372102,3283967.9966371953
8067,Se7en,327311859,33000000,294311859,468372425.440186,47221906.614529796,421150518.82565624
8068,Toy Story,361958736,30000000,331958736,517950958.475917,42929006.013208896,475021952.4627081
8069,The Usual Suspects,23341568,6000000,17341568,33401010.4343242,8585801.20264179,24815209.231682412
8070,Braveheart,210000000,72000000,138000000,300503042.092462,103029614.431701,197473427.660761
8071,GoldenEye,352194034,58000000,294194034,503977993.446744,82996078.29220401,420981915.15454
8072,Jumanji,262797249,65000000,197797249,376054156.085859,93012846.36195269,283041309.7239063
8073,Die Hard: With a Vengeance,366101666,90000000,276101666,523879354.03866,128787018.039626,395092335.999034
8074,Species,113000000,35000000,78000000,161699255.983087,50083840.3487438,111615415.6343432
8075,Twelve Monkeys,168840000,29500000,139340000,241604445.84234,42213522.579655394,199390923.26268458
8076,Apollo 13,355237933,52000000,303237933,508333712.06256396,74410277.08956221,433923434.9730017
8077,Bad Boys,141407024,19000000,122407024,202348766.120199,27188370.4750323,175160395.6451667
8078,Pocahontas,346079773,55000000,291079773,495228688.538899,78703177.6908831,416525510.8480159
8079,Heat,187436818,60000000,127436818,268215876.233958,85858012.02641791,182357864.2075401
8080,Before Sunrise,5535405,2500000,3035405,7920981.15101823,3577417.16776741,4343563.98325082
8081,Judge Dredd,113493481,90000000,23493481,162405410.94363302,128787018.039626,33618392.90400702
8082,Batman Forever,336529144,100000000,236529144,481562054.87986904,143096686.71069598,338465368.16917306
8083,Casino,116112375,52000000,64112375,166152961.486099,74410277.08956221,91742684.3965368
8084,Clueless,0,12000000,-12000000,0.0,17171602.4052835,-17171602.4052835
8085,Babe,254134910,30000000,224134910,363658635.98521,42929006.013208896,320729629.9720011
8086,Casper,287928194,50000000,237928194,412015705.71994597,71548343.3553482,340467362.3645978
8087,It Takes Two,0,0,0,0.0,0.0,0.0
8088,Four Rooms,4300000,4000000,300000,6153157.52855995,5723867.46842786,429290.06013209
8089,Waterworld,264218220,175000000,89218220,378087518.505979,250419201.74371898,127668316.76226002
8090,A Goofy Movie,35348597,0,35348597,50582671.1057166,0.0,50582671.1057166
8091,Ace Ventura: When Nature Calls,212385533,30000000,182385533,303916660.775853,42929006.013208896,260987654.76264408
8092,The Bridges of Madison County,182016617,24000000,158016617,260459748.18989798,34343204.8105671,226116543.37933087
8093,Leaving Las Vegas,49800000,3600000,46200000,71262149.9819269,5151480.72158507,66110669.26034183
8094,The Net,1106279658,22000000,1084279658,1583049536.3524199,31481271.0763532,1551568265.2760665
8095,A Close Shave,0,0,0,0.0,0.0,0.0
8096,Johnny Mnemonic,19075720,26000000,-6924280,27296723.286209602,37205138.544781104,-9908415.258571502
8097,Desperado,25405445,7000000,18405445,36354350.03910829,10016768.0697487,26337581.96935959
8098,While You Were Sleeping,182057016,17000000,165057016,260517557.820362,24326436.7408184,236191121.0795436
8099,Outbreak,189859560,0,189859560,271682739.763507,0.0,271682739.763507
8100,To Die For,21284514,20000000,1284514,30457434.3164743,28619337.3421393,1838096.974335
8101,Under Siege 2: Dark Territory,104324083,60000000,44324083,149284306.214317,85858012.02641791,63426294.18789908
8102,Cutthroat Island,18517322,98000000,-79482678,26497674.2495508,140234752.976482,-113737078.7269312
8103,Mortal Kombat,122195920,18000000,104195920,174858312.815653,25757403.607925303,149100909.2077277
8104,Sense and Sensibility,135000000,16500000,118500000,193180527.05944,23610953.307264898,169569573.7521751
8105,Billy Madison,26488734,10000000,16488734,37904500.7056097,14309668.671069598,23594832.034540102
8106,Mighty Morphin Power Rangers: The Movie,66000000,15000000,51000000,94443813.22905971,21464503.006604396,72979310.22245532
8107,Get Shorty,115101622,30250000,84851622,164706607.43227,43286747.72998571,121419859.70228428
8108,Assassins,30303072,50000000,-19696928,43362692.0035568,71548343.3553482,-28185651.351791397
8109,The Quick and the Dead,18552460,32000000,-13447540,26547955.5633272,45790939.747422904,-19242984.184095703
8110,French Kiss,0,0,0,0.0,0.0,0.0
8111,The Land Before Time III: The Time of the Great Giving,0,0,0,0.0,0.0,0.0
8112,Dracula: Dead and Loving It,0,0,0,0.0,0.0,0.0
8113,Copycat,0,0,0,0.0,0.0,0.0
8114,Tank Girl,6600000,25000000,-18400000,9444381.32290597,35774171.6776741,-26329790.354768127
8115,Friday,28215918,3500000,24715918,40376043.783007,5008384.03487438,35367659.748132624
8116,Dead Man Walking,39363635,11000000,28363635,56328057.453892104,15740635.5381766,40587421.9157155
8117,Crimson Tide,157387195,53000000,104387195,225215861.351903,75841243.9566692,149374617.3952338
8118,Showgirls,20350754,45000000,-24649246,29121254.6946445,64393509.0198134,-35272254.32516891
8119,Mighty Aphrodite,6700000,15000000,-8300000,9587478.00961667,21464503.006604396,-11877024.996987727
8120,Dead Man,0,9000000,-9000000,0.0,12878701.8039626,-12878701.8039626
8121,A Walk in the Clouds,50012507,20000000,30012507,71566240.4579552,28619337.3421393,42946903.11581589
8122,Father of the Bride Part II,76578911,0,76578911,109581884.36013299,0.0,109581884.36013299
8123,Balto,0,0,0,0.0,0.0,0.0
8124,Virtuosity,24048000,30000000,-5952000,34411891.2201883,42929006.013208896,-8517114.793020599
8125,The Prophecy,16,8,8,22.8954698737114,11.4477349368557,11.4477349368557
8126,The Basketball Diaries,0,0,0,0.0,0.0,0.0
8127,Dolores Claiborne,0,0,0,0.0,0.0,0.0
8128,Money Train,35431113,60000000,-24568887,50700748.76772279,85858012.02641791,-35157263.25869512
8129,Powder,0,0,0,0.0,0.0,0.0
8130,Rob Roy,31596911,28000000,3596911,45214132.7439276,40067072.278995,5147060.464932598
8131,"To Wong Foo, Thanks for Everything! Julie Newmar",47774193,0,47774193,68363287.2857735,0.0,68363287.2857735
8132,Hackers,7563728,20000000,-12436272,10823444.1598092,28619337.3421393,-17795893.1823301
8133,Grumpier Old Men,0,0,0,0.0,0.0,0.0
8134,Nixon,13681765,44000000,-30318235,19578152.398543697,62962542.1527065,-43384389.7541628
8135,Major Payne,0,0,0,0.0,0.0,0.0
8136,First Knight,127600435,55000000,72600435,182591994.713436,78703177.6908831,103888817.02255291
8137,Boys on the Side,23450000,21000000,2450000,33556173.0336583,30050304.209246196,3505868.8244121075
8138,Halloween: The Curse of Michael Myers,15116634,5000000,10116634,21631402.3961826,7154834.33553483,14476568.06064777
8139,Fair Game,11534477,50000000,-38465523,16505454.4164073,71548343.3553482,-55042888.9389409
8140,The Langoliers,0,0,0,0.0,0.0,0.0
8141,Dead Presidents,0,10000000,-10000000,0.0,14309668.671069598,-14309668.671069598
8142,Mallrats,2,6000000,-5999998,2.86193373421393,8585801.20264179,-8585798.340708056
8143,I.D.,0,0,0,0.0,0.0,0.0
8144,The American President,107879496,62000000,45879496,154371984.416198,88719945.7606318,65652038.655566186
8145,A Little Princess,0,17000000,-17000000,0.0,24326436.7408184,-24326436.7408184
8146,Canadian Bacon,178104,11000000,-10821896,254860.92289921897,15740635.5381766,-15485774.615277382
8147,Sabrina,0,58000000,-58000000,0.0,82996078.29220401,-82996078.29220401
8148,Strange Days,7959291,42000000,-34040709,11389481.706662599,60100608.4184925,-48711126.7118299
8149,Living in Oblivion,1148752,500000,648752,1643826.05052286,715483.433553482,928342.6169693779
8150,Just Cause,0,0,0,0.0,0.0,0.0
8151,Fluke,0,0,0,0.0,0.0,0.0
8152,Nick of Time,8175346,8169363,5983,11698649.2531354,11690087.778369501,8561.47476589866
8153,Nine Months,69660733,0,69660733,99682200.86138481,0.0,99682200.86138481
8154,Smoke,8349430,7000000,1349430,11947757.6892289,10016768.0697487,1930989.6194802
8155,Tommy Boy,32648673,0,32648673,46719169.318009704,0.0,46719169.318009704
8156,Othello,0,0,0,0.0,0.0,0.0
8157,Total Eclipse,339889,0,339889,486369.897494119,0.0,486369.897494119
8158,Bushwhacked,0,0,0,0.0,0.0,0.0
8159,Heavyweights,17689177,0,17689177,25312626.1933905,0.0,25312626.1933905
8160,Screamers,5781885,20000000,-14218115,8273685.86442275,28619337.3421393,-20345651.47771655
8161,Senior Trip,0,0,0,0.0,0.0,0.0
8162,Something to Talk About,50892160,0,50892160,72824994.75550641,0.0,72824994.75550641
8163,The Brady Bunch Movie,0,0,0,0.0,0.0,0.0
8164,Kids,7412216,1500000,5912216,10606635.5078401,2146450.30066044,8460185.20717966
8165,Losing Isaiah,7603766,17000000,-9396234,10880737.2112344,24326436.7408184,-13445699.529584
8166,Free Willy 2 - The Adventure Home,0,0,0,0.0,0.0,0.0
8167,A Kid in King Arthur's Court,0,0,0,0.0,0.0,0.0
8168,Empire Records,0,0,0,0.0,0.0,0.0
8169,The Englishman Who Went Up a Hill But Came Down a Mountain,0,0,0,0.0,0.0,0.0
8170,Jade,9851610,50000000,-40148390,14097327.497659601,71548343.3553482,-57451015.8576886
8171,Murder in the First,17381942,0,17381942,24872983.0879749,0.0,24872983.0879749
8172,Crying Freeman,0,6100000,-6100000,0.0,8728897.88935249,-8728897.88935249
8173,Pride and Prejudice,0,0,0,0.0,0.0,0.0
8174,The Cure,0,0,0,0.0,0.0,0.0
8175,Tales from the Crypt: Demon Knight,0,0,0,0.0,0.0,0.0
8176,Richard III,0,0,0,0.0,0.0,0.0
8177,Village of the Damned,0,0,0,0.0,0.0,0.0
8178,Vampire in Brooklyn,19800000,14000000,5800000,28333143.968717895,20033536.1394975,8299607.829220396
8179,Sudden Death,64350171,35000000,29350171,92082962.5936675,50083840.3487438,41999122.24492371
8180,Castle Freak,0,0,0,0.0,0.0,0.0
8181,Things to Do in Denver When You're Dead,529766,8000000,-7470234,758077.593319788,11447734.9368557,-10689657.343535911
8182,Lord of Illusions,0,0,0,0.0,0.0,0.0
8183,Candyman: Farewell to the Flesh,13940383,0,13940383,19948226.1877812,0.0,19948226.1877812
8184,Kiss of Death,0,40000000,-40000000,0.0,57238674.6842786,-57238674.6842786
8185,Circle of Friends,0,0,0,0.0,0.0,0.0
8186,Mad Love,15453274,0,15453274,22113123.0823255,0.0,22113123.0823255
8187,Children of the Corn III: Urban Harvest,0,0,0,0.0,0.0,0.0
8188,Congo,152000000,50000000,102000000,217506963.800258,71548343.3553482,145958620.4449098
8189,The Mangler,0,0,0,0.0,0.0,0.0
8190,Safe,0,0,0,0.0,0.0,0.0
8191,Les Trois FrÃ¨res,0,7500000,-7500000,0.0,10732251.503302198,-10732251.503302198
8192,Welcome to the Dollhouse,0,0,0,0.0,0.0,0.0
8193,Home for the Holidays,17519169,0,17519169,25069350.3782474,0.0,25069350.3782474
8194,The Tuskegee Airmen,0,0,0,0.0,0.0,0.0
8195,The Babysitter,0,0,0,0.0,0.0,0.0
8196,Kicking and Screaming,718490,0,718490,1028135.38434768,0.0,1028135.38434768
8197,The Big Green,0,0,0,0.0,0.0,0.0
8198,The Scarlet Letter,10382407,50000000,-39617593,14856880.4178194,71548343.3553482,-56691462.937528804
8199,Devil in a Blue Dress,16140822,27000000,-10859178,23096981.489871103,38636105.411888,-15539123.9220169
8200,Embrace of the Vampire,0,500000,-500000,0.0,715483.433553482,-715483.433553482
8201,Operation Dumbo Drop,0,0,0,0.0,0.0,0.0
8202,The Crossing Guard,0,0,0,0.0,0.0,0.0
8203,Tom and Huck,0,0,0,0.0,0.0,0.0
8204,The Last Supper,442965,0,442965,633868.238288037,0.0,633868.238288037
8205,3 Ninjas Knuckle Up,0,0,0,0.0,0.0,0.0
8206,The Addiction,0,0,0,0.0,0.0,0.0
8207,Now and Then,27400000,12000000,15400000,39208492.1587308,17171602.4052835,22036889.753447298
8208,Citizen X,0,0,0,0.0,0.0,0.0
8209,Jury Duty,17014653,0,17014653,24347404.698322102,0.0,24347404.698322102
8210,Problem Child 3,0,0,0,0.0,0.0,0.0
8211,Mr. Holland's Opus,106269971,0,106269971,152068807.469418,0.0,152068807.469418
8212,Restoration,0,19000000,-19000000,0.0,27188370.4750323,-27188370.4750323
8213,Far from Home: The Adventures of Yellow Dog,0,0,0,0.0,0.0,0.0
8214,The Amazing Panda Adventure,0,0,0,0.0,0.0,0.0
8215,The Indian in the Cupboard,0,45000000,-45000000,0.0,64393509.0198134,-64393509.0198134
8216,Dangerous Minds,180000000,0,180000000,257574036.079253,0.0,257574036.079253
8217,Persuasion,0,0,0,0.0,0.0,0.0
8218,Land and Freedom,0,0,0,0.0,0.0,0.0
8219,Haunted,0,0,0,0.0,0.0,0.0
8220,Waiting to Exhale,81452156,16000000,65452156,116555336.490427,22895469.8737114,93659866.61671561
8221,A Personal Journey with Martin Scorsese Through American Movies,0,0,0,0.0,0.0,0.0
8222,Le Hussard sur le toit,15000000,35000000,-20000000,21464503.006604396,50083840.3487438,-28619337.3421394
8223,Bye Bye Love,0,0,0,0.0,0.0,0.0
8224,How To Make An American Quilt,23574130,10000000,13574130,33733798.9508723,14309668.671069598,19424130.279802702
8225,The Pebble and the Penguin,3983912,28000000,-24016088,5700846.07346984,40067072.278995,-34366226.20552516
8226,Never Talk to Strangers,6,6400000,-6399994,8.58580120264179,9158187.94948458,-9158179.363683376
8227,Higher Learning,38290723,0,38290723,54792755.9305706,0.0,54792755.9305706
8228,Leprechaun 3,0,0,0,0.0,0.0,0.0
8229,Clockers,13071518,25000000,-11928482,18704909.1607923,35774171.6776741,-17069262.5168818
8230,Darkman II: The Return of Durant,0,0,0,0.0,0.0,0.0
8231,ç»™çˆ¸çˆ¸çš„ä¿¡,0,0,0,0.0,0.0,0.0
8232,Last of the Dogmen,0,0,0,0.0,0.0,0.0
8233,White Man's Burden,0,8000000,-8000000,0.0,11447734.9368557,-11447734.9368557
8234,Viaggi di nozze,0,0,0,0.0,0.0,0.0
8235,Tales from the Hood,11,6,5,15.740635538176598,8.58580120264179,7.154834335534808
8236,Forget Paris,0,0,0,0.0,0.0,0.0
8237,The Doom Generation,0,0,0,0.0,0.0,0.0
8238,Man of the House,0,0,0,0.0,0.0,0.0
8239,Le Bonheur est dans le prÃ©,0,13365000,-13365000,0.0,19124872.1788846,-19124872.1788846
8240,Forgotten Silver,0,0,0,0.0,0.0,0.0
8241,Top Dog,5093707,6000000,-906293,7288925.94775082,8585801.20264179,-1296875.254890971
8242,Reservoir Dogs,14661007,1200000,13461007,22783560.4746984,1864829.10550674,20918731.369191658
8243,Aladdin,504050219,28000000,476050219,783306265.856875,43512679.1284907,739793586.7283843
8244,Home Alone 2: Lost In New York,358991681,18000000,340991681,557881779.469661,27972436.582601197,529909342.8870598
8245,Batman Returns,280000000,80000000,200000000,435126791.284907,124321940.36711599,310804850.917791
8246,AlienÂ³,159773545,50000000,109773545,248291964.17166,77701212.7294478,170590751.44221222
8247,Lethal Weapon 3,321731527,35000000,286731527,499978596.423941,54390848.910613395,445587747.5133276
8248,Dracula,215862692,40000000,175862692,335455859.028865,62160970.1835582,273294888.84530675
8249,Army of Darkness,0,11000000,-11000000,0.0,17094266.8004785,-17094266.8004785
8250,Under Siege,156563139,35000000,121563139,243302915.38058197,54390848.910613395,188912066.4699686
8251,Death Becomes Her,0,0,0,0.0,0.0,0.0
8252,A Few Good Men,243240178,40000000,203240178,378001136.302535,62160970.1835582,315840166.1189768
8253,Wayne's World,121697323,20000000,101697323,189120591.660546,31080485.0917791,158040106.5687669
8254,Beethoven,147214049,0,147214049,228774202.76224703,0.0,228774202.76224703
8255,Basic Instinct,352927224,49000000,303927224,548457466.200749,76147188.4748588,472310277.7258902
8256,Universal Soldier,0,23000000,-23000000,0.0,35742557.8555459,-35742557.8555459
8257,Glengarry Glen Ross,10725228,12500000,-1774772,16667264.4479966,19425303.182361897,-2758038.7343652975
8258,Honey I Blew Up the Kid,58662452,40000000,18662452,91162873.2416604,62160970.1835582,29001903.058102198
8259,Sneakers,105232691,0,105232691,163534154.18966398,0.0,163534154.18966398
8260,Bad Lieutenant,2019469,1000000,1019469,3138303.8073905,1554024.25458895,1584279.55280155
8261,Unforgiven,159157447,14000000,145157447,247334532.936456,21756339.5642453,225578193.37221068
8262,Sister Act,231605150,31000000,200605150,359920020.587713,48174751.8922576,311745268.69545543
8263,White Men Can't Jump,90753806,0,90753806,141033615.72026002,0.0,141033615.72026002
8264,1492: Conquest of Paradise,7191399,47000000,-39808601,11175608.4704267,73039139.96568091,-61863531.49525421
8265,Pet Sematary II,17092453,8000000,9092453,26562086.532421697,12432194.0367116,14129892.495710097
8266,Scent of a Woman,134095253,31000000,103095253,208387275.58724198,48174751.8922576,160212523.69498438
8267,Passenger 57,44065653,15000000,29065653,68479093.5563006,23310363.8188343,45168729.73746629
8268,Braindead,242623,3000000,-2757377,377042.026721136,4662072.76376686,-4285030.737045724
8269,Fortress,6739141,8000000,-1260859,10472788.569094801,12432194.0367116,-1959405.4676167984
8270,A River Runs Through It,43440294,0,43440294,67507270.5024751,0.0,67507270.5024751
8271,The Bodyguard,411006740,25000000,386006740,638714442.759536,38850606.3647239,599863836.3948121
8272,Romper Stomper,0,0,0,0.0,0.0,0.0
8273,Poison Ivy,0,0,0,0.0,0.0,0.0
8274,Peter's Friends,0,0,0,0.0,0.0,0.0
8275,The Muppet Christmas Carol,27281507,0,27281507,42396123.5797383,0.0,42396123.5797383
8276,Stop! Or My Mom Will Shoot,70611210,0,70611210,109731532.985874,0.0,109731532.985874
8277,Patriot Games,178051587,45000000,133051587,276696484.766055,69931091.456503,206765393.30955198
8278,The Mighty Ducks,50752337,10000000,40752337,78870362.67507242,15540242.545889499,63330120.12918292
8279,Twin Peaks: Fire Walk with Me,4160851,10000000,-5839149,6466063.37373071,15540242.545889499,-9074179.172158789
8280,The Player,21706101,8000000,13706101,33731807.4265575,12432194.0367116,21299613.389845904
8281,Hellraiser III: Hell on Earth,12534961,5000000,7534961,19479633.424326602,7770121.27294478,11709512.151381822
8282,Malcolm X,48169908,34000000,14169908,74857205.3733186,52836824.6560245,22020380.717294097
8283,Orlando,0,4000000,-4000000,0.0,6216097.01835582,-6216097.01835582
8284,School Ties,14715067,0,14715067,22867571.0259015,0.0,22867571.0259015
8285,Toys,23278931,0,23278931,36176023.394902706,0.0,36176023.394902706
8286,Howards End,25966555,0,25966555,40352656.278118104,0.0,40352656.278118104
8287,The Last of the Mohicans,75505856,40000000,35505856,117337931.587501,62160970.1835582,55176961.4039428
8288,El Mariachi,2040920,220000,1820920,3171639.18167569,341885.33600957,2829753.8456661203
8289,The Hand that Rocks the Cradle,88036683,11700000,76336683,136811140.675559,18182083.7786907,118629056.89686832
8290,Bitter Moon,1862805,5000000,-3137195,2894844.15156958,7770121.27294478,-4875277.121375199
8291,Freejack,0,0,0,0.0,0.0,0.0
8292,Baraka,0,4000000,-4000000,0.0,6216097.01835582,-6216097.01835582
8293,Hero,0,42000000,-42000000,0.0,65269018.6927361,-65269018.6927361
8294,City of Joy,14683921,27000000,-12316079,22819169.3864681,41958654.87390179,-19139485.48743369
8295,Damage,7532911,0,7532911,11706326.4016599,0.0,11706326.4016599
8296,Final Analysis,28590665,0,28590665,44430586.8648275,0.0,44430586.8648275
8297,Forever Young,128000000,0,128000000,198915104.587386,0.0,198915104.587386
8298,Shining Through,21621000,0,21621000,33599558.4084678,0.0,33599558.4084678
8299,A League of Their Own,107458785,40000000,67458785,166993558.258659,62160970.1835582,104832588.07510081
8300,Of Mice and Men,5101632,0,5101632,7928059.86598716,0.0,7928059.86598716
8301,Love Potion No. 9,754935,0,754935,1173187.30063811,0.0,1173187.30063811
8302,My Cousin Vinny,64088552,11000000,53088552,99595164.2494855,17094266.8004785,82500897.44900699
8303,Cool World,14110589,0,14110589,21928197.552536104,0.0,21928197.552536104
8304,The Crying Game,62548947,3705538,58843409,97202580.7369991,5758495.92830105,91444084.80869804
8305,FernGully: The Last Rainforest,32710894,0,32710894,50833522.6652883,0.0,50833522.6652883
8306,Boomerang,70100000,40000000,30100000,108937100.246685,62160970.1835582,46776130.063126795
8307,The Lawnmower Man,32101000,10000000,22101000,49885732.596559994,15540242.545889499,34345490.0506705
8308,Candyman,25792310,6000000,19792310,40081875.321877204,9324145.52753373,30757729.79434347
8309,Chaplin,0,0,0,0.0,0.0,0.0
8310,Medicine Man,0,40000000,-40000000,0.0,62160970.1835582,-62160970.1835582
8311,Beyond The Law,0,0,0,0.0,0.0,0.0
8312,Housesitter,0,0,0,0.0,0.0,0.0
8313,Unlawful Entry,57138719,23000000,34138719,88794955.2021428,35742557.8555459,53052397.346596904
8314,Captain Ron,22518097,24000000,-1481903,34993668.905186795,37296582.1101349,-2302913.204948105
8315,Memoirs of an Invisible Man,14358033,40000000,-25641967,22312731.5301886,62160970.1835582,-39848238.653369606
8316,The Power of One,0,0,0,0.0,0.0,0.0
8317,Bob Roberts,0,0,0,0.0,0.0,0.0
8318,Rapid Fire,14356479,10000000,4356479,22310316.576497,15540242.545889499,6770074.030607501
8319,Encino Man,0,0,0,0.0,0.0,0.0
8320,Buffy the Vampire Slayer,0,0,0,0.0,0.0,0.0
8321,Thunderheart,0,0,0,0.0,0.0,0.0
8322,The Cutting Edge,25105517,0,25105517,39014582.34199529,0.0,39014582.34199529
8323,Far and Away,137783840,60000000,77783840,214119429.250404,93241455.2753373,120877973.9750667
8324,Radio Flyer,4651977,35000000,-30348023,7229285.08978996,54390848.910613395,-47161563.82082344
8325,Juice,20146880,5000000,15146880,31308740.174293105,7770121.27294478,23538618.901348323
8326,Singles,18472850,0,18472850,28707256.9513836,0.0,28707256.9513836
8327,Seong lung wui,8359717,10000000,-1640283,12991202.9794996,15540242.545889499,-2549039.566389898
8328,Gladiator,9,0,9,13.986218291300599,0.0,13.986218291300599
8329,The Distinguished Gentleman,46434570,0,46434570,72160448.0314087,0.0,72160448.0314087
8330,Single White Female,48017402,16000000,32017402,74620207.3503482,24864388.0734233,49755819.27692491
8331,Dust Devil,0,8000000,-8000000,0.0,12432194.0367116,-12432194.0367116
8332,Wuthering Heights,0,0,0,0.0,0.0,0.0
8333,American Me,0,0,0,0.0,0.0,0.0
8334,Mr. Baseball,20000000,0,20000000,31080485.0917791,0.0,31080485.0917791
8335,Critters 4,0,0,0,0.0,0.0,0.0
8336,A Stranger Among Us,0,0,0,0.0,0.0,0.0
8337,Dr. Giggles,8403433,0,8403433,13059138.703813199,0.0,13059138.703813199
8338,Sleepwalkers,30524763,0,30524763,47436222.0675795,0.0,47436222.0675795
8339,Prelude to a Kiss,22697691,0,22697691,35272762.3371654,0.0,35272762.3371654
8340,3 Ninjas,0,0,0,0.0,0.0,0.0
8341,Split Second,0,0,0,0.0,0.0,0.0
8342,Jennifer Eight,11390479,20000000,-8609521,17701080.637386102,31080485.0917791,-13379404.454393
8343,Leap of Faith,0,0,0,0.0,0.0,0.0
8344,Honeymoon in Vegas,0,25000000,-25000000,0.0,38850606.3647239,-38850606.3647239
8345,Knight Moves,0,0,0,0.0,0.0,0.0
8346,White Sands,0,0,0,0.0,0.0,0.0
8347,Tom and Jerry: The Movie,0,0,0,0.0,0.0,0.0
8348,Deep Cover,0,0,0,0.0,0.0,0.0
8349,Newsies,0,15000000,-15000000,0.0,23310363.8188343,-23310363.8188343
8350,Diggstown,4836637,17000000,-12163363,7516251.20864236,26418412.3280122,-18902161.11936984
8351,The Mambo Kings,6742168,0,6742168,10477492.6005135,0.0,10477492.6005135
8352,Raising Cain,37170057,12000000,25170057,57763170.122454,18648291.055067398,39114879.067386605
8353,Trespass,0,0,0,0.0,0.0,0.0
8354,Husbands and Wives,0,0,0,0.0,0.0,0.0
8355,Nemesis,0,0,0,0.0,0.0,0.0
8356,Kuffs,0,0,0,0.0,0.0,0.0
8357,Innocent Blood,0,0,0,0.0,0.0,0.0
8358,The Babe,17530973,0,17530973,27243557.2485441,0.0,27243557.2485441
8359,Sidekicks,0,0,0,0.0,0.0,0.0
8360,Un CÅ“ur en Hiver,1666511,0,1666511,2589798.51453929,0.0,2589798.51453929
8361,Mo' Money,0,17000000,-17000000,0.0,26418412.3280122,-26418412.3280122
8362,Hoffa,0,35000000,-35000000,0.0,54390848.910613395,-54390848.910613395
8363,Belle Ã‰poque,0,0,0,0.0,0.0,0.0
8364,Lorenzo's Oil,7286388,0,7286388,11323223.6803459,0.0,11323223.6803459
8365,Xiao ao jiang hu zhi: Dong Fang Bu Bai,0,4439832,-4439832,0.0,6899606.61430019,-6899606.61430019
8366,Io speriamo che me la cavo,0,0,0,0.0,0.0,0.0
8367,Strictly Ballroom,33946224,3000000,30946224,52753255.4477097,4662072.76376686,48091182.68394284
8368,LadyBugs,0,0,0,0.0,0.0,0.0
8369,Stay Tuned,0,0,0,0.0,0.0,0.0
8370,Bill Hicks: Relentless,0,0,0,0.0,0.0,0.0
8371,Blown Away,0,0,0,0.0,0.0,0.0
8372,Pure Country,0,0,0,0.0,0.0,0.0
8373,Mom and Dad Save the World,0,0,0,0.0,0.0,0.0
8374,Gayniggers from Outer Space,0,0,0,0.0,0.0,0.0
8375,Raiders of the Lost Ark,389925971,18000000,371925971,935116878.2270651,43167434.4874226,891949443.7396425
8376,Private Lessons,26279000,2800000,23479000,63022056.160832204,6714934.25359908,56307121.90723313
8377,For Your Eyes Only,195312802,28000000,167312802,468397365.82721907,67149342.53599079,401248023.2912283
8378,The Fox and the Hound,29800000,12000000,17800000,71466085.98473309,28778289.658281703,42687796.32645139
8379,Mad Max 2,24600832,2000000,22600832,58997489.09422729,4796381.60971363,54201107.48451366
8380,History of the World: Part I,31672907,11000000,20672907,75957674.330485,26380098.8534249,49577575.4770601
8381,An American Werewolf in London,31973249,10000000,21973249,76677951.7531973,23981908.048568103,52696043.7046292
8382,Heavy Metal,0,9300000,-9300000,0.0,22303174.4851683,-22303174.4851683
8383,The Evil Dead,29400000,350000,29050000,70506809.6627903,839366.781699885,69667442.88109042
8384,Escape from New York,50000000,6000000,44000000,119909540.24283999,14389144.829140803,105520395.4136992
8385,Excalibur,34967437,0,34967437,83858585.88281,0.0,83858585.88281
8386,On Golden Pond,19255967,0,19255967,46179482.9980262,0.0,46179482.9980262
8387,Chariots of Fire,58972904,5500000,53472904,141428276.108503,13190049.426712401,128238226.68179062
8388,Friday the 13th Part 2,21722776,1250000,20472776,52095361.659164295,2997738.50607102,49097623.15309328
8389,Southern Comfort,0,0,0,0.0,0.0,0.0
8390,Gallipoli,5732587,0,5732587,13747837.4314417,0.0,13747837.4314417
8391,Halloween II,25533818,2500000,23033818,61234967.5404874,5995477.01214204,55239490.52834536
8392,The Postman Always Rings Twice,0,12000000,-12000000,0.0,28778289.658281703,-28778289.658281703
8393,Arthur,95461682,7000000,88461682,228935327.988565,16787335.633997697,212147992.3545673
8394,Road Games,100000,1750000,-1650000,239819.080485681,4196833.90849942,-3957014.8280137386
8395,Endless Love,0,0,0,0.0,0.0,0.0
8396,Porky's,125728258,4000000,121728258,301520352.246265,9592763.21942726,291927589.0268377
8397,Reds,40382659,32000000,8382659,96845321.48946829,76742105.75541809,20103215.7340502
8398,The Cannonball Run,72179579,18000000,54179579,173100402.65623602,43167434.4874226,129932968.16881342
8399,Absence of Malice,40716963,12000000,28716963,97647046.2682952,28778289.658281703,68868756.6100135
8400,Time Bandits,42365581,5000000,37365581,101600746.796616,11990954.024284,89609792.772332
8401,Scanners,14225876,4100000,10125876,34116365.014233194,9832582.29991294,24283782.714320254
8402,Victory,0,0,0,0.0,0.0,0.0
8403,Thief,4300000,0,4300000,10312220.460884301,0.0,10312220.460884301
8404,Piranha Part Two: The Spawning,0,145786,-145786,0.0,349622.644676855,-349622.644676855
8405,Stripes,85300000,10000000,75300000,204565675.654286,23981908.048568103,180583767.6057179
8406,Outland,17374595,16000000,1374595,41667593.96711121,38371052.877709,3296541.0894022062
8407,Le Professionnel,0,0,0,0.0,0.0,0.0
8408,Omen III: The Final Conflict,20471382,0,20471382,49094280.0751113,0.0,49094280.0751113
8409,Dead & Buried,216166,3000000,-2783834,518407.313522678,7194572.41457044,-6676165.101047762
8410,Blow Out,12000000,18000000,-6000000,28778289.658281703,43167434.4874226,-14389144.829140898
8411,Queen - Rock Montreal,0,0,0,0.0,0.0,0.0
8412,Death Hunt,0,0,0,0.0,0.0,0.0
8413,Garde Ã  vue,0,0,0,0.0,0.0,0.0
8414,Ragtime,0,0,0,0.0,0.0,0.0
8415,Dragonslayer,6000000,18000000,-12000000,14389144.829140803,43167434.4874226,-28778289.658281796
8416,Nice Dreams,0,0,0,0.0,0.0,0.0
8417,The French Lieutenant's Woman,2689068,0,2689068,6448898.1512347,0.0,6448898.1512347
8418,The Howling,17985893,1000000,16985893,43133603.2097385,2398190.80485681,40735412.40488169
8419,Nighthawks,19905359,5000000,14905359,47736848.921173796,11990954.024284,35745894.8968898
8420,My Dinner with AndrÃ©,0,0,0,0.0,0.0,0.0
8421,Taps,35856053,14000000,21856053,85989656.60305859,33574671.267995395,52414985.3350632
8422,Ms .45,0,62000,-62000,0.0,148687.829901122,-148687.829901122
8423,Eye of the Needle,18000000,0,18000000,43167434.4874226,0.0,43167434.4874226
8424,Cannibal Ferox,0,0,0,0.0,0.0,0.0
8425,Clash of the Titans,41092328,15000000,26092328,98547243.1597602,35972862.0728522,62574381.086908005
8426,Lion of the Desert,0,35000000,-35000000,0.0,83936678.1699885,-83936678.1699885
8427,The Great Muppet Caper,0,0,0,0.0,0.0,0.0
8428,Cutter's Way,0,3000000,-3000000,0.0,7194572.41457044,-7194572.41457044
8429,Sharky's Machine,35610100,0,35610100,85399814.3800317,0.0,85399814.3800317
8430,Student Bodies,0,0,0,0.0,0.0,0.0
8431,Galaxy of Terror,0,700000,-700000,0.0,1678733.56339977,-1678733.56339977
8432,Condorman,0,0,0,0.0,0.0,0.0
8433,Ghost Story,0,0,0,0.0,0.0,0.0
8434,The Burning,0,1500000,-1500000,0.0,3597286.20728522,-3597286.20728522
8435,Happy Birthday to Me,0,0,0,0.0,0.0,0.0
8436,The Funhouse,0,0,0,0.0,0.0,0.0
8437,"Bianco, rosso e Verdone",0,0,0,0.0,0.0,0.0
8438,Looker,0,0,0,0.0,0.0,0.0
8439,Caveman,0,0,0,0.0,0.0,0.0
8440,Hell Night,0,0,0,0.0,0.0,0.0
8441,My Bloody Valentine,0,2200000,-2200000,0.0,5276019.77068499,-5276019.77068499
8442,Mommie Dearest,0,0,0,0.0,0.0,0.0
8443,Wolfen,0,17000000,-17000000,0.0,40769243.68256579,-40769243.68256579
8444,Neighbors,29916207,8500000,21416207,71744772.5435931,20384621.841282897,51360150.7023102
8445,Dark Night of the Scarecrow,0,0,0,0.0,0.0,0.0
8446,American Pop,6000000,0,6000000,14389144.829140803,0.0,14389144.829140803
8447,The Decline of Western Civilization,0,100000,-100000,0.0,239819.080485681,-239819.080485681
8448,Gregory's Girl,0,0,0,0.0,0.0,0.0
8449,Bloody Birthday,0,0,0,0.0,0.0,0.0
8450,The Incredible Shrinking Woman,0,0,0,0.0,0.0,0.0
8451,Continental Divide,15578237,0,15578237,37359584.7292802,0.0,37359584.7292802
8452,"Vernon, Florida",0,0,0,0.0,0.0,0.0
8453,The Prowler,0,1000000,-1000000,0.0,2398190.80485681,-2398190.80485681
8454,Enter the Ninja,0,0,0,0.0,0.0,0.0
8455,Prince of the City,0,0,0,0.0,0.0,0.0
8456,The Hitch Hikers Guide to the Galaxy,0,0,0,0.0,0.0,0.0
8457,Independence Day,816969268,75000000,741969268,1135764351.5897,104266255.42201899,1031498096.167681
8458,Mission: Impossible,457696359,80000000,377696359,636297139.642961,111217339.11682,525079800.52614105
8459,Trainspotting,16491080,4000000,12491080,22926175.459532604,5560866.95584101,17365308.50369159
8460,Fargo,60611975,7000000,53611975,84263782.2264404,9731517.17272177,74532265.05371863
8461,The Rock,335062621,75000000,260062621,465809664.314095,104266255.42201899,361543408.892076
8462,Mars Attacks!,101371017,70000000,31371017,140927684.678824,97315171.7272178,43612512.951606214
8463,Romeo + Juliet,147298761,14500000,132798761,204777203.170305,20158142.7149236,184619060.45538142
8464,The Hunchback of Notre Dame,100138851,100000000,138851,139214706.880446,139021673.896025,193032.98442098498
8465,Aladdin and the King of Thieves,0,0,0,0.0,0.0,0.0
8466,Space Jam,230000000,80000000,150000000,319749849.960858,111217339.11682,208532510.844038
8467,Eraser,242295562,100000000,142295562,336843346.068182,139021673.896025,197821672.172157
8468,101 Dalmatians,320689294,54000000,266689294,445827624.524146,75071703.9038537,370755920.6202923
8469,Phenomenon,152036382,32000000,120036382,211363523.187355,44486935.6467281,166876587.5406269
8470,From Dusk Till Dawn,25836616,19000000,6836616,35918496.0412883,26414118.0402448,9504378.001043502
8471,A Time to Kill,152266007,40000000,112266007,211682751.70603898,55608669.55841011,156074082.14762887
8472,Star Trek: First Contact,150000000,46000000,104000000,208532510.84403798,63949969.99217161,144582540.85186636
8473,Happy Gilmore,41205099,12000000,29205099,57284018.36031441,16682600.867523002,40601417.49279141
8474,Jingle All the Way,129832389,60000000,69832389,180495160.446999,83413004.33761519,97082156.10938382
8475,Scream,173046663,14000000,159046663,240572367.52381402,19463034.3454435,221109333.17837054
8476,The Long Kiss Goodnight,89456761,65000000,24456761,124364286.555366,90364088.03241651,34000198.52294949
8477,Jerry Maguire,273552592,50000000,223552592,380297392.384364,69510836.94801271,310786555.4363513
8478,Matilda,33459416,36000000,-2540584,46515840.1990345,50047802.6025691,-3531962.403534606
8479,DragonHeart,115267375,57000000,58267375,160246634.181008,79242354.12073441,81004280.0602736
8480,The Nutty Professor,128769345,54000000,74769345,179017298.88394699,75071703.9038537,103945594.98009329
8481,Daylight,159212469,80000000,79212469,221339839.45499,111217339.11682,110122500.33817
8482,The Quest,57400547,30000000,27400547,79799201.26487479,41706502.168807596,38092699.09606719
8483,Chain Reaction,60209334,50000000,10209334,83704023.96844871,69510836.94801271,14193187.020436004
8484,The English Patient,231976425,27000000,204976425,322497509.079157,37535851.9519268,284961657.12723017
8485,Executive Decision,121969216,55000000,66969216,169563645.721058,76461920.6428139,93101725.0782441
8486,Twister,494471524,92000000,402471524,687422589.603987,127899939.98434299,559522649.6196439
8487,Ransom,309492681,80000000,229492681,430261905.711886,111217339.11682,319044566.595066
8488,D3: The Mighty Ducks,22955097,0,22955097,31912560.093856297,0.0,31912560.093856297
8489,The Cable Guy,102825796,47000000,55825796,142950142.796112,65340186.7311319,77609956.0649801
8490,Sleepers,165615285,44000000,121615285,230241141.434673,61169536.5142511,169071604.9204219
8491,The Frighteners,29359216,30000000,-640784,40815673.5259497,41706502.168807596,-890828.6428578943
8492,Broken Arrow,150270147,50000000,100270147,208908073.725418,69510836.94801271,139397236.7774053
8493,Crash,0,10000000,-10000000,0.0,13902167.3896025,-13902167.3896025
8494,Escape from L.A.,42277365,50000000,-7722635,58774700.5021323,69510836.94801271,-10736136.445880413
8495,The People vs. Larry Flynt,20300385,36000000,-15699615,28221935.034337603,50047802.6025691,-21825867.5682315
8496,The Arrival,14048372,25000000,-10951628,19530281.9095405,34755418.474006295,-15225136.564465795
8497,Bound,7011317,4500000,2511317,9747250.25555659,6255975.32532114,3491274.930235451
8498,Swingers,4505922,200000,4305922,6264208.18884926,278043.34779205,5986164.84105721
8499,Striptease,113309743,50000000,63309743,157525101.405884,69510836.94801271,88014264.45787129
8500,The Fan,18626419,55000000,-36373581,25894759.4806873,76461920.6428139,-50567161.1621266
8501,Jack,58620973,45000000,13620973,81495857.9187371,62559753.2532114,18936104.665525697
8502,Primal Fear,102616183,30000000,72616183,142658735.294808,41706502.168807596,100952233.1260004
8503,Barb Wire,3793614,0,3793614,5273945.68395396,0.0,5273945.68395396
8504,Courage Under Fire,100860818,46000000,54860818,140218397.488823,63949969.99217161,76268427.49665138
8505,Everyone Says I Love You,0,20000000,-20000000,0.0,27804334.779205,-27804334.779205
8506,That Thing You Do!,34585416,0,34585416,48081224.247103706,0.0,48081224.247103706
8507,Thinner,0,0,0,0.0,0.0,0.0
8508,Don't Be a Menace to South Central While Drinking Your Juice in the Hood,0,0,0,0.0,0.0,0.0
8509,2 Days in the Valley,0,0,0,0.0,0.0,0.0
8510,Set  It Off,41590886,9000000,32590886,57820345.905387595,12511950.6506422,45308395.254745394
8511,The Portrait of a Lady,3692836,0,3692836,5133842.42143502,0.0,5133842.42143502
8512,The Craft,24769466,15000000,9769466,34434926.248306796,20853251.084403798,13581675.163902998
8513,House Arrest,0,0,0,0.0,0.0,0.0
8514,One Fine Day,97529550,0,97529550,135587212.95326102,0.0,135587212.95326102
8515,Hellraiser: Bloodline,16675000,4000000,12675000,23181864.122162197,5560866.95584101,17620997.16632119
8516,Down Periscope,0,0,0,0.0,0.0,0.0
8517,Kingpin,25023434,27000000,-1976566,34787996.8130671,37535851.9519268,-2747855.1388596967
8518,The Preacher's Wife,48093211,40000000,8093211,66859986.9625474,55608669.55841011,11251317.404137291
8519,Foxfire,258263,0,258263,359041.54565409204,0.0,359041.54565409204
8520,The Glimmer Man,0,45000000,-45000000,0.0,62559753.2532114,-62559753.2532114
8521,Bulletproof,22611954,25000000,-2388046,31435516.9513992,34755418.474006295,-3319901.5226070955
8522,The Truth About Cats & Dogs,0,0,0,0.0,0.0,0.0
8523,Bordello of Blood,5,15000000,-14999995,6.9510836948012695,20853251.084403798,-20853244.133320104
8524,Evita,141047179,55000000,86047179,196086149.228923,76461920.6428139,119624228.58610909
8525,Head Above Water,0,0,0,0.0,0.0,0.0
8526,City Hall,0,0,0,0.0,0.0,0.0
8527,Fear,0,0,0,0.0,0.0,0.0
8528,Flirting with Disaster,14702438,7000000,7702438,20439575.411125302,9731517.17272177,10708058.238403533
8529,Beautiful Thing,1500000,0,1500000,2085325.10844038,0.0,2085325.10844038
8530,Albino Alligator,0,6000000,-6000000,0.0,8341300.43376152,-8341300.43376152
8531,Multiplicity,0,45000000,-45000000,0.0,62559753.2532114,-62559753.2532114
8532,Basquiat,3011195,2962051,49144,4186213.69327342,4117892.88185395,68320.81141946977
8533,Hak Hap,0,0,0,0.0,0.0,0.0
8534,The Substitute,0,0,0,0.0,0.0,0.0
8535,Last Man Standing,47267001,67000000,-19732999,65711375.990651004,93144521.510337,-27433145.51968599
8536,Maximum Risk,51702483,25000000,26702483,71877657.31240791,34755418.474006295,37122238.838401616
8537,Fled,17193231,25000000,-7806769,23902317.5330103,34755418.474006295,-10853100.940995995
8538,The Associate,0,0,0,0.0,0.0,0.0
8539,Two Much,0,0,0,0.0,0.0,0.0
8540,She's the One,9482579,3500000,5982579,13182840.0543129,4865758.58636088,8317081.46795202
8541,Jane Eyre,0,0,0,0.0,0.0,0.0
8542,Eye for an Eye,0,20000000,-20000000,0.0,27804334.779205,-27804334.779205
8543,Beavis and Butt-Head Do America,0,12000000,-12000000,0.0,16682600.867523002,-16682600.867523002
8544,The Crow: City of Angels,17917287,13000000,4917287,24908912.3041549,18072817.6064833,6836094.6976716
8545,The Crucible,0,25000000,-25000000,0.0,34755418.474006295,-34755418.474006295
8546,Poison Ivy II: Lily,0,0,0,0.0,0.0,0.0
8547,Bottle Rocket,560069,7000000,-6439931,778617.29877273,9731517.17272177,-8952899.87394904
8548,James and the Giant Peach,28921264,38000000,-9078736,40206825.3246885,52828236.0804896,-12621410.755801097
8549,Muppet Treasure Island,34327391,0,34327391,47722513.573033504,0.0,47722513.573033504
8550,Emma,22231658,6000000,16231658,30906823.0864396,8341300.43376152,22565522.65267808
8551,The Birdcage,185260553,0,185260553,257552321.849633,0.0,257552321.849633
8552,Tin Cup,53854588,45000000,8854588,74869549.707408,62559753.2532114,12309796.454196595
8553,High School High,21302121,0,21302121,29614565.189556703,0.0,29614565.189556703
8554,The First Wives Club,116400000,26000000,90400000,161821228.414973,36145635.2129666,125675593.2020064
8555,The Land Before Time IV: Journey Through the Mists,0,0,0,0.0,0.0,0.0
8556,Kama Sutra - A Tale of Love,4109095,3000000,1109095,5712532.65097788,4170650.21688076,1541882.4340971196
8557,Sling Blade,24475416,1000000,23475416,34026133.0162156,1390216.73896025,32635916.27725535
8558,Secrets & Lies,13417292,4500000,8917292,18652943.9299175,6255975.32532114,12396968.60459636
8559,Marvin's Room,0,0,0,0.0,0.0,0.0
8560,Bed of Roses,19030691,0,19030691,26456785.1821802,0.0,26456785.1821802
8561,Fly Away Home,0,0,0,0.0,0.0,0.0
8562,Blood and Wine,0,26000000,-26000000,0.0,36145635.2129666,-36145635.2129666
8563,Mary Reilly,12379402,47000000,-34620598,17210051.878718,65340186.7311319,-48130134.85241389
8564,Homeward Bound II: Lost in San Francisco,32709423,0,32709423,45473187.3763315,0.0,45473187.3763315
8565,The Ghost and the Darkness,75000000,50000000,25000000,104266255.42201899,69510836.94801271,34755418.47400628
8566,Twelfth Night,0,0,0,0.0,0.0,0.0
8567,I Shot Andy Warhol,1814290,0,1814290,2522256.32732819,0.0,2522256.32732819
8568,Unforgettable,0,18000000,-18000000,0.0,25023901.3012845,-25023901.3012845
8569,Shine,0,0,0,0.0,0.0,0.0
8570,Bullet,0,0,0,0.0,0.0,0.0
8571,Larger Than Life,0,30000000,-30000000,0.0,41706502.168807596,-41706502.168807596
8572,Jude,405000,7000000,-6595000,563037.779278902,9731517.17272177,-9168479.393442867
8573,Hamlet,0,0,0,0.0,0.0,0.0
8574,The Juror,0,44000000,-44000000,0.0,61169536.5142511,-61169536.5142511
8575,Lone Star,13269963,5000000,8269963,18448124.6879832,6951083.69480127,11497040.993181929
8576,Flipper,20080020,25530000,-5449980,27915579.922656603,35492233.3456552,-7576653.4229986
8577,Big Night,0,0,0,0.0,0.0,0.0
8578,A Very Brady Sequel,0,0,0,0.0,0.0,0.0
8579,Lawnmower Man 2: Beyond Cyberspace,2409225,0,2409225,3349344.92292151,0.0,3349344.92292151
8580,Beautiful Girls,0,0,0,0.0,0.0,0.0
8581,Stealing Beauty,0,0,0,0.0,0.0,0.0
8582,Heaven's Prisoners,0,25000000,-25000000,0.0,34755418.474006295,-34755418.474006295
8583,Mulholland Falls,0,0,0,0.0,0.0,0.0
8584,Tremors 2: Aftershocks,0,4000000,-4000000,0.0,5560866.95584101,-5560866.95584101
8585,Kazaam,0,20000000,-20000000,0.0,27804334.779205,-27804334.779205
8586,The Chamber,22540359,50000000,-27459641,31335984.3839734,69510836.94801271,-38174852.564039305
8587,White Squall,10300000,38000000,-27700000,14319232.4112906,52828236.0804896,-38509003.669199
8588,Sgt. Bilko,0,0,0,0.0,0.0,0.0
8589,Freeway,0,3000000,-3000000,0.0,4170650.21688076,-4170650.21688076
8590,Spy Hard,0,18000000,-18000000,0.0,25023901.3012845,-25023901.3012845
8591,Feeling Minnesota,0,0,0,0.0,0.0,0.0
8592,Before and After,0,35000000,-35000000,0.0,48657585.8636089,-48657585.8636089
8593,The Phantom,17300889,45000000,-27699111,24051985.4866933,62559753.2532114,-38507767.7665181
8594,The Adventures of Pinocchio,0,0,0,0.0,0.0,0.0
8595,Bio-Dome,0,15000000,-15000000,0.0,20853251.084403798,-20853251.084403798
8596,My Fellow Americans,0,0,0,0.0,0.0,0.0
8597,Michael,119718203,0,119718203,166434249.768841,0.0,166434249.768841
8598,Extreme Measures,17380126,38000000,-20619874,24162142.0904383,52828236.0804896,-28666093.9900513
8599,Black Sheep,32,0,32,44.48693564672811,0.0,44.48693564672811
8600,All Dogs Go to Heaven 2,8620678,0,8620678,11984610.8567864,0.0,11984610.8567864
8601,The Great White Hype,0,0,0,0.0,0.0,0.0
8602,Michael Collins,16900000,28000000,-11100000,23494662.8884282,38926068.6908871,-15431405.802458901
8603,Carpool,0,17000000,-17000000,0.0,23633684.5623243,-23633684.5623243
8604,The Stupids,0,0,0,0.0,0.0,0.0
8605,The Mirror Has Two Faces,0,42000000,-42000000,0.0,58389103.0363306,-58389103.0363306
8606,Up Close & Personal,0,60000000,-60000000,0.0,83413004.33761519,-83413004.33761519
8607,Wish Upon a Star,0,0,0,0.0,0.0,0.0
8608,Looking For Richard,0,0,0,0.0,0.0,0.0
8609,Darkman III: Die Darkman Die,0,0,0,0.0,0.0,0.0
8610,Brassed Off,0,0,0,0.0,0.0,0.0
8611,Gulliver's Travels,0,28000000,-28000000,0.0,38926068.6908871,-38926068.6908871
8612,Hard Eight,222559,3000000,-2777441,309405.247206255,4170650.21688076,-3861244.9696745053
8613,La Belle verte,0,0,0,0.0,0.0,0.0
8614,T2 3-D: Battle Across Time,0,0,0,0.0,0.0,0.0
8615,Doctor Who,42000000,5000000,37000000,58389103.0363306,6951083.69480127,51438019.34152933
8616,Trees Lounge,0,0,0,0.0,0.0,0.0
8617,Space Truckers,0,25000000,-25000000,0.0,34755418.474006295,-34755418.474006295
8618,In Love and War,0,0,0,0.0,0.0,0.0
8619,Eddie,0,0,0,0.0,0.0,0.0
8620,Kids in the Hall: Brain Candy,0,0,0,0.0,0.0,0.0
8621,Ridicule,2503829,3000000,-496171,3480864.98729411,4170650.21688076,-689785.2295866502
8622,The Island of Dr. Moreau,49627779,40000000,9627779,68993369.08322011,55608669.55841011,13384699.524810001
8623,JÃ¤garna,0,17500000,-17500000,0.0,24328792.931804396,-24328792.931804396
8624,First Kid,0,0,0,0.0,0.0,0.0
8625,Children of the Corn IV: The Gathering,0,0,0,0.0,0.0,0.0
8626,Diabolique,0,0,0,0.0,0.0,0.0
8627,Alaska,0,23000000,-23000000,0.0,31974984.996085804,-31974984.996085804
8628,Silent Trigger,76382,15000000,-14923618,106187.53495526199,20853251.084403798,-20747063.549448535
8629,Dunston Checks In,0,0,0,0.0,0.0,0.0
8630,Titanic,0,13000000,-13000000,0.0,18072817.6064833,-18072817.6064833
8631,The Pallbearer,0,8000000,-8000000,0.0,11121733.911682,-11121733.911682
8632,The Dentist,0,2500000,-2500000,0.0,3475541.84740063,-3475541.84740063
8633,Irma Vep,0,0,0,0.0,0.0,0.0
8634,Citizen Ruth,153155,3000000,-2846845,212918.644655457,4170650.21688076,-3957731.5722253034
8635,Leprechaun 4: In Space,0,0,0,0.0,0.0,0.0
8636,Tromeo & Juliet,0,350000,-350000,0.0,486575.85863608797,-486575.85863608797
8637,Celtic Pride,0,0,0,0.0,0.0,0.0
8638,The Pillow Book,0,0,0,0.0,0.0,0.0
8639,Waiting for Guffman,0,0,0,0.0,0.0,0.0
8640,Daai laap mat taam 008,0,0,0,0.0,0.0,0.0
8641,Un hÃ©ros trÃ¨s discret,0,0,0,0.0,0.0,0.0
8642,Crossworlds,0,0,0,0.0,0.0,0.0
8643,Sometimes They Come Back... Again,0,3000000,-3000000,0.0,4170650.21688076,-4170650.21688076
8644,Harriet the Spy,0,12000000,-12000000,0.0,16682600.867523002,-16682600.867523002
8645,SubUrbia,0,0,0,0.0,0.0,0.0
8646,Emma,0,0,0,0.0,0.0,0.0
8647,Loch Ness,0,0,0,0.0,0.0,0.0
8648,Ed,0,0,0,0.0,0.0,0.0
8649,Ghosts of Mississippi,0,0,0,0.0,0.0,0.0
8650,Sabrina the Teenage Witch,0,0,0,0.0,0.0,0.0
8651,Mystery Science Theater 3000: The Movie,0,0,0,0.0,0.0,0.0
8652,Joe's Apartment,4619014,13000000,-8380986,6421430.58029175,18072817.6064833,-11651387.02619155
8653,Bad Moon,1100000,7000000,-5900000,1529238.41285627,9731517.17272177,-8202278.7598655
8654,Mrs. Winterbourne,10070000,25000000,-14930000,13999482.5613297,34755418.474006295,-20755935.912676595
8655,Bogus,0,32000000,-32000000,0.0,44486935.6467281,-44486935.6467281
8656,Paradise Lost: The Child Murders at Robin Hood Hills,0,0,0,0.0,0.0,0.0
8657,When We Were Kings,2666118,0,2666118,3706481.87164323,0.0,3706481.87164323
8658,Il ciclone,0,0,0,0.0,0.0,0.0
8659,Bernie,0,0,0,0.0,0.0,0.0
8660,A Thin Line Between Love and Hate,0,0,0,0.0,0.0,0.0
8661,Gladiator,457640427,103000000,354640427,579506463.914726,130428087.77734299,449078376.13738304
8662,Memento,39723096,9000000,30723096,50301043.2220954,11396629.0290882,38904414.1930072
8663,How the Grinch Stole Christmas,345141403,123000000,222141403,437049836.952227,155753930.064206,281295906.888021
8664,Cast Away,429632142,90000000,339632142,544039793.4829509,113966290.290882,430073503.19206893
8665,Snatch,83557872,10000000,73557872,105808674.40489301,12662921.1434313,93145753.2614617
8666,Mission: Impossible II,546388105,125000000,421388105,691886948.73239,158286514.29289198,533600434.43949807
8667,Bedazzled,90383208,48000000,42383208,114451543.55943501,60782021.48847061,53669522.0709644
8668,Scary Movie,278019771,19000000,259019771,352054243.648785,24059550.172519602,327994693.4762654
8669,The Emperor's New Groove,169327687,100000000,69327687,214418314.788063,126629211.43431298,87789103.35375
8670,What Women Want,374111707,70000000,304111707,473734704.45755,88640448.0040197,385094256.4535303
8671,Dinosaur,354248063,127500000,226748063,448581528.698231,161452244.57875,287129284.11948097
8672,Charlie's Angels,264105545,92000000,172105545,334434768.987796,116498874.519568,217935894.468228
8673,Chicken Run,224834564,45000000,179834564,284706235.424977,56983145.1454412,227723090.2795358
8674,The Patriot,215294342,110000000,105294342,272625527.537294,139292132.577745,133333394.95954898
8675,Final Destination,53302314,23000000,30302314,67496299.8944418,29124718.629892103,38371581.264549695
8676,Coyote Ugly,113916474,45000000,68916474,144251532.719975,56983145.1454412,87268387.57453379
8677,Romeo Must Die,91036760,25000000,66036760,115279131.303348,31657302.8585784,83621828.4447696
8678,U-571,127666415,62000000,65666415,161662974.580958,78510111.0892746,83152863.49168341
8679,Billy Elliot,110000000,5000000,105000000,139292132.577745,6331460.57171569,132960672.00602931
8680,Gone In Sixty Seconds,237202299,90000000,147202299,300367400.727763,113966290.290882,186401110.436881
8681,Erin Brockovich,256271286,52000000,204271286,324514308.594375,65847189.9458432,258667118.64853182
8682,Meet the Parents,330444045,55000000,275444045,418438688.41514903,69646066.28887261,348792622.12627643
8683,"O Brother, Where Art Thou?",71000000,26000000,45000000,89906740.1183628,32923594.9729216,56983145.145441204
8684,Pitch Black,53187659,23000000,30187659,67351113.1720718,29124718.629892103,38226394.542179696
8685,Boiler Room,28780255,26000000,2780255,36444209.9552846,32923594.9729216,3520614.9823630042
8686,The Road to El Dorado,76432727,95000000,-18567273,96786159.47784191,120297750.862598,-23511591.38475609
8687,Miss Congeniality,212000000,45000000,167000000,268453928.240745,56983145.1454412,211470783.0953038
8688,Frequency,68106245,31000000,37106245,86242400.9810218,39255055.5446373,46987345.43638451
8689,Requiem for a Dream,7390108,4500000,2890108,9358035.48454414,5698314.51454412,3659720.9700000193
8690,Pay It Forward,55707411,40000000,15707411,70541855.25977221,50651684.5737255,19890170.686046712
8691,Joseph: King of Dreams,0,0,0,0.0,0.0,0.0
8692,Hollow Man,190213455,95000000,95213455,240865798.108463,120297750.862598,120568047.24586499
8693,Big Momma's House,173959438,30000000,143959438,220283464.554964,37988763.430294104,182294701.1246699
8694,American Psycho,34266564,7000000,27266564,43391479.7788344,8864044.80040197,34527434.97843243
8695,Dancer in the Dark,40031879,12800000,27231879,50692052.7000386,16208539.063592099,34483513.6364465
8696,Road Trip,119754278,16000000,103754278,151643897.89025602,20260673.829490196,131383224.06076582
8697,Remember the Titans,136706683,30000000,106706683,173110594.660907,37988763.430294104,135121831.2306129
8698,The Gift,12008642,10000000,2008642,15206448.6685698,12662921.1434313,2543527.525138499
8699,The Legend of Bagger Vance,39459427,80000000,-40540573,49967161.246598706,101303369.147451,-51336207.90085229
8700,Traffic,207515725,48000000,159515725,262775526.169699,60782021.48847061,201993504.6812284
8701,"Dude, Whereâ€™s My Car?",73180723,13000000,60180723,92668172.4568295,16461797.4864608,76206374.9703687
8702,The Family Man,124745083,60000000,64745083,157963714.90598,75977526.8605883,81986188.0453917
8703,The Land Before Time VII: The Stone of Cold Fire,0,0,0,0.0,0.0,0.0
8704,The 6th Day,96085477,82000000,14085477,121672281.827999,103835953.376137,17836328.451861992
8705,The Skulls,35007180,15000000,20007180,44329315.97939079,18994381.715147,25334934.264243793
8706,For the Birds,0,0,0,0.0,0.0,0.0
8707,"Me, Myself & Irene",149270999,51000000,98270999,189020688.933822,64580897.8315,124439791.10232201
8708,Shanghai Noon,56932305,55000000,1932305,72092928.8728784,69646066.28887261,2446862.584005788
8709,Unbreakable,248118121,75000000,173118121,314190020.04793596,94971908.5757354,219218111.47220057
8710,Space Cowboys,128884132,65000000,63884132,163204960.01556,82308987.43230401,80895972.58325599
8711,The Whole Nine Yards,106371651,41300000,65071651,134697582.85096002,52297864.3223716,82399718.52858841
8712,Almost Famous,47383689,60000000,-12616311,60001591.729187705,75977526.8605883,-15975935.131400593
8713,Bring It On,90449929,28000000,62449929,114536031.835596,35456179.20160779,79079852.6339882
8714,Chocolat,152500343,25000000,127500343,193109981.775523,31657302.8585784,161452678.91694462
8715,High Fidelity,47126295,30000000,17126295,59675655.736708395,37988763.430294104,21686892.30641429
8716,Red Planet,33463969,80000000,-46536031,42375160.05932321,101303369.147451,-58928209.08812779
8717,Mission to Mars,60874615,90000000,-29125385,77085044.9381745,113966290.290882,-36881245.352707505
8718,The Cell,104155843,33000000,71155843,131891722.65366201,41787639.7733235,90104082.88033852
8719,Shaft,107196498,46000000,61196498,135742080.1026,58249437.2597843,77492642.8428157
8720,An Extremely Goofy Movie,0,0,0,0.0,0.0,0.0
8721,Get Carter,19412993,63600000,-44187007,24582519.951698497,80536178.4722236,-55953658.5205251
8722,The Replacements,0,0,0,0.0,0.0,0.0
8723,The Watcher,0,33000000,-33000000,0.0,41787639.7733235,-41787639.7733235
8724,The Flintstones in Viva Rock Vegas,59468275,83000000,-23531725,75304207.6860892,105102245.49048,-29798037.804390803
8725,2001: A Space Travesty,0,26000000,-26000000,0.0,32923594.9729216,-32923594.9729216
8726,Thirteen Days,34566746,80000000,-45433254,43771597.8783022,101303369.147451,-57531771.2691488
8727,The Beach,144056873,40000000,104056873,182418082.296831,50651684.5737255,131766397.72310552
8728,The Way of the Gun,19125401,0,19125401,24218344.469950303,0.0,24218344.469950303
8729,Batman Beyond: Return of the Joker,0,0,0,0.0,0.0,0.0
8730,The Perfect Storm,325756637,120000000,205756637,412503060.62804,151955053.721176,260548006.90686402
8731,Beethoven's 3rd,0,0,0,0.0,0.0,0.0
8732,Little Nicky,0,85000000,-85000000,0.0,107634829.71916601,-107634829.71916601
8733,The Yards,0,0,0,0.0,0.0,0.0
8734,Titan A.E.,36754634,75000000,-38245366,46542103.1997682,94971908.5757354,-48429805.375967205
8735,28 Days,0,43000000,-43000000,0.0,54450560.9167549,-54450560.9167549
8736,Scream 3,161834276,40000000,121834276,204929467.529231,50651684.5737255,154277782.95550552
8737,Takedown,0,0,0,0.0,0.0,0.0
8738,Vertical Limit,215663859,75000000,140663859,273093444.00051004,94971908.5757354,178121535.42477465
8739,Reindeer Games,32168970,42000000,-9831030,40735313.037540995,53184268.802411795,-12448955.7648708
8740,DragonHeart: A New Beginning,0,0,0,0.0,0.0,0.0
8741,Small Time Crooks,0,0,0,0.0,0.0,0.0
8742,Buzz Lightyear of Star Command: The Adventure Begins,0,0,0,0.0,0.0,0.0
8743,The Tigger Movie,45554533,30000000,15554533,57685345.9104842,37988763.430294104,19696582.4801901
8744,Next Friday,59827328,11000000,48827328,75758873.66862041,13929213.2577745,61829660.410845906
8745,Dracula 2000,33000337,28000000,5000337,41788066.5137661,35456179.20160779,6331887.312158309
8746,The Weight of Water,109130,16000000,-15890870,138190.458438266,20260673.829490196,-20122483.37105193
8747,Best in Show,0,0,0,0.0,0.0,0.0
8748,Vatel,0,35000000,-35000000,0.0,44320224.002009794,-44320224.002009794
8749,Urban Legends: Final Cut,38574362,14000000,24574362,48846410.416417606,17728089.600803897,31118320.81561371
8750,Men of Honor,48814909,32000000,16814909,61813934.32907789,40521347.65898039,21292586.6700975
8751,What Lies Beneath,155464351,100000000,55464351,196863281.732773,126629211.43431298,70234070.29846002
8752,Rules of Engagement,71000000,60000000,11000000,89906740.1183628,75977526.8605883,13929213.257774502
8753,Finding Forrester,80049764,43000000,37049764,101366384.90822901,54450560.9167549,46915823.99147411
8754,Tigerland,0,10000000,-10000000,0.0,12662921.1434313,-12662921.1434313
8755,Chain of Fools,0,20000000,-20000000,0.0,25325842.286862697,-25325842.286862697
8756,Digimon: The Movie,0,5500000,-5500000,0.0,6964606.62888726,-6964606.62888726
8757,Boys and Girls,20627372,16000000,4627372,26120278.5032224,20260673.829490196,5859604.6737322025
8758,Ginger Snaps,0,5000000,-5000000,0.0,6331460.57171569,-6331460.57171569
8759,102 Dalmatians,183611771,85000000,98611771,232506137.71787798,107634829.71916601,124871307.99871197
8760,Nutty Professor II: The Klumps,123307945,84000000,39307945,156143878.389357,106368537.604823,49775340.78453401
8761,Our Lips Are Sealed,0,0,0,0.0,0.0,0.0
8762,Keeping the Faith,37036004,30000000,7036004,46898399.811980896,37988763.430294104,8909636.381686792
8763,Casper's Haunted Christmas,0,0,0,0.0,0.0,0.0
8764,Lost Souls,0,0,0,0.0,0.0,0.0
8765,Supernova,14828081,90000000,-75171919,18776682.041141298,113966290.290882,-95189608.2497407
8766,The 10th Kingdom,0,0,0,0.0,0.0,0.0
8767,Cruel Intentions 2,0,0,0,0.0,0.0,0.0
8768,Frank Herbert's Dune,0,20000000,-20000000,0.0,25325842.286862697,-25325842.286862697
8769,Bounce,36779296,35000000,1779296,46573332.4958921,44320224.002009794,2253108.493882306
8770,The Contender,0,9000000,-9000000,0.0,11396629.0290882,-11396629.0290882
8771,Loser,0,0,0,0.0,0.0,0.0
8772,Where the Heart Is,0,0,0,0.0,0.0,0.0
8773,Nurse Betty,0,24000000,-24000000,0.0,30391010.744235303,-30391010.744235303
8774,Proof of Life,0,65000000,-65000000,0.0,82308987.43230401,-82308987.43230401
8775,The Art of War,30199105,40000000,-9800895,38240888.521720394,50651684.5737255,-12410796.052005105
8776,Whatever It Takes,9902115,15000000,-5097885,12538970.139818901,18994381.715147,-6455411.575328099
8777,Wonder Boys,0,35000000,-35000000,0.0,44320224.002009794,-44320224.002009794
8778,The Kid,69700000,65000000,4700000,88260560.3697167,82308987.43230401,5951572.937412694
8779,Chopper,236185,0,236185,299079.203026134,0.0,299079.203026134
8780,Rugrats In Paris,0,0,0,0.0,0.0,0.0
8781,Highlander: Endgame,15843608,25000000,-9156392,20062635.873143803,31657302.8585784,-11594666.985434595
8782,Love & Basketball,27728118,20000000,7728118,35111897.168976,25325842.286862697,9786054.882113304
8783,Kevin and Perry Go Large,0,0,0,0.0,0.0,0.0
8784,100 Girls,0,0,0,0.0,0.0,0.0
8785,Woman on Top,0,8000000,-8000000,0.0,10130336.914745098,-10130336.914745098
8786,Sexy Beast,0,5000000,-5000000,0.0,6331460.57171569,-6331460.57171569
8787,Bless the Child,0,40000000,-40000000,0.0,50651684.5737255,-50651684.5737255
8788,Gossip,5108820,14000000,-8891180,6469258.47959851,17728089.600803897,-11258831.121205386
8789,Quills,7060876,13500000,-6439124,8941131.59915472,17094943.5436323,-8153811.944477579
8790,The Million Dollar Hotel,0,8000000,-8000000,0.0,10130336.914745098,-10130336.914745098
8791,The Next Best Thing,24362772,25000000,-637228,30850386.0671398,31657302.8585784,-806916.7914385982
8792,Fail Safe,0,0,0,0.0,0.0,0.0
8793,Dungeons & Dragons,15185241,35000000,-19814759,19228950.9327001,44320224.002009794,-25091273.069309693
8794,The Crow: Salvation,0,10000000,-10000000,0.0,12662921.1434313,-12662921.1434313
8795,The Ladies Man,13700000,24000000,-10300000,17348201.966501,30391010.744235303,-13042808.777734302
8796,Animal Factory,0,0,0,0.0,0.0,0.0
8797,Hamlet,1568749,2000000,-431251,1986494.48808368,2532584.22868627,-546089.7406025899
8798,Under Suspicion,260562,25000000,-24739438,329947.605897476,31657302.8585784,-31327355.252680924
8799,Ready to Rumble,12372410,24000000,-11627590,15667085.2184201,30391010.744235303,-14723925.525815204
8800,Ordinary Decent Criminal,0,0,0,0.0,0.0,0.0
8801,Center Stage,17200925,18000000,-799075,21781395.6869077,22793258.058176503,-1011862.3712688014
8802,Before Night Falls,8524534,0,8524534,10794550.182649901,0.0,10794550.182649901
8803,Python,0,0,0,0.0,0.0,0.0
8804,Return to Me,36609995,24000000,12609995,46358947.9746417,30391010.744235303,15967937.2304064
8805,Nuremberg,0,24000000,-24000000,0.0,30391010.744235303,-30391010.744235303
8806,Book of Shadows: Blair Witch 2,0,0,0,0.0,0.0,0.0
8807,Down to You,0,9000000,-9000000,0.0,11396629.0290882,-11396629.0290882
8808,Saving Grace,26330482,10000000,16330482,33342081.7234539,12662921.1434313,20679160.580022603
8809,The Broken Hearts Club: A Romantic Comedy,1744858,1000000,744858,2209499.92604854,1266292.11434313,943207.81170541
8810,PokÃ©mon: Mewtwo Returns,0,0,0,0.0,0.0,0.0
8811,Blood: The Last Vampire,0,0,0,0.0,0.0,0.0
8812,Duets,0,0,0,0.0,0.0,0.0
8813,What Planet Are You From?,0,60000000,-60000000,0.0,75977526.8605883,-75977526.8605883
8814,Alvin and the Chipmunks Meet the Wolfman,0,0,0,0.0,0.0,0.0
8815,Drowning Mona,15427192,16000000,-572808,19535331.5760575,20260673.829490196,-725342.2534326948
8816,Heavy Metal 2000,0,15000000,-15000000,0.0,18994381.715147,-18994381.715147
8817,Gun Shy,1631839,10000000,-8368161,2066384.85757759,12662921.1434313,-10596536.28585371
8818,Hellraiser: Inferno,0,2000000,-2000000,0.0,2532584.22868627,-2532584.22868627
8819,Crocodile,0,0,0,0.0,0.0,0.0
8820,Shriek If You Know What I Did Last Friday the Thirteenth,0,5000000,-5000000,0.0,6331460.57171569,-6331460.57171569
8821,Psycho Beach Party,0,1500000,-1500000,0.0,1899438.1715147,-1899438.1715147
8822,I Dreamed of Africa,0,34000000,-34000000,0.0,43053931.8876667,-43053931.8876667
8823,Happy Accidents,688510,0,688510,871854.783646394,0.0,871854.783646394
8824,Father and Daughter,0,0,0,0.0,0.0,0.0
8825,Bait,0,35000000,-35000000,0.0,44320224.002009794,-44320224.002009794
8826,X-Men,157299717,75000000,82299717,199187391.22550702,94971908.5757354,104215482.64977162
8827,Girlfight,0,0,0,0.0,0.0,0.0
8828,If These Walls Could Talk 2,0,0,0,0.0,0.0,0.0
8829,Skipped Parts,0,0,0,0.0,0.0,0.0
8830,The Prophecy 3: The Ascent,0,0,0,0.0,0.0,0.0
8831,Juste une question d'amour,0,0,0,0.0,0.0,0.0
8832,Cecil B. Demented,0,10000000,-10000000,0.0,12662921.1434313,-12662921.1434313
8833,Jet Set,0,0,0,0.0,0.0,0.0
8834,Nico and Dani,0,0,0,0.0,0.0,0.0
8835,Dr. T and the Women,0,12000000,-12000000,0.0,15195505.3721176,-15195505.3721176
8836,Autumn in New York,0,65000000,-65000000,0.0,82308987.43230401,-82308987.43230401
8837,The Golden Bowl,0,15000000,-15000000,0.0,18994381.715147,-18994381.715147
8838,The Man Who Cried,0,0,0,0.0,0.0,0.0
8839,Dave Chappelle: Killin' Them Softly,0,0,0,0.0,0.0,0.0
8840,The Dish,0,0,0,0.0,0.0,0.0
8841,About Adam,151559,0,151559,191917.966557731,0.0,191917.966557731
8842,The Filth and the Fury,0,0,0,0.0,0.0,0.0
8843,Cherry Falls,0,0,0,0.0,0.0,0.0
8844,"Love, Honour and Obey",0,0,0,0.0,0.0,0.0
8845,Le goÃ»t des autres,0,0,0,0.0,0.0,0.0
8846,Jalla! Jalla!,0,0,0,0.0,0.0,0.0
8847,Essex Boys,0,0,0,0.0,0.0,0.0
8848,Here On Earth,0,0,0,0.0,0.0,0.0
8849,Timecode,0,4000000,-4000000,0.0,5065168.45737255,-5065168.45737255
8850,Lucky Numbers,0,65000000,-65000000,0.0,82308987.43230401,-82308987.43230401
8851,Snow Day,0,0,0,0.0,0.0,0.0
8852,My Dog Skip,0,7000000,-7000000,0.0,8864044.80040197,-8864044.80040197
8853,Bruiser,0,5000000,-5000000,0.0,6331460.57171569,-6331460.57171569
8854,Quints,0,0,0,0.0,0.0,0.0
8855,The Up in Smoke Tour,0,0,0,0.0,0.0,0.0
8856,Life-Size,0,0,0,0.0,0.0,0.0
8857,Leprechaun in the Hood,0,0,0,0.0,0.0,0.0
8858,Pollock,0,0,0,0.0,0.0,0.0
8859,The Little Mermaid II: Return to the Sea,0,0,0,0.0,0.0,0.0
8860,The Little Vampire,13555988,22000000,-8444012,17165840.7065302,27858426.515549,-10692585.809018802
8861,John Henry,0,0,0,0.0,0.0,0.0
8862,Shadow of the Vampire,8279017,8000000,279017,10483653.9416127,10130336.914745098,353317.026867602
8863,Left Behind,0,0,0,0.0,0.0,0.0
8864,Paradise Lost 2: Revelations,0,0,0,0.0,0.0,0.0
8865,Scooby-Doo and the Alien Invaders,0,0,0,0.0,0.0,0.0
8866,The Adventures of Rocky & Bullwinkle,35134820,76000000,-40865180,44490945.504865505,96238200.6900785,-51747255.18521299
8867,Tillsammans,0,0,0,0.0,0.0,0.0
8868,The Big Kahuna,3728888,7000000,-3271112,4721861.46966875,8864044.80040197,-4142183.330733221
8869,You Can Count on Me,0,0,0,0.0,0.0,0.0
8870,All the Pretty Horses,0,57000000,-57000000,0.0,72178650.51755892,-72178650.51755892
8871,Gangster No. 1,0,0,0,0.0,0.0,0.0
8872,The Audrey Hepburn Story,0,0,0,0.0,0.0,0.0
8873,Chlopaki nie placza,0,0,0,0.0,0.0,0.0
8874,Mission Kashmir,0,0,0,0.0,0.0,0.0
8875,Ð‘Ñ€Ð°Ñ‚ 2,0,1500000,-1500000,0.0,1899438.1715147,-1899438.1715147
8876,State and Main,0,0,0,0.0,0.0,0.0
8877,Phantom of the Megaplex,0,0,0,0.0,0.0,0.0
8878,Mom's Got a Date With a Vampire,0,0,0,0.0,0.0,0.0
8879,"Ali G, Aiii",0,0,0,0.0,0.0,0.0
8880,The World of Stainboy,0,0,0,0.0,0.0,0.0
8881,Hanging Up,36037909,40000000,-3962091,45634519.9841156,50651684.5737255,-5017164.589609899
8882,Rejected,0,0,0,0.0,0.0,0.0
8883,The In Crowd,5217498,15000000,-9782502,6606876.57400109,18994381.715147,-12387505.141145911
8884,Phir Bhi Dil Hai Hindustani,0,0,0,0.0,0.0,0.0
8885,The Tao of Steve,0,0,0,0.0,0.0,0.0
8886,George Washington,0,0,0,0.0,0.0,0.0
8887,Is It Fall Yet?,0,0,0,0.0,0.0,0.0
8888,Blade Runner,32768670,28000000,4768670,74045476.2072083,63269987.2714343,10775488.935774006
8889,E.T. the Extra-Terrestrial,792910554,10500000,782410554,1791694309.24878,23726245.2267878,1767968064.0219922
8890,The Thing,13782838,10000000,3782838,31144285.1722943,22596424.025512196,8547861.146782104
8891,First Blood,125212904,15000000,110212904,282936387.224976,33894636.038268395,249041751.18670762
8892,Cat People,0,0,0,0.0,0.0,0.0
8893,Tron,33000000,17000000,16000000,74568199.2841904,38413920.843370795,36154278.440819606
8894,Rocky III,124000000,17000000,107000000,280195657.916352,38413920.843370795,241781737.07298118
8895,Poltergeist,122200000,10700000,111500000,276128301.59175897,24178173.7072981,251950127.88446087
8896,Conan the Barbarian,68851475,20000000,48851475,155579712.388195,45192848.0510245,110386864.33717051
8897,48 Hrs.,78868508,1000000,77868508,178214624.90275,2259642.40255122,175954982.50019875
8898,Star Trek II: The Wrath of Khan,96800000,12000000,84800000,218733384.566958,27115708.8306147,191617675.73634332
8899,Fast Times at Ridgemont High,27092880,4500000,22592880,61220220.455231994,10168390.8114805,51051829.643751495
8900,Evil Under the Sun,6110000,0,6110000,13806415.0795879,0.0,13806415.0795879
8901,The Dark Crystal,40577001,15000000,25577001,91689512.0279635,33894636.038268395,57794875.98969511
8902,Pink Floyd: The Wall,0,0,0,0.0,0.0,0.0
8903,Gandhi,77737889,22000000,55737889,175659830.26922,49712132.8561269,125947697.41309309
8904,Tootsie,177200000,21000000,156200000,400408633.732077,47452490.4535757,352956143.2785013
8905,Airplane II: The Sequel,27150534,0,27150534,61350497.878308706,0.0,61350497.878308706
8906,The King of Comedy,0,20000000,-20000000,0.0,45192848.0510245,-45192848.0510245
8907,Night Shift,21017056,0,21017056,47491030.914393604,0.0,47491030.914393604
8908,Trail of the Pink Panther,9056073,0,9056073,20463486.5513992,0.0,20463486.5513992
8909,Dead Men Don't Wear Plaid,18196170,0,18196170,41116837.2960305,0.0,41116837.2960305
8910,Swamp Thing,0,3000000,-3000000,0.0,6778927.20765368,-6778927.20765368
8911,The Secret of NIMH,14665733,7000000,7665733,33139312.1512948,15817496.817858499,17321815.333436303
8912,The Snowman,0,0,0,0.0,0.0,0.0
8913,The Last Unicorn,6455530,0,6455530,14587189.3189415,0.0,14587189.3189415
8914,An Officer and a Gentleman,129795554,0,129795554,293291537.481027,0.0,293291537.481027
8915,Tenebre,0,0,0,0.0,0.0,0.0
8916,Sophie's Choice,30036000,12000000,18036000,67870619.2030286,27115708.8306147,40754910.3724139
8917,A Midsummer Night's Sex Comedy,0,0,0,0.0,0.0,0.0
8918,Grease 2,15171476,13200000,1971476,34282110.4788882,29827279.7136761,4454830.7652121
8919,Creepshow,21028755,8000000,13028755,47517466.4708611,18077139.220409803,29440327.250451297
8920,Annie,57059003,50000000,7059003,128932942.626097,112982120.12756102,15950822.498535976
8921,Koyaanisqatsi,1723872,0,1723872,3895334.26777078,0.0,3895334.26777078
8922,Missing,14000000,0,14000000,31634993.6357171,0.0,31634993.6357171
8923,Vincent,0,60000,-60000,0.0,135578.54415307302,-135578.54415307302
8924,The World According to Garp,0,0,0,0.0,0.0,0.0
8925,The Sword and the Sorcerer,0,0,0,0.0,0.0,0.0
8926,The Entity,13277558,0,13277558,30002533.059133198,0.0,30002533.059133198
8927,Honkytonk Man,0,0,0,0.0,0.0,0.0
8928,The Year of Living Dangerously,10278575,6000000,4278575,23225903.9078029,13557854.415307302,9668049.492495596
8929,The Toy,0,0,0,0.0,0.0,0.0
8930,Friday the 13th Part III,36690067,4000000,32690067,82906431.14564541,9038569.610204902,73867861.5354405
8931,Class of 1984,0,4300000,-4300000,0.0,9716462.33097027,-9716462.33097027
8932,Halloween III: Season of the Witch,14400000,2500000,11900000,32538850.596737605,5649106.00637806,26889744.590359546
8933,The Verdict,53977250,16000000,37977250,121969282.87310801,36154278.440819606,85815004.43228841
8934,The Last American Virgin,0,0,0,0.0,0.0,0.0
8935,Victor/Victoria,28215453,0,28215453,63756834.0059912,0.0,63756834.0059912
8936,Firefox,70687344,18000000,52687344,159728119.826125,40673563.245922,119054556.580203
8937,The Border,0,22000000,-22000000,0.0,49712132.8561269,-49712132.8561269
8938,Silent Rage,0,4500000,-4500000,0.0,10168390.8114805,-10168390.8114805
8939,Amityville II: The Possession,12534817,0,12534817,28324204.001419898,0.0,28324204.001419898
8940,The Best Little Whorehouse in Texas,0,0,0,0.0,0.0,0.0
8941,Zapped!,0,0,0,0.0,0.0,0.0
8942,Deathtrap,0,0,0,0.0,0.0,0.0
8943,Fitzcarraldo,0,0,0,0.0,0.0,0.0
8944,Death Wish 2,16,2,14,36.1542784408196,4.51928480510245,31.63499363571715
8945,The Beastmaster,14056528,0,14056528,31762726.7014485,0.0,31762726.7014485
8946,Monty Python Live at the Hollywood Bowl,0,0,0,0.0,0.0,0.0
8947,Shao Lin Si,0,0,0,0.0,0.0,0.0
8948,The Flight of Dragons,0,0,0,0.0,0.0,0.0
8949,Mil gritos tiene la noche,1198346,0,1198346,2707833.43452765,0.0,2707833.43452765
8950,The Man from Snowy River,20659423,3500000,17159423,46682908.223042,7908748.40892929,38774159.81411271
8951,White Dog,0,8000000,-8000000,0.0,18077139.220409803,-18077139.220409803
8952,Q,0,0,0,0.0,0.0,0.0
8953,The Plague Dogs,0,0,0,0.0,0.0,0.0
8954,The Draughtsman's Contract,0,0,0,0.0,0.0,0.0
8955,Ren zhe wu di,0,0,0,0.0,0.0,0.0
8956,Turkey Shoot,0,32000000,-32000000,0.0,72308556.88163921,-72308556.88163921
8957,Liquid Sky,0,0,0,0.0,0.0,0.0
8958,Basket Case,0,35000,-35000,0.0,79087.4840892929,-79087.4840892929
8959,My Favorite Year,0,0,0,0.0,0.0,0.0
8960,Megaforce,0,0,0,0.0,0.0,0.0
8961,Diner,0,0,0,0.0,0.0,0.0
8962,The Slumber Party Massacre,0,0,0,0.0,0.0,0.0
8963,Oliver Twist,0,0,0,0.0,0.0,0.0
8964,Forbidden World,0,0,0,0.0,0.0,0.0
8965,Summer Lovers,0,0,0,0.0,0.0,0.0
8966,Made in Britain,0,0,0,0.0,0.0,0.0
8967,Madman,0,0,0,0.0,0.0,0.0
8968,Vokzal dlya Dvoikh,0,0,0,0.0,0.0,0.0
8969,The Truman Show,264118201,60000000,204118201,353309720.778811,80261728.1446979,273047992.6341131
8970,Armageddon,553799566,140000000,413799566,740815170.215728,187277365.67096102,553537804.544767
8971,Mulan,304320254,90000000,214320254,407087824.924557,120392592.217046,286695232.70751095
8972,Blade,131183530,45000000,86183530,175483613.698697,60196296.1085234,115287317.5901736
8973,The Big Lebowski,27739163,15000000,12739163,37106552.66112439,20065432.036174398,17041120.624949995
8974,Saving Private Ryan,481840909,70000000,411840909,644556400.785869,93638682.83548091,550917717.9503881
8975,The Lion King 2: Simba's Pride,0,0,0,0.0,0.0,0.0
8976,Rush Hour,244386864,33000000,211386864,326915200.675054,44143950.47958379,282771250.1954702
8977,A Bug's Life,363398565,120000000,243398565,486116613.870056,160523456.289395,325593157.58066094
8978,The Prince of Egypt,218613188,70000000,148613188,292437871.068362,93638682.83548091,198799188.23288107
8979,Antz,171757863,60000000,111757863,229759715.113671,80261728.1446979,149497986.9689731
8980,Species II,0,35000000,-35000000,0.0,46819341.4177404,-46819341.4177404
8981,Ronin,41610884,55000000,-13389116,55662690.9911427,73573250.79930641,-17910559.80816371
8982,Dark City,27200316,27000000,200316,36385739.4706979,36117777.665114,267961.8055839017
8983,Pocahontas II: Journey to a New World,0,0,0,0.0,0.0,0.0
8984,Wild Things,67200000,20000000,47200000,89893135.5220617,26753909.3815659,63139226.14049581
8985,There's Something About Mary,369884651,23000000,346884651,494793021.724308,30766995.7888008,464026025.93550724
8986,The X Files,189198313,66000000,123198313,253089726.05735698,88287900.9591677,164801825.0981893
8987,American History X,23875127,20000000,3875127,31937649.211568896,26753909.3815659,5183739.830002997
8988,What Dreams May Come,71485043,85000000,-13514957,95625218.1279674,113704114.871655,-18078896.7436876
8989,Enemy of the State,250649836,90000000,160649836,335293149.94241804,120392592.217046,214900557.72537205
8990,The Man in the Iron Mask,0,0,0,0.0,0.0,0.0
8991,Deep Impact,140464664,75000000,65464664,187898944.598405,100327160.180872,87571784.41753301
8992,Lost in Space,136159423,80000000,56159423,182139843.21941498,107015637.526263,75124205.69315198
8993,The Negotiator,44547681,50000000,-5452319,59591231.031645395,66884773.453914896,-7293542.422269501
8994,Meet Joe Black,142940100,90000000,52940100,191210324.11959898,120392592.217046,70817731.90255299
8995,Lethal Weapon 4,285444603,140000000,145444603,381837952.105954,187277365.67096102,194560586.43499297
8996,I Still Know What You Did Last Summer,40002112,65000000,-24997888,53510643.9759626,86950205.4900894,-33439561.5141268
8997,Godzilla,379014294,130000000,249014294,507005703.79971,173900410.980178,333105292.819532
8998,Practical Magic,46683377,75000000,-28316623,62448141.8941741,100327160.180872,-37879018.286697894
8999,Sphere,13100000,75000000,-61900000,17523810.6449257,100327160.180872,-82803349.5359463
9000,Six Days Seven Nights,164000000,70000000,94000000,219382056.928841,93638682.83548091,125743374.09336008
9001,Fear and Loathing in Las Vegas,10680275,18500000,-7819725,14286955.4760102,24747366.177948497,-10460410.701938298
9002,Shakespeare in Love,289317794,25000000,264317794,387019102.157528,33442386.726957396,353576715.4305706
9003,The Mask of Zorro,250288523,95000000,155288523,334809823.179399,127081069.56243798,207728753.61696103
9004,The Waterboy,185991646,23000000,162991646,248800182.140615,30766995.7888008,218033186.35181418
9005,A Perfect Murder,128038368,60000000,68038368,171276344.741779,80261728.1446979,91014616.5970811
9006,Pi,3221152,60000,3161152,4308920.4356125,80261.7281446979,4228658.707467802
9007,City of Angels,198685114,55000000,143685114,265780176.771105,73573250.79930641,192206925.9717986
9008,The Parent Trap,0,0,0,0.0,0.0,0.0
9009,The Thin Red Line,98126565,52000000,46126565,131263461.396717,69560164.3920715,61703297.0046455
9010,Jack Frost,0,27000000,-27000000,0.0,36117777.665114,-36117777.665114
9011,Small Soldiers,54682547,40000000,14682547,73148595.3595611,53507818.763131894,19640776.596429206
9012,Doctor Dolittle,294456605,71000000,223456605,393893266.348678,94976378.3045592,298916888.04411876
9013,Star Trek: Insurrection,118000000,70000000,48000000,157848065.351239,93638682.83548091,64209382.51575808
9014,You've Got Mail,250821495,65000000,185821495,335522777.408945,86950205.4900894,248572571.9188556
9015,U.S. Marshals,102367405,60000000,42367405,136936413.849803,80261728.1446979,56674685.705105096
9016,Elizabeth,82150642,30000000,52150642,109892541.585273,40130864.0723489,69761677.5129241
9017,Out of Sight,77745568,48000000,29745568,103999894.054518,64209382.5157583,39790511.5387597
9018,The Wedding Singer,123306987,18000000,105306987,164947197.81559598,24078518.4434093,140868679.3721867
9019,Rushmore,0,0,0,0.0,0.0,0.0
9020,EverAfter,65705772,26000000,39705772,87894313.4966918,34780082.1960357,53114231.300656095
9021,Patch Adams,202292902,50000000,152292902,270606298.4321,66884773.453914896,203721524.97818512
9022,Fallen,25232289,0,25232289,33753118.6697742,0.0,33753118.6697742
9023,Urban Legend,72527595,14000000,58527595,97019835.2146459,18727736.567096103,78292098.64754981
9024,Quest for Camelot,0,0,0,0.0,0.0,0.0
9025,Rounders,22921898,12000000,10921898,30662519.097274896,16052345.628939498,14610173.468335398
9026,Les MisÃ©rables,14096321,0,14096321,18856584.7323732,0.0,18856584.7323732
9027,Disturbing Behavior,17507368,15000000,2507368,23419526.8490864,20065432.036174398,3354094.812912002
9028,Babe: Pig in the City,69131860,90000000,-20868140,92477375.8909553,120392592.217046,-27915216.326090693
9029,Babylon 5: Thirdspace,0,0,0,0.0,0.0,0.0
9030,"Lock, Stock and Two Smoking Barrels",3897569,1350000,2547569,5213760.39172004,1805888.8832556999,3407871.50846434
9031,Addams Family Reunion,0,0,0,0.0,0.0,0.0
9032,I'll Be Home for Christmas,0,30000000,-30000000,0.0,40130864.0723489,-40130864.0723489
9033,Stepmom,0,0,0,0.0,0.0,0.0
9034,A Night at the Roxbury,30331165,17000000,13331165,40573861.9923663,22740822.974331,17833039.0180353
9035,The Horse Whisperer,186883563,60000000,126883563,249993295.470309,80261728.1446979,169731567.32561108
9036,Mighty Joe Young,0,90000000,-90000000,0.0,120392592.217046,-120392592.217046
9037,Hope Floats,0,0,0,0.0,0.0,0.0
9038,Bride of Chucky,50671850,25000000,25671850,67783504.1548152,33442386.726957396,34341117.4278578
9039,Vampires,0,20000000,-20000000,0.0,26753909.3815659,-26753909.3815659
9040,54,16757163,13000000,3757163,22415981.0197065,17390041.0980178,5025939.921688698
9041,Great Expectations,55494066,25000000,30494066,74234160.6489321,33442386.726957396,40791773.9219747
9042,Belle's Magical World,0,0,0,0.0,0.0,0.0
9043,The Siege,116672912,70000000,46672912,156072825.746571,93638682.83548091,62434142.91109009
9044,Snake Eyes,103891409,73000000,30891409,138975067.09546,97651769.24271579,41323297.85274421
9045,Phantoms,5624282,0,5624282,7523576.54821863,0.0,7523576.54821863
9046,Primary Colors,0,65000000,-65000000,0.0,86950205.4900894,-86950205.4900894
9047,Sliding Doors,58000000,6000000,52000000,77586337.2065413,8026172.81446979,69560164.39207152
9048,The Land Before Time VI: The Secret of Saurus Rock,0,0,0,0.0,0.0,0.0
9049,Twilight,0,0,0,0.0,0.0,0.0
9050,The Last Days of Disco,0,8000000,-8000000,0.0,10701563.7526263,-10701563.7526263
9051,The Avengers,48522832,60000000,-11477168,64908772.5132475,80261728.1446979,-15352955.631450407
9052,A Knight in Camelot,0,0,0,0.0,0.0,0.0
9053,Mercury Rising,0,60000000,-60000000,0.0,80261728.1446979,-80261728.1446979
9054,Simon Birch,18253415,20000000,-1746585,24417510.5407058,26753909.3815659,-2336398.8408600986
9055,The Big Hit,27007143,13000000,14007143,36127332.8238497,17390041.0980178,18737291.7258319
9056,Pleasantville,0,0,0,0.0,0.0,0.0
9057,Blues Brothers 2000,14051384,28000000,-13948616,18796472.7110793,37455473.134192295,-18659000.423112996
9058,He Got Game,21567853,25000000,-3432147,28851219.235846803,33442386.726957396,-4591167.491110593
9059,Hard Rain,19870567,70000000,-50129433,26580767.4439167,93638682.83548091,-67057915.39156421
9060,A Civil Action,56702901,70000000,-13297099,75851213.7512953,93638682.83548091,-17787469.084185615
9061,Rudolph the Red-Nosed Reindeer: The Movie,0,0,0,0.0,0.0,0.0
9062,Gia,0,0,0,0.0,0.0,0.0
9063,Happiness,2807390,3000000,-192610,3755432.88293572,4013086.40723489,-257653.5242991699
9064,The Replacement Killers,19204929,30000000,-10795071,25690346.5072704,40130864.0723489,-14440517.5650785
9065,Desperate Measures,0,50000000,-50000000,0.0,66884773.453914896,-66884773.453914896
9066,Velvet Goldmine,1053788,0,1053788,1409647.43296908,0.0,1409647.43296908
9067,SLC Punk,299200,0,299200,400238.48434822704,0.0,400238.48434822704
9068,Hilary and Jackie,0,0,0,0.0,0.0,0.0
9069,Legionnaire,0,20000000,-20000000,0.0,26753909.3815659,-26753909.3815659
9070,Black Dog,0,0,0,0.0,0.0,0.0
9071,The Swan Princess: The Mystery of the Enchanted Kingdom,0,0,0,0.0,0.0,0.0
9072,The Faculty,40283321,15000000,25283321,53886815.9811267,20065432.036174398,33821383.94495231
9073,Playing by Heart,3970078,20000000,-16029922,5310755.35248743,26753909.3815659,-21443154.02907847
9074,The Mighty,0,0,0,0.0,0.0,0.0
9075,Celebrity,0,0,0,0.0,0.0,0.0
9076,The Prophecy II,0,0,0,0.0,0.0,0.0
9077,BASEketball,7027290,0,7027290,9400373.99289924,0.0,9400373.99289924
9078,Thursday,0,0,0,0.0,0.0,0.0
9079,Holy Man,0,60000000,-60000000,0.0,80261728.1446979,-80261728.1446979
9080,Merlin,0,0,0,0.0,0.0,0.0
9081,Phantasm IV: Oblivion,0,650000,-650000,0.0,869502.054900894,-869502.054900894
9082,Batman & Mr. Freeze: SubZero,0,0,0,0.0,0.0,0.0
9083,Can't Hardly Wait,25605015,10000000,15605015,34251712.5511819,13376954.6907829,20874757.860398997
9084,Halloween: H20,55041738,17000000,38041738,73629083.5327948,22740822.974331,50888260.558463804
9085,Psycho,37141130,60000000,-22858870,49683521.3174481,80261728.1446979,-30578206.827249803
9086,Croupier,0,0,0,0.0,0.0,0.0
9087,Savior,0,10000000,-10000000,0.0,13376954.6907829,-13376954.6907829
9088,Deep Rising,11203026,45000000,-33796974,14986237.1201663,60196296.1085234,-45210058.9883571
9089,The Red Violin,9495408,18000000,-8504592,12701964.2586498,24078518.4434093,-11376554.184759501
9090,A Simple Plan,0,0,0,0.0,0.0,0.0
9091,Very Bad Things,9898412,30000000,-20101588,13241060.8834702,40130864.0723489,-26889803.1888787
9092,Soldier,14567883,75000000,-60432117,19487391.0831627,100327160.180872,-80839769.0977093
9093,The Patriot,0,25000000,-25000000,0.0,33442386.726957396,-33442386.726957396
9094,The Opposite of Sex,5879254,5000000,879254,7864651.43736047,6688477.34539149,1176174.0919689806
9095,High Art,1929168,0,1929168,2580639.29269084,0.0,2580639.29269084
9096,Dangerous Beauty,0,0,0,0.0,0.0,0.0
9097,Casper Meets Wendy,0,0,0,0.0,0.0,0.0
9098,Another Day in Paradise,0,0,0,0.0,0.0,0.0
9099,Palmetto,0,0,0,0.0,0.0,0.0
9100,An American Tail: The Treasure of Manhattan Island,0,0,0,0.0,0.0,0.0
9101,Dead Man on Campus,0,0,0,0.0,0.0,0.0
9102,Creature,0,0,0,0.0,0.0,0.0
9103,Major League: Back to the Minors,3572443,0,3572443,4778840.81464048,0.0,4778840.81464048
9104,Bulworth,29202884,30000000,-797116,39064565.6108191,40130864.0723489,-1066298.4615297988
9105,The Rugrats Movie,100491683,0,100491683,134427269.029152,0.0,134427269.029152
9106,The Gingerbread Man,0,0,0,0.0,0.0,0.0
9107,Madeline,0,0,0,0.0,0.0,0.0
9108,Scooby-Doo on Zombie Island,0,0,0,0.0,0.0,0.0
9109,Dance With Me,15,0,15,20.065432036174396,0.0,20.065432036174396
9110,My Name Is Joe,0,0,0,0.0,0.0,0.0
9111,Sat sau ji wong,0,0,0,0.0,0.0,0.0
9112,Senseless,13035599,0,13035599,17437661.7190216,0.0,17437661.7190216
9113,Hush,0,0,0,0.0,0.0,0.0
9114,Buffalo '66,2375097,1500000,875097,3177156.49552146,2006543.20361744,1170613.2919040201
9115,Half Baked,17460020,8000000,9460020,23356189.644016396,10701563.7526263,12654625.891390096
9116,The Wisdom of Crocodiles,0,0,0,0.0,0.0,0.0
9117,Permanent Midnight,0,0,0,0.0,0.0,0.0
9118,Gods and Monsters,6451628,10000000,-3548372,8630313.54377869,13376954.6907829,-4746641.147004211
9119,Without Limits,777423,25000000,-24222577,1039955.22465725,33442386.726957396,-32402431.502300147
9120,Love Is the Devil: Study for a Portrait of Francis Bacon,0,0,0,0.0,0.0,0.0
9121,Jane Austen's Mafia!,19000000,10000000,9000000,25416213.9124876,13376954.6907829,12039259.2217047
9122,Air Bud: Golden Receiver,10224116,0,10224116,13676753.6485309,0.0,13676753.6485309
9123,Zero Effect,1980338,5000000,-3019662,2649089.16984358,6688477.34539149,-4039388.1755479095
9124,Halloweentown,0,0,0,0.0,0.0,0.0
9125,Babylon 5: In the Beginning,0,0,0,0.0,0.0,0.0
9126,The Second Arrival,0,0,0,0.0,0.0,0.0
9127,Six-String Samurai,124494,2000000,-1875506,166535.05972743302,2675390.93815659,-2508855.8784291567
9128,Belly,0,0,0,0.0,0.0,0.0
9129,Following,0,0,0,0.0,0.0,0.0
9130,Return to Paradise,0,0,0,0.0,0.0,0.0
9131,Futuresport,0,0,0,0.0,0.0,0.0
9132,Alice Through the Looking Glass,0,0,0,0.0,0.0,0.0
9133,Il fantasma dell'opera,0,0,0,0.0,0.0,0.0
9134,Edge of Seventeen,870751,1500000,-629249,1164799.66739539,2006543.20361744,-841743.53622205
9135,Knock Off,0,33000000,-33000000,0.0,44143950.47958379,-44143950.47958379
9136,Waking Ned,0,0,0,0.0,0.0,0.0
9137,Everest,76447420,0,76447420,102263367.356725,0.0,102263367.356725
9138,Dirty Work,0,0,0,0.0,0.0,0.0
9139,Hurlyburly,0,0,0,0.0,0.0,0.0
9140,Strike!,0,0,0,0.0,0.0,0.0
9141,Home Fries,10443316,15000000,-4556684,13969976.4953529,20065432.036174398,-6095455.540821498
9142,Pecker,0,0,0,0.0,0.0,0.0
9143,Dennis the Menace Strikes Again!,0,0,0,0.0,0.0,0.0
9144,Letters From a Killer,0,0,0,0.0,0.0,0.0
9145,Strangeland,631221,1100000,-468779,844381.471687073,1471465.01598612,-627083.5442990471
9146,The Acid House,0,0,0,0.0,0.0,0.0
9147,The Object of My Affection,46905889,15000000,31905889,62745795.1883896,20065432.036174398,42680363.1522152
9148,Rear Window,0,0,0,0.0,0.0,0.0
9149,Tale of the Mummy,0,0,0,0.0,0.0,0.0
9150,My Giant,7985929,0,7985929,10682741.0396809,0.0,10682741.0396809
9151,Sabrina Goes to Rome,0,0,0,0.0,0.0,0.0
9152,The Newton Boys,76000000,27000000,49000000,101664855.64995,36117777.665114,65547077.984836
9153,How Stella Got Her Groove Back,37672350,20000000,17672350,50394131.9045318,26753909.3815659,23640222.5229659
9154,Still Crazy,0,0,0,0.0,0.0,0.0
9155,The Odd Couple II,0,0,0,0.0,0.0,0.0
9156,Little Voice,0,0,0,0.0,0.0,0.0
9157,Krippendorf's Tribe,0,0,0,0.0,0.0,0.0
9158,Brink!,0,0,0,0.0,0.0,0.0
9159,Full Tilt Boogie,0,0,0,0.0,0.0,0.0
9160,Goodnight Mister Tom,0,0,0,0.0,0.0,0.0
9161,Jerry Seinfeld: I'm Telling You for the Last Time,0,0,0,0.0,0.0,0.0
9162,Kurt & Courtney,0,0,0,0.0,0.0,0.0
9163,Dead Man's Curve,0,1000000,-1000000,0.0,1337695.46907829,-1337695.46907829
9164,Almost Heroes,0,0,0,0.0,0.0,0.0
9165,Get Real,0,0,0,0.0,0.0,0.0
9166,Clay Pigeons,0,0,0,0.0,0.0,0.0
9167,Slums of Beverly Hills,0,5000000,-5000000,0.0,6688477.34539149,-6688477.34539149
9168,Children of the Corn V: Fields of Terror,0,0,0,0.0,0.0,0.0
9169,The Temptations,0,8000000,-8000000,0.0,10701563.7526263,-10701563.7526263
9170,3 Ninjas: High Noon at Mega Mountain,0,0,0,0.0,0.0,0.0
9171,The Batman Superman Movie: World's Finest,0,0,0,0.0,0.0,0.0
9172,Paulie,0,0,0,0.0,0.0,0.0
9173,A Murder of Crows,0,0,0,0.0,0.0,0.0
9174,Billboard Dad,0,0,0,0.0,0.0,0.0
9175,Moby Dick,0,0,0,0.0,0.0,0.0
9176,New Rose Hotel,0,0,0,0.0,0.0,0.0
9177,Last Night,0,0,0,0.0,0.0,0.0
9178,Ghulam,0,0,0,0.0,0.0,0.0
9179,The Little Mermaid,211343479,40000000,171343479,371749996.526004,70359397.5617302,301390598.9642738
9180,Indiana Jones and the Last Crusade,474171806,48000000,426171806,834061065.27294,84431277.0740763,749629788.1988637
9181,When Harry Met Sally...,92823546,16000000,76823546,163275219.40258798,28143759.024692103,135131460.3778959
9182,Batman,411348924,35000000,376348924,723556562.0076491,61564472.8665139,661992089.1411352
9183,Back to the Future Part II,332000000,40000000,292000000,583982999.762361,70359397.5617302,513623602.20063084
9184,Dead Poets Society,235860116,16400000,219460116,414874391.76499504,28847353.0003094,386027038.76468563
9185,Ghostbusters II,215394738,37000000,178394738,378876100.09116805,65082442.7446004,313793657.34656763
9186,Licence to Kill,156167015,32000000,124167015,274695427.36034197,56287518.04938421,218407909.31095776
9187,National Lampoon's Christmas Vacation,71320000,27000000,44320000,125450805.85256499,47492593.35416789,77958212.4983971
9188,Glory,26828365,18000000,8828365,47190689.9741552,31661728.9027786,15528961.071376603
9189,The Abyss,90000098,70000000,20000098,158308816.894417,123128945.733027,35179871.16138999
9190,Lethal Weapon 2,227853986,25000000,202853986,400791729.674973,43974623.47608139,356817106.19889164
9191,Tango & Cash,63408614,55000000,8408614,111534797.031607,96744171.64737909,14790625.384227917
9192,Bill & Ted's Excellent Adventure,40485039,10000000,30485039,71212573.8575788,17589849.390432503,53622724.46714629
9193,Look Who's Talking,296000000,7500000,288500000,520659541.956803,13192387.0428244,507467154.91397864
9194,"Honey, I Shrunk the Kids",222724172,32000000,190724172,391768464.108879,56287518.04938421,335480946.05949485
9195,Star Trek V: The Final Frontier,70200000,30000000,40200000,123480742.72083601,52769548.1712976,70711194.5495384
9196,Kickboxer,14697005,1500000,13197005,25851810.444043398,2638477.40856488,23213333.035478517
9197,A Nightmare on Elm Street 5: The Dream Child,22168359,8000000,14168359,38993809.604304,14071879.512346,24921930.091958
9198,Cyborg,10166459,500000,9666459,17882648.2644007,879492.469521628,17003155.79487907
9199,The 'Burbs,36602000,18000000,18602000,64382366.7388612,31661728.9027786,32720637.836082604
9200,Pet Sematary,57469467,11500000,45969467,101087926.90784301,20228326.7989974,80859600.1088456
9201,"The Karate Kid, Part III",38956288,0,38956288,68523523.8730315,0.0,68523523.8730315
9202,"See No Evil, Hear No Evil",46908987,18000000,28908987,82512201.6387759,31661728.9027786,50850472.735997304
9203,Born on the Fourth of July,161001698,14000000,147001698,283199561.94238997,24625789.1466055,258573772.79578447
9204,Uncle Buck,79258538,15000000,64258538,139414574.63258702,26384774.0856488,113029800.54693821
9205,Leviathan,15704614,0,15704614,27624179.4994878,0.0,27624179.4994878
9206,"Sex, Lies, and Videotape",0,1200000,-1200000,0.0,2110781.9268519,-2110781.9268519
9207,Major League,49797148,11000000,38797148,87592433.339308,19348834.329475798,68243599.0098322
9208,We're No Angels,0,20000000,-20000000,0.0,35179698.7808651,-35179698.7808651
9209,Weekend at Bernie's,30218387,6500000,23718387,53153687.6151805,11433402.103781098,41720285.5113994
9210,Parenthood,126297830,0,126297830,222155980.80384502,0.0,222155980.80384502
9211,K-9,78247647,18598420,59649227,137636432.588573,32714340.6700008,104922091.91857222
9212,Casualties of War,18671317,22500000,-3828683,32842565.3951023,39577161.12847321,-6734595.733370908
9213,The War of the Roses,0,0,0,0.0,0.0,0.0
9214,Best of the Best,1700000,0,1700000,2990274.39637353,0.0,2990274.39637353
9215,Lock Up,0,24000000,-24000000,0.0,42215638.5370381,-42215638.5370381
9216,The Punisher,0,0,0,0.0,0.0,0.0
9217,Who's Harry Crumb?,0,0,0,0.0,0.0,0.0
9218,Friday the 13th Part VIII: Jason Takes Manhattan,14000000,5000000,9000000,24625789.1466055,8794924.69521628,15830864.45138922
9219,Always,74134790,31000000,43134790,130401979.06913401,54528533.1103409,75873445.9587931
9220,Police Academy 6: City Under Siege,11567217,0,11567217,20346560.4896451,0.0,20346560.4896451
9221,The Fly II,38903179,0,38903179,68430105.9419038,0.0,68430105.9419038
9222,Miracle Mile,1145404,3000000,-1854596,2014748.3851198996,5276954.81712976,-3262206.4320098604
9223,Turner & Hooch,71079915,0,71079915,125028499.953474,0.0,125028499.953474
9224,"The Cook, the Thief, His Wife & Her Lover",0,0,0,0.0,0.0,0.0
9225,The Dream Team,0,0,0,0.0,0.0,0.0
9226,All Dogs Go to Heaven,27100027,13800000,13300027,47668539.3406656,24273992.1587969,23394547.181868702
9227,Blind Fury,2345628,0,2345628,4125924.32459815,0.0,4125924.32459815
9228,Harlem Nights,60864870,30000000,30864870,107060389.646825,52769548.1712976,54290841.4755274
9229,Sea of Love,110879513,19000000,91879513,195035393.41545,33420713.8418218,161614679.57362822
9230,The BFG,0,0,0,0.0,0.0,0.0
9231,Dead Calm,7825000,10000000,-2175000,13764057.1480134,17589849.390432503,-3825792.242419103
9232,Warlock,0,7000000,-7000000,0.0,12312894.5733027,-12312894.5733027
9233,Johnny Handsome,7237794,0,7237794,12731170.6378976,0.0,12731170.6378976
9234,Shocker,16554699,5000000,11554699,29119466.211394396,8794924.69521628,20324541.516178116
9235,How to Get Ahead in Advertising,0,0,0,0.0,0.0,0.0
9236,Driving Miss Daisy,145793296,7500000,138293296,256448211.877475,13192387.0428244,243255824.8346506
9237,The Phantom of the Opera,0,0,0,0.0,0.0,0.0
9238,Crimes and Misdemeanors,18254702,19000000,-745298,32109745.884722803,33420713.8418218,-1310967.9570989981
9239,Black Rain,45892212,30000000,15892212,80723709.7273802,52769548.1712976,27954161.5560826
9240,The Toxic Avenger Part II,0,0,0,0.0,0.0,0.0
9241,Little Nemo: Adventures In Slumberland,0,0,0,0.0,0.0,0.0
9242,New York Stories,0,15000000,-15000000,0.0,26384774.0856488,-26384774.0856488
9243,Wild Orchid,0,7000000,-7000000,0.0,12312894.5733027,-12312894.5733027
9244,Santa sangre,0,787000,-787000,0.0,1384321.14702704,-1384321.14702704
9245,The Fabulous Baker Boys,0,13000000,-13000000,0.0,22866804.2075623,-22866804.2075623
9246,Steel Magnolias,95904091,0,95904091,168693851.661633,0.0,168693851.661633
9247,My Left Foot: The Story of Christy Brown,14743391,645180,14098211,25933402.7194258,1134861.90297192,24798540.81645388
9248,DeepStar Six,8143225,0,8143225,14323810.1302405,0.0,14323810.1302405
9249,Teen Witch,27843,0,27843,48975.4176577813,0.0,48975.4176577813
9250,Her Alibi,0,0,0,0.0,0.0,0.0
9251,Knick Knack,0,0,0,0.0,0.0,0.0
9252,Chances Are,0,0,0,0.0,0.0,0.0
9253,The Toxic Avenger Part III: The Last Temptation of Toxie,0,0,0,0.0,0.0,0.0
9254,Do the Right Thing,37295445,6500000,30795445,65602126.0499161,11433402.103781098,54168723.94613501
9255,Puppet Master,0,0,0,0.0,0.0,0.0
9256,Henry V,0,9000000,-9000000,0.0,15830864.4513893,-15830864.4513893
9257,Roger & Me,0,0,0,0.0,0.0,0.0
9258,The Blood of Heroes,882290,0,882290,1551934.82186847,0.0,1551934.82186847
9259,The Package,0,0,0,0.0,0.0,0.0
9260,Loverboy,3960327,0,3960327,6966155.54668636,0.0,6966155.54668636
9261,Mystery Train,0,2800000,-2800000,0.0,4925157.82932111,-4925157.82932111
9262,The Return of Swamp Thing,192816,0,192816,339160.44000656396,0.0,339160.44000656396
9263,The Gods Must Be Crazy II,0,0,0,0.0,0.0,0.0
9264,Halloween 5: The Revenge of Michael Myers,11642254,5000000,6642254,20478549.4425161,8794924.69521628,11683624.74729982
9265,Say Anything...,20036737,0,20036737,35244318.61057071,0.0,35244318.61057071
9266,Dream a Little Dream,0,0,0,0.0,0.0,0.0
9267,Next of Kin,15942628,12000000,3942628,28042842.540769298,21107819.268519,6935023.272250298
9268,Meet the Feebles,0,750000,-750000,0.0,1319238.70428244,-1319238.70428244
9269,Leningrad Cowboys Go America,0,0,0,0.0,0.0,0.0
9270,Robot Jox,0,0,0,0.0,0.0,0.0
9271,Jacknife,0,0,0,0.0,0.0,0.0
9272,Troop Beverly Hills,0,0,0,0.0,0.0,0.0
9273,Millennium,0,0,0,0.0,0.0,0.0
9274,Field of Dreams,84431625,0,84431625,148513956.753948,0.0,148513956.753948
9275,Erik the Viking,0,0,0,0.0,0.0,0.0
9276,Road House,30050028,15000000,15050028,52857546.6698281,26384774.0856488,26472772.5841793
9277,Fletch Lives,35150960,8045760,27105200,61830009.2329119,14152370.6631566,47677638.5697553
9278,An Innocent Man,20047604,0,20047604,35263433.4999033,0.0,35263433.4999033
9279,Music Box,0,0,0,0.0,0.0,0.0
9280,The Mighty Quinn,4557214,0,4557214,8016070.78999707,0.0,8016070.78999707
9281,The Woman in Black,0,0,0,0.0,0.0,0.0
9282,Gleaming the Cube,2777280,0,2777280,4885193.69150605,0.0,4885193.69150605
9283,She's Out of Control,12065892,0,12065892,21223722.3041225,0.0,21223722.3041225
9284,Three Fugitives,40590000,15000000,25590000,71397198.6757657,26384774.0856488,45012424.59011689
9285,Sleepaway Camp III: Teenage Wasteland,0,0,0,0.0,0.0,0.0
9286,Bride of Re-Animator,0,2000000,-2000000,0.0,3517969.87808651,-3517969.87808651
9287,Valmont,1132112,33000000,-31867888,1991367.95731013,58046502.98842739,-56055135.03111726
9288,Drugstore Cowboy,4729352,2500000,2229352,8318858.9394341,4397462.34760814,3921396.59182596
9289,The Wizard,14278900,6000000,8278900,25116370.0461047,10553909.6342595,14562460.4118452
9290,Depeche Mode: 101,0,0,0,0.0,0.0,0.0
9291,Going Overboard,0,0,0,0.0,0.0,0.0
9292,The Tall Guy,0,0,0,0.0,0.0,0.0
9293,Scandal,8800000,0,8800000,15479067.463580599,0.0,15479067.463580599
9294,Great Balls of Fire!,0,0,0,0.0,0.0,0.0
9295,Monsieur Hire,0,0,0,0.0,0.0,0.0
9296,UHF,0,5000000,-5000000,0.0,8794924.69521628,-8794924.69521628
9297,Lean On Me,0,0,0,0.0,0.0,0.0
9298,Gross Anatomy,0,0,0,0.0,0.0,0.0
9299,Pink Cadillac,0,0,0,0.0,0.0,0.0
9300,Lonesome Dove,0,0,0,0.0,0.0,0.0
9301,Kill Me Again,0,4000000,-4000000,0.0,7035939.75617302,-7035939.75617302
9302,Society,0,0,0,0.0,0.0,0.0
9303,Little Monsters,793775,7000000,-6206225,1396238.26998906,12312894.5733027,-10916656.303313639
9304,The January Man,0,0,0,0.0,0.0,0.0
9305,Let It Ride,0,0,0,0.0,0.0,0.0
9306,House III: The Horror Show,1738897,0,1738897,3058693.6335475,0.0,3058693.6335475
9307,Goldeneye,0,0,0,0.0,0.0,0.0
9308,"Amanece, que no es poco",0,0,0,0.0,0.0,0.0
9309,She-Devil,0,0,0,0.0,0.0,0.0
9310,Family Business,12195695,0,12195695,21452043.8261651,0.0,21452043.8261651
9311,Intruder,0,130000,-130000,0.0,228668.042075623,-228668.042075623
9312,Ho vinto la lotteria di Capodanno,0,0,0,0.0,0.0,0.0
9313,Communion,1919653,0,1919653,3376640.7151892004,0.0,3376640.7151892004
9314,Stepfather II: Make Room For Daddy,1519796,0,1519796,2673298.27441818,0.0,2673298.27441818
9315,For All Mankind,0,0,0,0.0,0.0,0.0
9316,Beauty and the Beast,377350553,25000000,352350553,604173269.3066981,40027321.0482546,564145948.2584435
9317,Terminator 2: Judgment Day,520000000,100000000,420000000,832568277.803697,160109284.193018,672458993.610679
9318,Hook,300854823,70000000,230854823,481696503.565473,112076498.93511298,369620004.63036
9319,Robin Hood: Prince of Thieves,390493908,48000000,342493908,625217000.916145,76852456.412649,548364544.5034959
9320,Highlander II: The Quickening,15556340,30000000,-14443660,24907144.620632198,48032785.2579056,-23125640.637273405
9321,Cape Fear,182300000,35000000,147300000,291879225.083873,56038249.46755649,235840975.6163165
9322,Star Trek VI: The Undiscovered Country,96900000,27000000,69900000,155145896.383035,43229506.732115,111916389.65092
9323,The Naked Gun 2Â½: The Smell of Fear,86930411,23000000,63930411,139183658.798149,36825135.3643943,102358523.43375468
9324,Point Break,83531958,24000000,59531958,133742420.02621299,38426228.2063245,95316191.81988849
9325,Bill & Ted's Bogus Journey,0,0,0,0.0,0.0,0.0
9326,Backdraft,152368585,75000000,77368585,243956250.77853101,120081963.14476399,123874287.63376702
9327,The Addams Family,191502426,30000000,161502426,306613163.480865,48032785.2579056,258580378.2229594
9328,Hudson Hawk,17218080,65000000,-47781920,27567744.6397813,104071034.725462,-76503290.08568071
9329,The Rocketeer,62000000,42000000,20000000,99267756.1996716,67245899.3610678,32021856.838603795
9330,Thelma & Louise,45361000,16000000,29361000,72627172.4027952,25617485.470882997,47009686.9319122
9331,The Doors,34416893,38000000,-3583107,55104641.0237771,60841527.99334711,-5736886.969570011
9332,Teenage Mutant Ninja Turtles II: The Secret of the Ooze,78,25000000,-24999922,124.88524167055401,40027321.0482546,-40027196.16301293
9333,Nothing but Trouble,8479793,40000000,-31520207,13576935.8733497,64043713.67720749,-50466777.80385779
9334,An American Tail: Fievel Goes West,0,0,0,0.0,0.0,0.0
9335,The Silence of the Lambs,272742922,19000000,253742922,436686740.101323,30420763.9966735,406265976.1046495
9336,Barton Fink,6153939,9000000,-2846061,9853027.68257501,14409835.577371601,-4556807.894796591
9337,My Girl,0,16500000,-16500000,0.0,26418031.891848102,-26418031.891848102
9338,Dying Young,0,0,0,0.0,0.0,0.0
9339,Freddy's Dead: The Final Nightmare,34872033,11000000,23872033,55833362.419853196,17612021.261232,38221341.15862119
9340,My Own Private Idaho,0,2500000,-2500000,0.0,4002732.10482546,-4002732.10482546
9341,The Last Boy Scout,59509925,29000000,30509925,95280914.9413023,46431692.4159754,48849222.5253269
9342,JFK,205405498,40000000,165405498,328873272.540905,64043713.67720749,264829558.8636975
9343,Boyz n the Hood,57504069,6500000,51004069,92069353.2577596,10407103.4725462,81662249.7852134
9344,Harley Davidson and the Marlboro Man,7434726,23000000,-15565274,11903686.5803122,36825135.3643943,-24921448.7840821
9345,Double Impact,30102717,15000000,15102717,48197244.711350106,24016392.6289528,24180852.082397304
9346,La belle noiseuse,0,0,0,0.0,0.0,0.0
9347,What About Bob?,63710000,35000000,28710000,102005624.959372,56038249.46755649,45967375.49181551
9348,Night on Earth,2015810,0,2015810,3227498.96169129,0.0,3227498.96169129
9349,Child's Play 3,20560255,13000000,7560255,32918877.108759303,20814206.9450924,12104670.163666904
9350,The People Under the Stairs,0,6000000,-6000000,0.0,9606557.05158112,-9606557.05158112
9351,City Slickers,124033791,26000000,98033791,198589614.927564,41628413.8901848,156961201.0373792
9352,Hot Shots!,181096164,26000000,155096164,289951771.881415,41628413.8901848,248323357.99123022
9353,Wild Hearts Can't Be Broken,0,0,0,0.0,0.0,0.0
9354,Return to the Blue Lagoon,2807854,11000000,-8192146,4495634.94058504,17612021.261232,-13116386.32064696
9355,L.A. Story,0,0,0,0.0,0.0,0.0
9356,Fried Green Tomatoes,119418501,11000000,108418501,191200107.145132,17612021.261232,173588085.88390002
9357,The Hard Way,65595485,0,65595485,105024461.496439,0.0,105024461.496439
9358,Showdown in Little Tokyo,2275557,8000000,-5724443,3643378.02410413,12808742.735441498,-9165364.711337369
9359,Sleeping with the Enemy,174999005,19000000,155999005,280189654.25040495,30420763.9966735,249768890.25373146
9360,Grand Canyon,0,0,0,0.0,0.0,0.0
9361,Rock-A-Doodle,11657385,18000000,-6342615,18664555.6791243,28819671.1547433,-10155115.475619
9362,Knight Rider 2000,0,0,0,0.0,0.0,0.0
9363,Naked Lunch,0,16000000,-16000000,0.0,25617485.470882997,-25617485.470882997
9364,Zandalee,0,0,0,0.0,0.0,0.0
9365,Rush,0,0,0,0.0,0.0,0.0
9366,Life Stinks,0,0,0,0.0,0.0,0.0
9367,Father of the Bride,89325780,0,89325780,143018866.95783,0.0,143018866.95783
9368,The Fisher King,41895491,24000000,17895491,67078570.7492506,38426228.2063245,28652342.542926095
9369,K2,3106559,0,3106559,4973889.377933799,0.0,4973889.377933799
9370,Regarding Henry,0,0,0,0.0,0.0,0.0
9371,Don't Tell Mom the Babysitter's Dead,25196249,10000000,15196249,40341533.9173906,16010928.4193018,24330605.4980888
9372,Shadows and Fog,2735731,14000000,-11264269,4380159.32154651,22415299.7870226,-18035140.465476092
9373,Bugsy,49114016,30000000,19114016,78636099.4560447,48032785.2579056,30603314.1981391
9374,Cool as Ice,1193062,6000000,-4806938,1910203.02817891,9606557.05158112,-7696354.02340221
9375,Out for Justice,39673161,14000000,25673161,63520414.093843795,22415299.7870226,41105114.3068212
9376,Problem Child 2,0,0,0,0.0,0.0,0.0
9377,Ernest Scared Stupid,0,0,0,0.0,0.0,0.0
9378,Toy Soldiers,15073942,0,15073942,24134780.6358708,0.0,24134780.6358708
9379,Mortal Thoughts,0,8000000,-8000000,0.0,12808742.735441498,-12808742.735441498
9380,The Prince of Tides,74787599,30000000,44787599,119741889.424045,48032785.2579056,71709104.1661394
9381,Flirting,2415396,0,2415396,3867273.2460267995,0.0,3867273.2460267995
9382,Jungle Fever,32482682,14000000,18482682,52007789.6368945,22415299.7870226,29592489.8498719
9383,Suburban Commando,0,0,0,0.0,0.0,0.0
9384,The Pit and the Pendulum,0,2000000,-2000000,0.0,3202185.68386037,-3202185.68386037
9385,Defending Your Life,0,0,0,0.0,0.0,0.0
9386,King Ralph,0,0,0,0.0,0.0,0.0
9387,Dead Again,38016380,0,38016380,60867753.8940979,0.0,60867753.8940979
9388,Ghoulies III: Ghoulies Go to College,0,0,0,0.0,0.0,0.0
9389,"Mon pÃ¨re, ce hÃ©ros",0,0,0,0.0,0.0,0.0
9390,Drop Dead Fred,13,0,13,20.814206945092398,0.0,20.814206945092398
9391,Sometimes They Come Back,0,0,0,0.0,0.0,0.0
9392,Soapdish,36489888,0,36489888,58423698.4796342,0.0,58423698.4796342
9393,The Guyver,0,0,0,0.0,0.0,0.0
9394,Career Opportunities,0,0,0,0.0,0.0,0.0
9395,Curly Sue,0,0,0,0.0,0.0,0.0
9396,New Jack City,47624253,8500000,39124253,76250850.5805722,13609289.1564065,62641561.4241657
9397,A Rage in Harlem,10400000,8000000,2400000,16651365.556073902,12808742.735441498,3842622.8206324037
9398,Critters 3,0,0,0,0.0,0.0,0.0
9399,Enchanted April,13200170,0,13200170,21134697.699261602,0.0,21134697.699261602
9400,Oscar,23562716,35000000,-11437284,37726095.9240339,56038249.46755649,-18312153.54352259
9401,Madonna: Truth or Dare,29,0,29,46.4316924159754,0.0,46.4316924159754
9402,Kickboxer 2:  The Road Back,1250712,0,1250712,2002506.03051618,0.0,2002506.03051618
9403,Necessary Roughness,0,0,0,0.0,0.0,0.0
9404,Omen IV: The Awakening,0,0,0,0.0,0.0,0.0
9405,A Brief History of Time,0,0,0,0.0,0.0,0.0
9406,Pure Luck,0,0,0,0.0,0.0,0.0
9407,Flight of the Intruder,0,35000000,-35000000,0.0,56038249.46755649,-56038249.46755649
9408,Frankie and Johnny,22773535,0,22773535,36462543.8739466,0.0,36462543.8739466
9409,If Looks Could Kill,7788597,0,7788597,12470266.9053789,0.0,12470266.9053789
9410,Other People's Money,0,0,0,0.0,0.0,0.0
9411,Proof,524668,0,524668,840042.1791898271,0.0,840042.1791898271
9412,The Commitments,0,0,0,0.0,0.0,0.0
9413,Dolly Dearest,0,0,0,0.0,0.0,0.0
9414,The Butcher's Wife,0,0,0,0.0,0.0,0.0
9415,Billy Bathgate,0,48000000,-48000000,0.0,76852456.412649,-76852456.412649
9416,V.I. Warshawski,0,0,0,0.0,0.0,0.0
9417,Little Man Tate,0,0,0,0.0,0.0,0.0
9418,Mobsters,20246790,23000000,-2753210,32416990.541063696,36825135.3643943,-4408144.823330604
9419,Begotten,0,33000,-33000,0.0,52836.0637836962,-52836.0637836962
9420,Not Without My Daughter,0,0,0,0.0,0.0,0.0
9421,Hearts of Darkness: A Filmmaker's Apocalypse,0,0,0,0.0,0.0,0.0
9422,"He Said, She Said",0,0,0,0.0,0.0,0.0
9423,Lucky Luke,0,0,0,0.0,0.0,0.0
9424,Impromptu,0,0,0,0.0,0.0,0.0
9425,Class Action,0,0,0,0.0,0.0,0.0
9426,Shattered,11511031,22000000,-10488969,18430229.3373364,35224042.5224641,-16793813.185127698
9427,White Fang,34793160,14000000,20793160,55707079.4241317,22415299.7870226,33291779.637109097
9428,Only the Lonely,21830957,0,21830957,34953388.9851857,0.0,34953388.9851857
9429,Switch,0,0,0,0.0,0.0,0.0
9430,Ricochet,0,0,0,0.0,0.0,0.0
9431,Wedlock,0,0,0,0.0,0.0,0.0
9432,Dutch,4603929,17000000,-12396071,7371317.766654801,27218578.3128131,-19847260.5461583
9433,é€ƒå­¦å¨é¾™,0,0,0,0.0,0.0,0.0
9434,Slacker,0,0,0,0.0,0.0,0.0
9435,Mannequin Two: On the Move,3752426,13000000,-9247574,6007982.40847272,20814206.9450924,-14806224.536619678
9436,Toto le hÃ©ros,0,0,0,0.0,0.0,0.0
9437,The Resurrected,0,0,0,0.0,0.0,0.0
9438,Puppet Master III: Toulon's Revenge,0,800000,-800000,0.0,1280874.27354415,-1280874.27354415
9439,Prospero's Books,1750301,0,1750301,2802394.40232324,0.0,2802394.40232324
9440,Deceived,0,0,0,0.0,0.0,0.0
9441,All I Want For Christmas,14812000,0,14812000,23715387.1746699,0.0,23715387.1746699
9442,Shakes the Clown,0,0,0,0.0,0.0,0.0
9443,The Man in the Moon,2853801,0,2853801,4569200.35339321,0.0,4569200.35339321
9444,F/X2,0,16400000,-16400000,0.0,26257922.607655,-26257922.607655
9445,Doc Hollywood,0,0,0,0.0,0.0,0.0
9446,Mississippi Masala,0,0,0,0.0,0.0,0.0
9447,Dogfight,0,0,0,0.0,0.0,0.0
9448,The Hitman,4654288,0,4654288,7451947.20108156,0.0,7451947.20108156
9449,Die Hard,140767956,28000000,112767956,259560770.407171,51628948.6465286,207931821.7606424
9450,Big,151668774,18000000,133668774,279660690.86171204,33190038.4156255,246470652.44608653
9451,The Naked Gun: From the Files of Police Squad!,78756177,12000000,66756177,145217807.78321102,22126692.277083702,123091115.50612733
9452,License to Drive,22433275,8000000,14433275,41364514.39101621,14751128.1847224,26613386.206293806
9453,Beetlejuice,73326666,15000000,58326666,135206381.190541,27658365.346354604,107548015.8441864
9454,Rain Man,354825435,25000000,329825435,654259434.360614,46097275.5772577,608162158.7833562
9455,Bloodsport,11806119,1500000,10306119,21769196.841635898,2765836.53463546,19003360.307000436
9456,Coming to America,288752301,39000000,249752301,532427775.710571,71911749.900522,460516025.810049
9457,Rambo III,189015611,63000000,126015611,348524188.34682995,116165134.454689,232359053.89214095
9458,The Dead Pool,0,20000000,-20000000,0.0,36877820.4618061,-36877820.4618061
9459,Oliver & Company,0,0,0,0.0,0.0,0.0
9460,Twins,216614388,15000000,201614388,399413325.50540096,27658365.346354604,371754960.15904635
9461,Who Framed Roger Rabbit,329803958,70000000,259803958,608122557.535853,129072371.616321,479050185.91953206
9462,The Land Before Time,84460846,12300000,72160846,155736595.74201298,22679859.5840108,133056736.15800218
9463,Cocktail,171504781,20000000,151504781,316236126.102969,36877820.4618061,279358305.6411629
9464,Scrooged,60328000,0,60328000,111238257.64099199,0.0,111238257.64099199
9465,Child's Play,44196684,9000000,35196684,81493868.87795909,16595019.207812699,64898849.67014639
9466,Willow,57269863,35000000,22269863,105599386.279311,64536185.80816079,41063200.47115021
9467,Crocodile Dundee II,239606210,0,239606210,441807739.695691,0.0,441807739.695691
9468,A Nightmare on Elm Street 4: The Dream Master,72500000,7000000,65500000,133682099.174047,12907237.1616321,120774862.01241489
9469,Dirty Rotten Scoundrels,42039085,0,42039085,77515491.45043051,0.0,77515491.45043051
9470,Bull Durham,50888000,7000000,43888000,93831926.3830196,12907237.1616321,80924689.22138749
9471,Red Heat,34994648,29000000,5994648,64526317.3034052,53472839.6696189,11053477.633786306
9472,A Fish Called Wanda,62493712,7500000,54993712,115231594.55639099,13829182.673177302,101402411.88321368
9473,Police Academy 5: Assignment Miami Beach,19510371,0,19510371,35974997.944061495,0.0,35974997.944061495
9474,Short Circuit 2,21630088,0,21630088,39883525.0918534,0.0,39883525.0918534
9475,The Blob,8247943,19000000,-10752057,15208308.056660501,35033929.4387158,-19825621.382055297
9476,Cocoon: The Return,25024919,17500000,7524919,46143223.497662105,32268092.904080395,13875130.59358171
9477,"Elvira, Mistress of the Dark",5596267,0,5596267,10318906.4841165,0.0,10318906.4841165
9478,The Unbearable Lightness of Being,0,0,0,0.0,0.0,0.0
9479,Heathers,1108462,0,1108462,2043883.13123673,0.0,2043883.13123673
9480,Spoorloos,0,0,0,0.0,0.0,0.0
9481,Mississippi Burning,34604000,15000000,19604000,63806004.963017,27658365.346354604,36147639.6166624
9482,Fright Night Part 2,2983784,0,2983784,5501772.53244049,0.0,5501772.53244049
9483,Working Girl,103173635,28000000,75173635,190240939.396096,51628948.6465286,138611990.7495674
9484,They Live,13008928,4000000,9008928,23987045.5592281,7375564.09236123,16611481.46686687
9485,Phantasm II,7282851,3000000,4282851,13428783.5814042,5531673.06927092,7897110.51213328
9486,Alien Nation,0,16000000,-16000000,0.0,29502256.3694449,-29502256.3694449
9487,Big Business,0,0,0,0.0,0.0,0.0
9488,Halloween 4: The Return of Michael Myers,17768757,5000000,12768757,32763651.5237731,9219455.11545154,23544196.40832156
9489,Action Jackson,20256975,7000000,13256975,37351654.3574648,12907237.1616321,24444417.1958327
9490,Married to the Mob,21486757,10000000,11486757,39619238.3476228,18438910.230903,21180328.116719797
9491,Another Woman,0,0,0,0.0,0.0,0.0
9492,Friday the 13th Part VII: The New Blood,19170001,2800000,16370001,35347392.7565322,5162894.86465286,30184497.89187934
9493,The Seventh Sign,0,0,0,0.0,0.0,0.0
9494,Dangerous Liaisons,34670720,14000000,20670720,63929029.3720776,25814474.3232643,38114555.0488133
9495,My Stepmother is an Alien,13854000,20000000,-6146000,25545266.233893104,36877820.4618061,-11332554.227913
9496,Frantic,17637950,20000000,-2362050,32522457.670715697,36877820.4618061,-4355362.7910904065
9497,Mac and Me,5935269,0,5935269,10943989.2287261,0.0,10943989.2287261
9498,Killer Klowns from Outer Space,0,2000000,-2000000,0.0,3687782.04618061,-3687782.04618061
9499,The Beast of War,0,0,0,0.0,0.0,0.0
9500,Drowning by Numbers,0,0,0,0.0,0.0,0.0
9501,Fei lung mang jeung,0,0,0,0.0,0.0,0.0
9502,D.O.A.,12706478,0,12706478,23429360.7192945,0.0,23429360.7192945
9503,Return of the Living Dead Part II,9205924,6200000,3005924,16974720.6228516,11432124.3431599,5542596.2796917
9504,Without a Clue,0,0,0,0.0,0.0,0.0
9505,Caddyshack II,0,0,0,0.0,0.0,0.0
9506,Iron Eagle II,0,0,0,0.0,0.0,0.0
9507,The Bourne Identity,0,0,0,0.0,0.0,0.0
9508,Poltergeist III,14144000,10500000,3644000,26079994.6305893,19360855.7424482,6719138.888141099
9509,The Adventures of Baron Munchausen,0,0,0,0.0,0.0,0.0
9510,Braddock: Missing in Action III,6193901,0,6193901,11420878.45181,0.0,11420878.45181
9511,The Presidio,20324096,0,20324096,37475418.16682561,0.0,37475418.16682561
9512,Midnight Run,38413606,30000000,8413606,70830503.267928,55316730.69270921,15513772.575218797
9513,Black Eagle,0,0,0,0.0,0.0,0.0
9514,Above the Law,18869631,7500000,11369631,34793543.2099266,13829182.673177302,20964360.536749296
9515,The Last Temptation of Christ,8373585,7000000,1373585,15439978.2125836,12907237.1616321,2532741.0509514995
9516,High Spirits,7399763,0,7399763,13644356.5686958,0.0,13644356.5686958
9517,Pumpkinhead,0,0,0,0.0,0.0,0.0
9518,The Accused,0,0,0,0.0,0.0,0.0
9519,Prison,354704,1300000,-945296,654035.521454225,2397058.3300174,-1743022.8085631751
9520,Hairspray,0,0,0,0.0,0.0,0.0
9521,U2: Rattle and Hum,0,0,0,0.0,0.0,0.0
9522,Hellbound: Hellraiser II,12090735,0,12090735,22293997.7290638,0.0,22293997.7290638
9523,Moonwalker,0,22000000,-22000000,0.0,40565602.5079868,-40565602.5079868
9524,The Great Outdoors,43455230,24000000,19455230,80126708.5033247,44253384.554167405,35873323.9491573
9525,Gorillas in the Mist,0,22000000,-22000000,0.0,40565602.5079868,-40565602.5079868
9526,Mystic Pizza,0,0,0,0.0,0.0,0.0
9527,School Daze,0,0,0,0.0,0.0,0.0
9528,Waxwork,0,0,0,0.0,0.0,0.0
9529,Tin Toy,0,0,0,0.0,0.0,0.0
9530,Dead Ringers,8038508,13000000,-4961492,14822132.7402396,23970583.300173998,-9148450.559934398
9531,"Distant Voices, Still Lives",0,0,0,0.0,0.0,0.0
9532,Ernest Saves Christmas,28202109,6000000,22202109,52001615.6173144,11063346.1385418,40938269.478772596
9533,Bird,0,0,0,0.0,0.0,0.0
9534,She's Having a Baby,0,0,0,0.0,0.0,0.0
9535,Bad Dreams,9797098,4000000,5797098,18064781.054536,7375564.09236123,10689216.96217477
9536,Dead Heat,0,5000000,-5000000,0.0,9219455.11545154,-9219455.11545154
9537,Scooby-Doo and the Ghoul School,0,0,0,0.0,0.0,0.0
9538,Two Moon Junction,1547397,0,1547397,2853231.43745687,0.0,2853231.43745687
9539,Sleepaway Camp II: Unhappy Campers,0,0,0,0.0,0.0,0.0
9540,Night of the Demons,3109904,1200000,1909904,5734324.06827264,2212669.22770837,3521654.84056427
9541,Eight Men Out,0,0,0,0.0,0.0,0.0
9542,Talk Radio,3468572,4000000,-531428,6395668.7737424,7375564.09236123,-979895.3186188303
9543,"Bright Lights, Big City",0,0,0,0.0,0.0,0.0
9544,Earth Girls Are Easy,3916303,10000000,-6083697,7221235.94540164,18438910.230903,-11217674.28550136
9545,Beaches,57041866,0,57041866,105178984.65772,0.0,105178984.65772
9546,Johnny Be Good,0,0,0,0.0,0.0,0.0
9547,é»‘å¤ªé™½731,0,0,0,0.0,0.0,0.0
9548,Young Einstein,0,0,0,0.0,0.0,0.0
9549,The Thin Blue Line,0,0,0,0.0,0.0,0.0
9550,Bat*21,3184348,0,3184348,5871590.69159558,0.0,5871590.69159558
9551,Shoot to Kill,29300000,0,29300000,54026006.976546004,0.0,54026006.976546004
9552,Big Top Pee-wee,15122000,0,15122000,27883320.0511716,0.0,27883320.0511716
9553,Tequila Sunrise,0,23000000,-23000000,0.0,42409493.5310771,-42409493.5310771
9554,Punchline,21032267,15000000,6032267,38781208.3165385,27658365.346354604,11122842.970183894
9555,Critters 2,3813293,4500000,-686707,7031296.73111311,8297509.60390639,-1266212.8727932805
9556,La Vie est un long fleuve tranquille,0,0,0,0.0,0.0,0.0
9557,Monkey Shines,5344577,7000000,-1655423,9854817.55251493,12907237.1616321,-3052419.609117171
9558,Tucker: The Man and His Dream,0,0,0,0.0,0.0,0.0
9559,Hollywood Chainsaw Hookers,0,23000,-23000,0.0,42409.493531077096,-42409.493531077096
9560,Blackadder's Christmas Carol,0,0,0,0.0,0.0,0.0
9561,Arthur 2: On the Rocks,14681192,0,14681192,27070518.1370652,0.0,27070518.1370652
9562,Return of the Killer Tomatoes!,0,0,0,0.0,0.0,0.0
9563,Maniac Cop,0,1100000,-1100000,0.0,2028280.12539934,-2028280.12539934
9564,Powaqqatsi,589244,2500000,-1910756,1086501.72200982,4609727.55772577,-3523225.8357159505
9565,The Serpent and the Rainbow,19595031,7000000,12595031,36131101.758076295,12907237.1616321,23223864.596444197
9566,Running on Empty,2835116,0,2835116,5227644.9418196995,0.0,5227644.9418196995
9567,Vice Versa,0,0,0,0.0,0.0,0.0
9568,Colors,46616067,6000000,40616067,85954947.4730764,11063346.1385418,74891601.3345346
9569,Biloxi Blues,51684798,20000000,31684798,95301135.0624359,36877820.4618061,58423314.60062979
9570,The Couch Trip,0,0,0,0.0,0.0,0.0
9571,Vampire's Kiss,725131,2000000,-1274869,1337062.54146449,3687782.04618061,-2350719.50471612
9572,"Slugs, muerte viscosa",0,0,0,0.0,0.0,0.0
9573,Funny Farm,0,0,0,0.0,0.0,0.0
9574,The Accidental Tourist,0,0,0,0.0,0.0,0.0
9575,Scarecrows,0,425000,-425000,0.0,783653.6848133809,-783653.6848133809
9576,I'm Gonna Git You Sucka,0,0,0,0.0,0.0,0.0
9577,Stand and Deliver,13994920,0,13994920,25805107.356867,0.0,25805107.356867
9578,The Lair of the White Worm,1189315,2500000,-1310685,2192967.25212665,4609727.55772577,-2416760.3055991204
9579,Hell Comes to Frogtown,0,0,0,0.0,0.0,0.0
9580,Paperhouse,241,0,241,444.377736564764,0.0,444.377736564764
9581,Imagine: John Lennon,0,0,0,0.0,0.0,0.0
9582,18 Again!,0,0,0,0.0,0.0,0.0
9583,Scooby-Doo! and the Reluctant Werewolf,0,0,0,0.0,0.0,0.0
9584,The Decline of Western Civilization Part II: The Metal Years,0,0,0,0.0,0.0,0.0
9585,A Cry in the Dark,6908797,15000000,-8091203,12739068.7686532,27658365.346354604,-14919296.577701405
9586,For Keeps,17514553,0,17514553,32294927.050139397,0.0,32294927.050139397
9587,Red Scorpion,4192440,16000000,-11807560,7730402.48084473,29502256.3694449,-21771853.88860017
9588,Sherlock Holmes: The Hound of the Baskervilles,0,0,0,0.0,0.0,0.0
9589,Moving,0,0,0,0.0,0.0,0.0
9590,The New Adventures of Pippi Longstocking,3569939,5000000,-1430061,6582578.47507999,9219455.11545154,-2636876.640371551
9591,"The Chronicles of Narnia: The Lion, the Witch and the Wardrobe",0,0,0,0.0,0.0,0.0
9592,Brain Damage,0,0,0,0.0,0.0,0.0
9593,Peter Pan,0,0,0,0.0,0.0,0.0
9594,Predator,98235548,18000000,80235548,188521918.48936102,34543447.885163695,153978470.60419732
9595,Full Metal Jacket,46357676,17000000,29357676,88964109.16573921,32624367.447099105,56339741.718640104
9596,Dirty Dancing,213954274,6000000,207954274,410595461.87372404,11514482.6283879,399080979.2453361
9597,Spaceballs,38119483,22700000,15419483,73154354.1344381,43563125.944067605,29591228.190370493
9598,The Living Daylights,191185897,40000000,151185897,366901114.966543,76763217.52258609,290137897.4439569
9599,RoboCop,53000000,13000000,40000000,101711263.217426,24948045.694840398,76763217.5225856
9600,Evil Dead II,5923044,3600000,2323044,11366797.8741962,6908689.57703275,4458108.29716345
9601,Lethal Weapon,120207127,15000000,105207127,230687145.94165298,28786206.5709698,201900939.3706832
9602,The Running Man,38122105,27000000,11122105,73159385.9633467,51815171.8277456,21344214.135601103
9603,Jaws: The Revenge,51881013,23000000,28881013,99563837.15527791,44138850.075487,55424987.079790905
9604,The Princess Bride,30857814,16000000,14857814,59218627.2088375,30705287.0090344,28513340.199803103
9605,A Nightmare on Elm Street 3: Dream Warriors,44793222,5000000,39793222,85961796.0980872,9595402.19032326,76366393.90776394
9606,Wall Street,43848069,15000000,28848069,84147971.46480909,28786206.5709698,55361764.893839285
9607,Beverly Hills Cop II,299965036,20000000,279965036,575657032.690959,38381608.761293,537275423.9296659
9608,Superman IV: The Quest for Peace,19300000,17000000,2300000,37038252.454647794,32624367.447099105,4413885.00754869
9609,Raising Arizona,29180280,6000000,23180280,55999304.525249206,11514482.6283879,44484821.89686131
9610,The Untouchables,76270454,25000000,51270454,146369136.273709,47977010.951616295,98392125.32209271
9611,"Good Morning, Vietnam",123922370,13000000,110922370,237816996.10561,24948045.694840398,212868950.4107696
9612,The Last Emperor,43984230,23000000,20984230,84409275.3763364,44138850.075487,40270425.30084939
9613,Fatal Attraction,320145693,14000000,306145693,614385336.7669519,26867126.132905103,587518210.6340468
9614,Police Academy 4: Citizens on Patrol,28061343,0,28061343,53851974.4171225,0.0,53851974.4171225
9615,Innerspace,25893810,0,25893810,49692304.237962894,0.0,49692304.237962894
9616,"Planes, Trains and Automobiles",49230280,0,49230280,94476867.3084455,0.0,94476867.3084455
9617,Angel Heart,17185632,17000000,185632,32980610.1869779,32624367.447099105,356242.73987879604
9618,Over the Top,16057580,25000000,-8942420,30815787.660658196,47977010.951616295,-17161223.2909581
9619,*batteries not included,65088797,0,65088797,124910637.059861,0.0,124910637.059861
9620,The Lost Boys,32222567,8500000,23722567,61837697.9939276,16312183.7235495,45525514.2703781
9621,The Witches of Eastwick,63766510,0,63766510,122373061.944654,0.0,122373061.944654
9622,Creepshow 2,14000000,3500000,10500000,26867126.132905103,6716781.53322628,20150344.59967882
9623,Bad Taste,0,25710,-25710,0.0,49339.558062642194,-49339.558062642194
9624,Overboard,26713187,1880006,24833181,51264754.610063,3607882.73804417,47656871.87201883
9625,Barfly,3221568,3000000,221568,6182448.12869506,5757241.31419396,425206.8145010993
9626,Broadcast News,51249404,20000000,31249404,98351728.6788724,38381608.761293,59970119.917579405
9627,Some Kind of Wonderful,18553948,0,18553948,35606518.655668795,0.0,35606518.655668795
9628,Blind Date,39321715,18000000,21321715,75461534.0476534,34543447.885163695,40918086.16248971
9629,Adventures in Babysitting,34368475,0,34368475,65955868.058614,0.0,65955868.058614
9630,Dragnet,66673516,20000000,46673516,127951840.29258999,38381608.761293,89570231.531297
9631,A Muppet Family Christmas,0,0,0,0.0,0.0,0.0
9632,House 2: The Second Story,7800000,0,7800000,14968827.4169042,0.0,14968827.4169042
9633,Roxanne,40050884,0,40050884,76860868.01159659,0.0,76860868.01159659
9634,The Pick-up Artist,13290368,15000000,-1709632,25505285.2434804,28786206.5709698,-3280921.327489402
9635,Withnail & I,0,0,0,0.0,0.0,0.0
9636,Empire of the Sun,0,38000000,-38000000,0.0,72925056.6464568,-72925056.6464568
9637,The Gate,0,2500000,-2500000,0.0,4797701.09516163,-4797701.09516163
9638,Cherry 2000,14000,10000000,-9986000,26867.126132905098,19190804.3806465,-19163937.254513595
9639,Masters of the Universe,0,17000000,-17000000,0.0,32624367.447099105,-32624367.447099105
9640,Radio Days,0,16000000,-16000000,0.0,30705287.0090344,-30705287.0090344
9641,No Way Out,35509515,15000000,20509515,68145615.60166329,28786206.5709698,39359409.03069349
9642,Harry and the Hendersons,49998613,0,49998613,95951360.138665,0.0,95951360.138665
9643,The Secret of My Success,110996879,12000000,98996879,213011939.175129,23028965.2567758,189982973.9183532
9644,Death Wish 4: The Crackdown,0,0,0,0.0,0.0,0.0
9645,Near Dark,0,5000000,-5000000,0.0,9595402.19032326,-9595402.19032326
9646,Three Men and a Baby,168000000,11000000,157000000,322405513.594861,21109884.818711102,301295628.77614987
9647,The Hidden,0,0,0,0.0,0.0,0.0
9648,The Brave Little Toaster,0,2000000,-2000000,0.0,3838160.8761293,-3838160.8761293
9649,Street Trash,0,0,0,0.0,0.0,0.0
9650,Surf Nazis Must Die,0,0,0,0.0,0.0,0.0
9651,Prince of Darkness,14182492,3000000,11182492,27217342.960208397,5757241.31419396,21460101.646014437
9652,Stakeout,0,0,0,0.0,0.0,0.0
9653,Hellraiser,14564027,1000000,13564027,27949539.3151454,1919080.43806465,26030458.87708075
9654,Mio min Mio,2300000,7200000,-4900000,4413885.0075487,13817379.1540655,-9403494.1465168
9655,The Believers,18753438,0,18753438,35989356.01225829,0.0,35989356.01225829
9656,The Belly of an Architect,0,0,0,0.0,0.0,0.0
9657,House of Games,2585639,0,2585639,4962049.22479705,0.0,4962049.22479705
9658,Ironweed,0,0,0,0.0,0.0,0.0
9659,La Bamba,54215416,6500000,47715416,104043744.287137,12474022.847420199,91569721.4397168
9660,Someone to Watch Over Me,10278549,17000000,-6721451,19725362.317589,32624367.447099105,-12899005.129510105
9661,Renegade,0,0,0,0.0,0.0,0.0
9662,Suspect,0,0,0,0.0,0.0,0.0
9663,Out of Rosenheim,3587303,0,3587303,6884323.01271064,0.0,6884323.01271064
9664,The Dead,0,0,0,0.0,0.0,0.0
9665,Project X,18532286,18000000,532286,35564947.53521939,34543447.885163695,1021499.650055699
9666,Anne of Avonlea,0,0,0,0.0,0.0,0.0
9667,September,0,0,0,0.0,0.0,0.0
9668,Steel Dawn,0,0,0,0.0,0.0,0.0
9669,Throw Momma from the Train,57915972,14000000,43915972,111145408.9167,26867126.132905103,84278282.78379491
9670,Moonstruck,80640528,0,80640528,154755659.800004,0.0,154755659.800004
9671,The Monster Squad,3769990,12000000,-8230010,7234914.06069936,23028965.2567758,-15794051.19607644
9672,Ghoulies II,0,0,0,0.0,0.0,0.0
9673,Eddie Murphy Raw,50504655,0,50504655,96922495.4417041,0.0,96922495.4417041
9674,Summer School,35114428,0,35114428,67387411.8686297,0.0,67387411.8686297
9675,The Fourth Protocol,0,0,0,0.0,0.0,0.0
9676,Maurice,0,0,0,0.0,0.0,0.0
9677,Red's Dream,0,0,0,0.0,0.0,0.0
9678,Khane-ye doust kodjast?,0,0,0,0.0,0.0,0.0
9679,Can't Buy Me Love,31623833,1800000,29823833,60688679.2869234,3454344.78851637,57234334.49840703
9680,Deliria,0,1000000,-1000000,0.0,1919080.43806465,-1919080.43806465
9681,Date With an Angel,0,0,0,0.0,0.0,0.0
9682,Revenge of the Nerds II: Nerds in Paradise,22642033,0,22642033,43451882.6083143,0.0,43451882.6083143
9683,Amazon Women on the Moon,0,0,0,0.0,0.0,0.0
9684,The Stepfather,0,0,0,0.0,0.0,0.0
9685,Hot Pursuit,4215859,0,4215859,8090572.53653881,0.0,8090572.53653881
9686,Flowers in the Attic,0,0,0,0.0,0.0,0.0
9687,Benji the Hunted,0,0,0,0.0,0.0,0.0
9688,Mannequin,42721196,6000000,36721196,81985411.5343259,11514482.6283879,70470928.905938
9689,Oci ciornie,0,0,0,0.0,0.0,0.0
9690,Black Widow,25205460,0,25205460,48371305.2184211,0.0,48371305.2184211
9691,River's Edge,0,19000000,-19000000,0.0,36462528.3232284,-36462528.3232284
9692,Gandahar,0,0,0,0.0,0.0,0.0
9693,Cry Freedom,0,0,0,0.0,0.0,0.0
9694,Less Than Zero,12396383,0,12396383,23789656.1180572,0.0,23789656.1180572
9695,Escape from Sobibor,0,0,0,0.0,0.0,0.0
9696,Wanted: Dead or Alive,0,0,0,0.0,0.0,0.0
9697,Dolls,0,0,0,0.0,0.0,0.0
9698,Baby Boom,0,0,0,0.0,0.0,0.0
9699,Best Seller,4278150,0,4278150,8210113.97610629,0.0,8210113.97610629
9700,Beauty and the Beast,0,0,0,0.0,0.0,0.0
9701,No Man's Land,0,0,0,0.0,0.0,0.0
9702,Prick Up Your Ears,0,0,0,0.0,0.0,0.0
9703,Teen Wolf Too,0,0,0,0.0,0.0,0.0
9704,Ernest Goes to Camp,23509382,3000000,20509382,45116395.1071892,5757241.31419396,39359153.792995244
9705,Hamburger Hill,13839404,0,13839404,26558929.4908737,0.0,26558929.4908737
9706,Who's That Girl,7305209,0,7305209,14019283.687873801,0.0,14019283.687873801
9707,Three O'Clock High,3685862,0,3685862,7073465.66160585,0.0,7073465.66160585
9708,Miami Connection,0,0,0,0.0,0.0,0.0
9709,Like Father Like Son,34377585,0,34377585,65973350.881404795,0.0,65973350.881404795
9710,"Silent Night, Deadly Night Part 2",154323,250000,-95677,296158.250443451,479770.10951616295,-183611.85907271196
9711,The Secret Garden,0,0,0,0.0,0.0,0.0
9712,Hope and Glory,0,0,0,0.0,0.0,0.0
9713,The Principal,0,0,0,0.0,0.0,0.0
9714,84 Charing Cross Road,0,95,-95,0.0,182.312641616142,-182.312641616142
9715,My Best Friend's Birthday,0,0,0,0.0,0.0,0.0
9716,Hello Mary Lou: Prom Night II,2683519,0,2683519,5149888.81807482,0.0,5149888.81807482
9717,Hollywood Shuffle,0,0,0,0.0,0.0,0.0
9718,Scooby-Doo Meets the Boo Brothers,0,0,0,0.0,0.0,0.0
9719,2001: A Space Odyssey,56715371,12000000,44715371,355546597.20654905,75227563.3792221,280319033.82732695
9720,Planet of the Apes,33395426,5800000,27595426,209354710.49926,36359988.966624,172994721.53263602
9721,Night of the Living Dead,0,114000,-114000,0.0,714661.85210261,-714661.85210261
9722,The Boston Strangler,0,0,0,0.0,0.0,0.0
9723,Barbarella,0,0,0,0.0,0.0,0.0
9724,Bullitt,42300873,5500000,36800873,265182633.716993,34479299.88214339,230703333.8348496
9725,The Love Bug,0,0,0,0.0,0.0,0.0
9726,The Lion in Winter,0,0,0,0.0,0.0,0.0
9727,Rosemary's Baby,33395426,3200000,30195426,209354710.49926,20060683.567792498,189294026.9314675
9728,Yellow Submarine,0,0,0,0.0,0.0,0.0
9729,Oliver!,16800000,10000000,6800000,105318588.730911,62689636.14935171,42628952.58155929
9730,Hang 'em High,6800000,1800000,5000000,42628952.5815592,11284134.5068833,31344818.074675903
9731,Where Eagles Dare,21000000,7700000,13300000,131648235.913638,48271019.8350008,83377216.0786372
9732,The Party,0,1500000,-1500000,0.0,9403445.42240277,-9403445.42240277
9733,The Thomas Crown Affair,0,4300000,-4300000,0.0,26956543.5442212,-26956543.5442212
9734,The Odd Couple,0,0,0,0.0,0.0,0.0
9735,Romeo and Juliet,38901218,0,38901218,243870320.21866098,0.0,243870320.21866098
9736,The Devil Rides Out,0,0,0,0.0,0.0,0.0
9737,The Green Berets,11000000,7000000,4000000,68958599.7642869,43882745.30454621,25075854.4597407
9738,Chitty Chitty Bang Bang,0,10000000,-10000000,0.0,62689636.14935171,-62689636.14935171
9739,The Swimmer,0,0,0,0.0,0.0,0.0
9740,Blackbeard's Ghost,0,0,0,0.0,0.0,0.0
9741,Pretty Poison,0,1800000,-1800000,0.0,11284134.5068833,-11284134.5068833
9742,Funny Girl,0,0,0,0.0,0.0,0.0
9743,If....,500000,0,500000,3134481.80746758,0.0,3134481.80746758
9744,The Little Drummer Boy,0,0,0,0.0,0.0,0.0
9745,Faces,0,275000,-275000,0.0,1723964.99410717,-1723964.99410717
9746,Hell in the Pacific,0,0,0,0.0,0.0,0.0
9747,"Yours, Mine and Ours",0,0,0,0.0,0.0,0.0
9748,The Devil's Brigade,0,0,0,0.0,0.0,0.0
9749,Hellfighters,0,0,0,0.0,0.0,0.0
9750,Witchfinder General,0,0,0,0.0,0.0,0.0
9751,Coogan's Bluff,3110000,0,3110000,19496476.8424484,0.0,19496476.8424484
9752,Carry On... Up the Khyber,0,0,0,0.0,0.0,0.0
9753,Ice Station Zebra,0,0,0,0.0,0.0,0.0
9754,Head,0,0,0,0.0,0.0,0.0
9755,The Big Shave,0,0,0,0.0,0.0,0.0
9756,Charly,814666,950000,-135334,5107111.51232478,5955515.43418842,-848403.9218636397
9757,The Alphabet,0,0,0,0.0,0.0,0.0
9758,The Godfather: Part II,47542841,13000000,34542841,210247939.768493,57489690.5506849,152758249.2178081
9759,Chinatown,30000000,6000000,24000000,132668516.655426,26533703.3310853,106134813.3243407
9760,The Man with the Golden Gun,97572000,7000000,90572000,431491083.570109,30955987.2195995,400535096.3505095
9761,Young Frankenstein,86273333,2800000,83473333,381525170.534322,12382394.887839802,369142775.6464822
9762,The Texas Chain Saw Massacre,30859000,85000,30774000,136467258.51566002,375894.130523709,136091364.3851363
9763,Dark Star,0,60000,-60000,0.0,265337.033310853,-265337.033310853
9764,The Conversation,4420000,1600000,2820000,19546494.7872328,7075654.22162275,12470840.565610051
9765,Herbie Rides Again,0,0,0,0.0,0.0,0.0
9766,Murder on the Orient Express,27634716,0,27634716,122208559.33046599,0.0,122208559.33046599
9767,Blazing Saddles,119500000,2600000,116900000,528462924.67744905,11497938.1101369,516964986.5673121
9768,The Four Musketeers,0,0,0,0.0,0.0,0.0
9769,Airport 1975,47000000,3000000,44000000,207847342.760168,13266851.665542599,194580491.09462538
9770,The Sugarland Express,12800000,3000000,9800000,56605233.772981994,13266851.665542599,43338382.1074394
9771,Il portiere di notte,0,0,0,0.0,0.0,0.0
9772,The Great Gatsby,26533200,6500000,20033200,117337342.870725,28744845.2753424,88592497.5953826
9773,Foxy Brown,0,500000,-500000,0.0,2211141.94425711,-2211141.94425711
9774,Deranged,0,200000,-200000,0.0,884456.7777028441,-884456.7777028441
9775,Black Christmas,0,0,0,0.0,0.0,0.0
9776,Thunderbolt and Lightfoot,21700000,0,21700000,95963560.3807586,0.0,95963560.3807586
9777,Female Trouble,0,25000,-25000,0.0,110557.097212855,-110557.097212855
9778,Phantom of the Paradise,0,0,0,0.0,0.0,0.0
9779,The Taking of Pelham One Two Three,0,0,0,0.0,0.0,0.0
9780,Alice Doesn't Live Here Anymore,0,0,0,0.0,0.0,0.0
9781,Death Wish,22000000,3000000,19000000,97290245.5473129,13266851.665542599,84023393.8817703
9782,The Parallax View,0,0,0,0.0,0.0,0.0
9783,The Front Page,0,4000000,-4000000,0.0,17689135.5540568,-17689135.5540568
9784,It's Alive,0,0,0,0.0,0.0,0.0
9785,The Towering Inferno,116000000,14000000,102000000,512984931.067649,61911974.4391991,451072956.6284499
9786,Gone in 60 Seconds,0,0,0,0.0,0.0,0.0
9787,Zardoz,0,0,0,0.0,0.0,0.0
9788,The Year Without a Santa Claus,0,0,0,0.0,0.0,0.0
9789,Bring Me the Head of Alfredo Garcia,0,1500000,-1500000,0.0,6633425.83277133,-6633425.83277133
9790,Earthquake,79666653,7000000,72666653,352308556.013753,30955987.2195995,321352568.7941535
9791,The Longest Yard,43008075,0,43008075,190193917.14851102,0.0,190193917.14851102
9792,Phase IV,0,0,0,0.0,0.0,0.0
9793,Animals Are Beautiful People,0,0,0,0.0,0.0,0.0
9794,The Odessa File,0,0,0,0.0,0.0,0.0
9795,The Count of Monte-Cristo,0,0,0,0.0,0.0,0.0
9796,Lenny,0,0,0,0.0,0.0,0.0
9797,Madhouse,0,0,0,0.0,0.0,0.0
9798,A Woman Under the Influence,0,0,0,0.0,0.0,0.0
9799,The Amputee,0,0,0,0.0,0.0,0.0
9800,Flesh Gordon,0,700000,-700000,0.0,3095598.72195995,-3095598.72195995
9801,Captain Kronos: Vampire Hunter,0,400000,-400000,0.0,1768913.55540568,-1768913.55540568
9802,Where the Red Fern Grows,0,0,0,0.0,0.0,0.0
9803,Benji,0,0,0,0.0,0.0,0.0
9804,Hearts and Minds,30000,0,30000,132668.516655426,0.0,132668.516655426
9805,One Flew Over the Cuckoo's Nest,108981275,3000000,105981275,441572637.403333,12155463.5161866,429417173.8871464
9806,Jaws,470654000,7000000,463654000,1907005841.91576,28362748.2044354,1878643093.7113247
9807,Monty Python and the Holy Grail,5028948,400000,4628948,20376397.9795998,1620728.46882488,18755669.51077492
9808,The Rocky Horror Picture Show,112892319,1200000,111692319,457419488.2874,4862185.40647464,452557302.88092536
9809,Barry Lyndon,20000000,11000000,9000000,81036423.4412441,44570032.89268421,36466390.54855989
9810,The Return of the Pink Panther,41833347,5000000,36833347,169501241.072824,20259105.860310998,149242135.212513
9811,The Man Who Would Be King,0,0,0,0.0,0.0,0.0
9812,The Story of O,0,0,0,0.0,0.0,0.0
9813,Three Days of the Condor,27476252,0,27476252,111328859.58251598,0.0,111328859.58251598
9814,Ilsa: She Wolf of the SS,0,0,0,0.0,0.0,0.0
9815,A Boy and His Dog,0,0,0,0.0,0.0,0.0
9816,Death Race 2000,0,300000,-300000,0.0,1215546.35161866,-1215546.35161866
9817,Love and Death,0,0,0,0.0,0.0,0.0
9818,Escape to Witch Mountain,20000000,0,20000000,81036423.4412441,0.0,81036423.4412441
9819,Black Moon,0,0,0,0.0,0.0,0.0
9820,Picnic at Hanging Rock,0,0,0,0.0,0.0,0.0
9821,French Connection II,12484444,0,12484444,50584734.5206249,0.0,50584734.5206249
9822,Hard Times,5000000,2700000,2300000,20259105.860310998,10939917.1645679,9319188.695743097
9823,Supervixens,0,0,0,0.0,0.0,0.0
9824,Tommy,34251525,5000000,29251525,138781054.17041698,20259105.860310998,118521948.31010598
9825,Breakheart Pass,0,0,0,0.0,0.0,0.0
9826,Nashville,0,2200000,-2200000,0.0,8914006.57853685,-8914006.57853685
9827,The Stepford Wives,0,0,0,0.0,0.0,0.0
9828,The Land That Time Forgot,0,1500000,-1500000,0.0,6077731.75809331,-6077731.75809331
9829,The Adventure of Sherlock Holmes' Smarter Brother,0,0,0,0.0,0.0,0.0
9830,Dog Day Afternoon,46665856,1800000,44865856,189081703.353206,7293278.10971197,181788425.24349403
9831,The Eiger Sanction,14200000,0,14200000,57535860.6432833,0.0,57535860.6432833
9832,Shivers,0,179000,-179000,0.0,725275.989799135,-725275.989799135
9833,Bug,0,0,0,0.0,0.0,0.0
9834,The Sunshine Boys,0,0,0,0.0,0.0,0.0
9835,Rollerball,30000000,0,30000000,121554635.161866,0.0,121554635.161866
9836,The Hindenburg,0,15000000,-15000000,0.0,60777317.58093311,-60777317.58093311
9837,Professione: reporter,0,0,0,0.0,0.0,0.0
9838,Shampoo,0,0,0,0.0,0.0,0.0
9839,The Wind and the Lion,0,0,0,0.0,0.0,0.0
9840,Rooster Cogburn,8022000,0,8022000,32503709.442283,0.0,32503709.442283
9841,Race with the Devil,0,0,0,0.0,0.0,0.0
9842,The Apple Dumpling Gang,0,0,0,0.0,0.0,0.0
9843,Grey Gardens,0,0,0,0.0,0.0,0.0
9844,Night Moves,0,0,0,0.0,0.0,0.0
9845,Trilogy of Terror,0,0,0,0.0,0.0,0.0
9846,The Ultimate Warrior,0,0,0,0.0,0.0,0.0
9847,Boss Nigger,0,0,0,0.0,0.0,0.0
9848,Coonskin,0,0,0,0.0,0.0,0.0
9849,Dr. No,59600000,1100000,58500000,429623553.174204,7929293.7666380005,421694259.407566
9850,Lawrence of Arabia,70000000,15000000,55000000,504591421.51332694,108126733.181427,396464688.33189994
9851,Lolita,0,2000000,-2000000,0.0,14416897.7575236,-14416897.7575236
9852,To Kill a Mockingbird,13129846,2000000,11129846,94645823.67701529,14416897.7575236,80228925.9194917
9853,The Manchurian Candidate,0,2200000,-2200000,0.0,15858587.533276001,-15858587.533276001
9854,Hatari!,0,0,0,0.0,0.0,0.0
9855,Cape Fear,0,0,0,0.0,0.0,0.0
9856,How the West Was Won,50000000,15000000,35000000,360422443.93809104,108126733.181427,252295710.75666404
9857,Mutiny on the Bounty,0,0,0,0.0,0.0,0.0
9858,The Man Who Shot Liberty Valance,8000000,3200000,4800000,57667591.0300945,23067036.4120378,34600554.6180567
9859,The 300 Spartans,0,0,0,0.0,0.0,0.0
9860,Experiment in Terror,0,0,0,0.0,0.0,0.0
9861,The Loneliness of the Long Distance Runner,0,0,0,0.0,0.0,0.0
9862,The Music Man,8000000,0,8000000,57667591.0300945,0.0,57667591.0300945
9863,Captain Clegg,0,0,0,0.0,0.0,0.0
9864,What Ever Happened to Baby Jane?,0,980000,-980000,0.0,7064279.90118658,-7064279.90118658
9865,Le procÃ¨s,0,0,0,0.0,0.0,0.0
9866,Birdman of Alcatraz,3100000,2650000,450000,22346191.524161603,19102389.528718803,3243801.9954428
9867,Boccaccio '70,0,126,-126,0.0,908.2645587239889,-908.2645587239889
9868,The Longest Day,0,10000000,-10000000,0.0,72084488.78761809,-72084488.78761809
9869,The Brain That Wouldn't Die,0,62000,-62000,0.0,446923.83048323204,-446923.83048323204
9870,Days of Wine and Roses,0,0,0,0.0,0.0,0.0
9871,The Miracle Worker,2500000,500000,2000000,18021122.196904503,3604224.43938091,14416897.757523593
9872,Tales of Terror,0,0,0,0.0,0.0,0.0
9873,Panic in Year Zero!,0,0,0,0.0,0.0,0.0
9874,Premature Burial,1250000,0,1250000,9010561.09845227,0.0,9010561.09845227
9875,In Search of the Castaways,0,0,0,0.0,0.0,0.0
9876,Hell Is for Heroes,0,0,0,0.0,0.0,0.0
9877,Carnival of Souls,0,30000,-30000,0.0,216253.46636285397,-216253.46636285397
9878,Ride the High Country,0,0,0,0.0,0.0,0.0
9879,Advise & Consent,0,0,0,0.0,0.0,0.0
9880,That Touch of Mink,0,0,0,0.0,0.0,0.0
9881,Goldfinger,124900000,3500000,121400000,878080399.544157,24605935.9359851,853474463.6081719
9882,Dr. Strangelove or: How I Learned to Stop Worrying and Love the Bomb,9440272,1800000,7640272,66367636.585792795,12654481.3385066,53713155.24728619
9883,Mary Poppins,102272727,6000000,96272727,719004619.5887151,42181604.4616889,676823015.1270262
9884,A Hard Day's Night,1000549,500000,500549,7034127.02708972,3515133.70514074,3518993.3219489795
9885,"Rudolph, the Red-Nosed Reindeer",0,0,0,0.0,0.0,0.0
9886,Marnie,7000000,2135161,4864839,49211871.871970296,15010752.794004,34201119.077966295
9887,My Fair Lady,72000000,17000000,55000000,506179253.54026604,119514545.97478501,386664707.565481
9888,A Shot in the Dark,12368234,0,12368234,86951992.4129354,0.0,86951992.4129354
9889,The Last Man on Earth,0,0,0,0.0,0.0,0.0
9890,The Masque of the Red Death,0,0,0,0.0,0.0,0.0
9891,Murder Ahoy,0,0,0,0.0,0.0,0.0
9892,Fail-Safe,0,0,0,0.0,0.0,0.0
9893,Zulu,0,0,0,0.0,0.0,0.0
9894,Send Me No Flowers,0,0,0,0.0,0.0,0.0
9895,Carry On Cleo,0,0,0,0.0,0.0,0.0
9896,The Incredible Mr. Limpet,0,0,0,0.0,0.0,0.0
9897,The Train,0,0,0,0.0,0.0,0.0
9898,Viva Las Vegas,0,0,0,0.0,0.0,0.0
9899,The Naked Kiss,0,0,0,0.0,0.0,0.0
9900,The Gorgon,0,0,0,0.0,0.0,0.0
9901,Seven Days in May,0,0,0,0.0,0.0,0.0
9902,Paris When It Sizzles,0,0,0,0.0,0.0,0.0
9903,Il deserto rosso,0,0,0,0.0,0.0,0.0
9904,Zorba the Greek,0,783000,-783000,0.0,5504699.3822504,-5504699.3822504
9905,The Night of the Iguana,12000000,3000000,9000000,84363208.9233778,21090802.230844397,63272406.6925334
9906,The Killers,0,0,0,0.0,0.0,0.0
9907,Robinson Crusoe on Mars,0,1200000,-1200000,0.0,8436320.89233778,-8436320.89233778
9908,Dead Ringer,0,0,0,0.0,0.0,0.0
9909,Seance on a Wet Afternoon,0,0,0,0.0,0.0,0.0
9910,The Tomb of Ligeia,0,0,0,0.0,0.0,0.0
9911,Topkapi,0,0,0,0.0,0.0,0.0
9912,Man's Favorite Sport?,0,0,0,0.0,0.0,0.0
9913,Father Goose,0,0,0,0.0,0.0,0.0
9914,"Kiss Me, Stupid",0,3500000,-3500000,0.0,24605935.9359851,-24605935.9359851
9915,Cheyenne Autumn,0,0,0,0.0,0.0,0.0
9916,First Men in the Moon,0,0,0,0.0,0.0,0.0
9917,Robin and the 7 Hoods,0,0,0,0.0,0.0,0.0
9918,The Americanization of Emily,0,0,0,0.0,0.0,0.0
9919,Becket,0,0,0,0.0,0.0,0.0
9920,Scorpio Rising,0,0,0,0.0,0.0,0.0
9921,"Hush... Hush, Sweet Charlotte",0,0,0,0.0,0.0,0.0
9922,Two Thousand Maniacs!,0,65000,-65000,0.0,456967.381668296,-456967.381668296
9923,A Clockwork Orange,26589000,2200000,24389000,143186947.579974,11847428.8117621,131339518.7682119
9924,Willy Wonka & the Chocolate Factory,4000000,3000000,1000000,21540779.657749303,16155584.743311903,5385194.9144374
9925,Diamonds Are Forever,116000000,7200000,108800000,624682610.07473,38773403.383948706,585909206.6907814
9926,Summer of '42,0,0,0,0.0,0.0,0.0
9927,Dirty Harry,35976000,4000000,31976000,193737772.241797,21540779.657749303,172196992.5840477
9928,Escape from the Planet of the Apes,12348905,2500000,9848905,66501260.404869705,13462987.286093302,53038273.1187764
9929,Straw Dogs,3251794,2200000,1051794,17511544.5115978,11847428.8117621,5664115.699835701
9930,The Omega Man,0,0,0,0.0,0.0,0.0
9931,Bedknobs and Broomsticks,0,20000000,-20000000,0.0,107703898.288746,-107703898.288746
9932,THX 1138,2437000,777000,1660000,13123720.006483698,4184296.4485178003,8939423.557965897
9933,Harold and Maude,0,1200000,-1200000,0.0,6462233.89732479,-6462233.89732479
9934,The French Connection,41158757,1800000,39358757,221647928.880961,9693350.84598719,211954578.0349738
9935,Play Misty for Me,10600000,725000,9875000,57083066.093035705,3904266.31296706,53178799.78006864
9936,Monty Python's And Now for Something Completely Different,0,0,0,0.0,0.0,0.0
9937,Hannie Caulder,0,0,0,0.0,0.0,0.0
9938,The Panic in Needle Park,0,1645000,-1645000,0.0,8858645.6342494,-8858645.6342494
9939,Duel,0,450000,-450000,0.0,2423337.71149679,-2423337.71149679
9940,Get Carter,0,750000,-750000,0.0,4038896.18582799,-4038896.18582799
9941,Bananas,0,2000000,-2000000,0.0,10770389.828874601,-10770389.828874601
9942,Wake in Fright,0,0,0,0.0,0.0,0.0
9943,Macbeth,0,0,0,0.0,0.0,0.0
9944,The Andromeda Strain,0,6500000,-6500000,0.0,35003766.943842605,-35003766.943842605
9945,Big Jake,0,0,0,0.0,0.0,0.0
9946,Two-Lane Blacktop,0,850000,-850000,0.0,4577415.67727173,-4577415.67727173
9947,Walkabout,0,0,0,0.0,0.0,0.0
9948,Shaft,12121618,4000000,8121618,65277275.608352005,21540779.657749303,43736495.9506027
9949,GiÃ¹ la testa,0,0,0,0.0,0.0,0.0
9950,Fiddler on the Roof,10404330,9000000,1404330,56029345.004127696,48466754.2299359,7562590.774191797
9951,The Last Picture Show,29133000,1300000,27833000,156886883.442302,7000753.38876852,149886130.05353346
9952,Vanishing Point,72266306,1300000,70966306,389168143.556371,7000753.38876852,382167390.1676025
9953,McCabe & Mrs. Miller,0,0,0,0.0,0.0,0.0
9954,The House That Dripped Blood,0,0,0,0.0,0.0,0.0
9955,The Anderson Tapes,0,0,0,0.0,0.0,0.0
9956,Sunday Bloody Sunday,0,0,0,0.0,0.0,0.0
9957,Klute,0,2500000,-2500000,0.0,13462987.286093302,-13462987.286093302
9958,Johnny Got His Gun,0,0,0,0.0,0.0,0.0
9959,Le Mans,0,0,0,0.0,0.0,0.0
9960,The Beguiled,0,0,0,0.0,0.0,0.0
9961,Countess Dracula,0,0,0,0.0,0.0,0.0
9962,Brian's Song,0,0,0,0.0,0.0,0.0
9963,Man in the Wilderness,0,0,0,0.0,0.0,0.0
9964,Punishment Park,0,0,0,0.0,0.0,0.0
9965,A New Leaf,0,0,0,0.0,0.0,0.0
9966,Twins of Evil,0,0,0,0.0,0.0,0.0
9967,Sacco e Vanzetti,0,0,0,0.0,0.0,0.0
9968,Carnal Knowledge,28623900,0,28623900,154145280.711362,0.0,154145280.711362
9969,Dad's Army,0,0,0,0.0,0.0,0.0
9970,Hands of the Ripper,0,0,0,0.0,0.0,0.0
9971,Nicholas and Alexandra,0,0,0,0.0,0.0,0.0
9972,10 Rillington Place,0,0,0,0.0,0.0,0.0
9973,The Abominable Dr. Phibes,0,0,0,0.0,0.0,0.0
9974,The Devils,0,0,0,0.0,0.0,0.0
9975,The Go-Between,0,100000,-100000,0.0,538519.491443733,-538519.491443733
9976,Les lÃ¨vres rouges,0,0,0,0.0,0.0,0.0
9977,The Hospital,0,0,0,0.0,0.0,0.0
9978,Total Recall,261317921,65000000,196317921,436113096.91494,108478405.120447,327634691.794493
9979,Goodfellas,46836394,25000000,21836394,78165189.5801985,41722463.507864505,36442726.07233399
9980,Die Hard 2,240031094,70000000,170031094,400587542.406711,116822897.82202,283764644.584691
9981,Back to the Future Part III,244527583,40000000,204527583,408091726.335352,66755941.612583205,341335784.7227688
9982,Edward Scissorhands,53000000,20000000,33000000,88451622.6366727,33377970.806291603,55073651.8303811
9983,Pretty Woman,463000000,14000000,449000000,772700024.16565,23364579.5644041,749335444.6012459
9984,The Godfather: Part III,136766062,54000000,82766062,228248681.236373,90120521.17698729,138128160.05938572
9985,Dances with Wolves,424208848,22000000,402208848,707961527.215729,36715767.886920705,671245759.3288083
9986,Ghost,505000000,22000000,483000000,842793762.858863,36715767.886920705,806077994.9719423
9987,Teenage Mutant Ninja Turtles,201965915,13500000,188465915,337060620.736798,22530130.2942468,314530490.4425512
9988,Misery,61276872,20000000,41276872,102264882.235843,33377970.806291603,68886911.4295514
9989,Rocky V,119946358,42000000,77946358,200178301.78225,70093738.69321229,130084563.0890377
9990,Child's Play 2,35763605,13000000,22763605,59685828.18088721,21695681.0240895,37990147.15679771
9991,The Witches,0,0,0,0.0,0.0,0.0
9992,The Hunt for Red October,200,30,170,333.779708062916,50.0669562094374,283.71275185347855
9993,Predator 2,57120318,35000000,22120318,95328015.33250459,58411448.9110103,36916566.42149428
9994,Days of Thunder,157920733,60000000,97920733,263553680.789108,100133912.418874,163419768.370234
9995,Stephen King's It,0,0,0,0.0,0.0,0.0
9996,Miller's Crossing,5080409,14000000,-8919591,8478687.16430105,23364579.5644041,-14885892.40010305
9997,Gremlins 2: The New Batch,41482207,50000000,-8517793,69229594.7113272,83444927.01572901,-14215332.304401815
9998,Tremors,48572000,11000000,37572000,81061739.9001598,18357883.9434603,62703855.956699505
9999,RoboCop 2,45681173,35000000,10681173,76237242.9395578,58411448.9110103,17825794.028547503
10000,The Neverending Story II: The Next Chapter,16283667,32000000,-15716333,27175788.0872687,53404753.290066496,-26228965.202797797
10001,Look Who's Talking Too,0,0,0,0.0,0.0,0.0
10002,Awakenings,52096475,0,52096475,86943731.08303499,0.0,86943731.08303499
10003,Another 48 Hrs.,153518974,38000000,115518974,256207591.619192,63418144.531954005,192789447.087238
10004,DuckTales: The Movie - Treasure of the Lost Lamp,0,0,0,0.0,0.0,0.0
10005,Lionheart,24078196,6000000,18078196,40184066.1578083,10013391.2418874,30170674.9159209
10006,Death Warrant,16853487,4000000,12853487,28126759.8535107,6675594.16125832,21451165.69225238
10007,Green Card,29888235,0,29888235,49880431.7640791,0.0,49880431.7640791
10008,The Reflecting Skin,0,0,0,0.0,0.0,0.0
10009,Presumed Innocent,221303188,0,221303188,369332567.420163,0.0,369332567.420163
10010,Joe Versus the Volcano,39404261,0,39404261,65761713.665074706,0.0,65761713.665074706
10011,Wild at Heart,14560247,9500000,5060247,24299574.964919697,15854536.132988501,8445038.831931196
10012,A Grand Day Out,0,0,0,0.0,0.0,0.0
10013,The Exorcist III,39024251,0,39024251,65127515.5307698,0.0,65127515.5307698
10014,Flatliners,61489265,26000000,35489265,102619344.603516,43391362.048179105,59227982.55533689
10015,Captain America,0,10000000,-10000000,0.0,16688985.403145801,-16688985.403145801
10016,Men at Work,0,0,0,0.0,0.0,0.0
10017,Henry & June,11567449,0,11567449,19304898.751263298,0.0,19304898.751263298
10018,Air America,33461269,0,33461269,55843462.9911735,0.0,55843462.9911735
10019,Jacob's Ladder,25965144,25000000,965144,43333190.92065779,41722463.507864505,1610727.4127932861
10020,State of Grace,0,0,0,0.0,0.0,0.0
10021,Cry-Baby,8266343,11000000,-2733657,13795687.7664396,18357883.9434603,-4562196.177020701
10022,Mo' Better Blues,16153593,10000000,6153593,26958707.778535802,16688985.403145801,10269722.37539
10023,Dark Angel,9229401,7000000,2229401,15402933.856877899,11682289.782202,3720644.074675899
10024,Pump up the Volume,11541758,0,11541758,19262023.0788641,0.0,19262023.0788641
10025,Young Guns II,0,0,0,0.0,0.0,0.0
10026,Bird on a Wire,0,0,0,0.0,0.0,0.0
10027,Dick Tracy,103738726,47000000,56738726,173129408.39549398,78438231.3947853,94691177.00070868
10028,Darkman,48878502,16000000,32878502,81573260.6405633,26702376.6450332,54870883.9955301
10029,The Hot Spot,1293976,0,1293976,2159514.65760209,0.0,2159514.65760209
10030,Alice,0,0,0,0.0,0.0,0.0
10031,Night of the Living Dead,5835247,4200000,1635247,9738435.20067503,7009373.86932123,2729061.3313537994
10032,The Grifters,13446769,0,13446769,22441293.156047303,0.0,22441293.156047303
10033,Blue Steel,0,0,0,0.0,0.0,0.0
10034,Cadillac Man,27575086,0,27575086,46020020.774449,0.0,46020020.774449
10035,The Bonfire of the Vanities,15691192,47000000,-31308808,26187007.4245958,78438231.3947853,-52251223.9701895
10036,Marked for Death,46044400,12000000,34044400,76843431.9496606,20026782.4837749,56816649.4658857
10037,Hidden Agenda,1030938,0,1030938,1720530.92335483,0.0,1720530.92335483
10038,Rosencrantz & Guildenstern Are Dead,0,0,0,0.0,0.0,0.0
10039,Kindergarten Cop,201957688,15000000,186957688,337046890.708507,25033478.104718696,312013412.6037883
10040,Fire Birds,0,22000000,-22000000,0.0,36715767.886920705,-36715767.886920705
10041,My Blue Heaven,0,0,0,0.0,0.0,0.0
10042,The Freshman,0,0,0,0.0,0.0,0.0
10043,King of New York,2554476,1000000,1554476,4263161.26766862,1668898.54031458,2594262.7273540394
10044,Graveyard Shift,11582891,10500000,1082891,19330669.8825228,17523434.673303,1807235.2092197984
10045,Jetsons: The Movie,20,0,20,33.3779708062916,0.0,33.3779708062916
10046,The Sheltering Sky,2075084,25000000,-22924916,3463104.65863014,41722463.507864505,-38259358.849234365
10047,Hardware,5728953,1500000,4228953,9561041.29923083,2503347.81047187,7057693.488758961
10048,Quick Change,0,0,0,0.0,0.0,0.0
10049,Lord of the Flies,0,0,0,0.0,0.0,0.0
10050,Tales from the Darkside: The Movie,16,3,13,26.702376645033198,5.00669562094374,21.69568102408946
10051,Repossessed,1382462,0,1382462,2307188.81384037,0.0,2307188.81384037
10052,Hard to Kill,47410000,10000000,37410000,79122479.79631421,16688985.403145801,62433494.393168405
10053,Class of 1999,0,0,0,0.0,0.0,0.0
10054,Delta Force 2: The Colombian Connection,6698361,0,6698361,11178884.8954001,0.0,11178884.8954001
10055,The Rescuers Down Under,27931461,37931000,-9999539,46614774.4917536,63302990.5326723,-16688216.0409187
10056,Psycho IV: The Beginning,0,0,0,0.0,0.0,0.0
10057,Problem Child,0,0,0,0.0,0.0,0.0
10058,Three Men and a Little Lady,0,0,0,0.0,0.0,0.0
10059,Desperate Hours,0,0,0,0.0,0.0,0.0
10060,Ernest Goes to Jail,0,0,0,0.0,0.0,0.0
10061,Treasure Island,0,0,0,0.0,0.0,0.0
10062,Europa Europa,0,0,0,0.0,0.0,0.0
10063,Frankenhooker,205068,2500000,-2294932,342237.68586523,4172246.35078645,-3830008.66492122
10064,"Welcome Home, Roxy Carmichael",0,0,0,0.0,0.0,0.0
10065,Moon 44,0,0,0,0.0,0.0,0.0
10066,Revenge,15645616,0,15645616,26110945.7047224,0.0,26110945.7047224
10067,Taking Care of Business,0,0,0,0.0,0.0,0.0
10068,Nightbreed,8862354,11000000,-2137646,14790369.654351002,18357883.9434603,-3567514.289109299
10069,The Two Jakes,10000000,19000000,-9000000,16688985.403145801,31709072.265977003,-15020086.862831201
10070,The Rookie,0,0,0,0.0,0.0,0.0
10071,American Ninja 4: The Annihilation,0,0,0,0.0,0.0,0.0
10072,Quigley Down Under,0,0,0,0.0,0.0,0.0
10073,White Hunter Black Heart,0,0,0,0.0,0.0,0.0
10074,White Palace,17487531,0,17487531,29184914.959605895,0.0,29184914.959605895
10075,Miami Blues,0,0,0,0.0,0.0,0.0
10076,Leatherface: Texas Chainsaw Massacre III,5765562,0,5765562,9622138.00589321,0.0,9622138.00589321
10077,The Adventures of Ford Fairlane,20423389,49000000,-28576611,34084564.0903768,81776028.47541441,-47691464.38503761
10078,Memphis Belle,0,23000000,-23000000,0.0,38384666.4272353,-38384666.4272353
10079,Maniac Cop 2,0,4000000,-4000000,0.0,6675594.16125832,-6675594.16125832
10080,Bad Influence,0,0,0,0.0,0.0,0.0
10081,Mr. Destiny,15379253,20000000,-4620747,25666412.8828286,33377970.806291603,-7711557.923463002
10082,Postcards from the Edge,39071603,22000000,17071603,65206541.21445071,36715767.886920705,28490773.327530004
10083,Metropolitan,0,225000,-225000,0.0,375502.17157078,-375502.17157078
10084,Internal Affairs,27734391,0,27734391,46285884.65641379,0.0,46285884.65641379
10085,Due occhi diabolici,0,9000000,-9000000,0.0,15020086.862831198,-15020086.862831198
10086,Cadence,0,0,0,0.0,0.0,0.0
10087,Almost an Angel,0,0,0,0.0,0.0,0.0
10088,The Guardian,17037887,0,17037887,28434504.744344704,0.0,28434504.744344704
10089,Le mari de la coiffeuse,0,0,0,0.0,0.0,0.0
10090,I Love You to Death,0,0,0,0.0,0.0,0.0
10091,Buried Alive,0,0,0,0.0,0.0,0.0
10092,The Russia House,0,22997992,-22997992,0.0,38381315.2789664,-38381315.2789664
10093,Paris is Burning,3779620,500000,3279620,6307802.30094379,834449.27015729,5473353.0307865
10094,Home Alone,476684675,18000000,458684675,795538358.29783,30040173.725662395,765498184.5721676
10095,Mermaids,35419397,31000000,4419397,59111379.95212261,51735854.749752,7375525.202370606
10096,House Party,26386000,2500000,23886000,44035556.8847405,4172246.35078645,39863310.533954054
10097,Nuns on the Run,0,0,0,0.0,0.0,0.0
10098,Troll 2,0,0,0,0.0,0.0,0.0
10099,Puppet Master II,0,0,0,0.0,0.0,0.0
10100,An Angel at My Table,0,0,0,0.0,0.0,0.0
10101,Reversal of Fortune,15445131,0,15445131,25776356.5808674,0.0,25776356.5808674
10102,Xiaoao jiang hu,0,2068041,-2068041,0.0,3451350.6062107002,-3451350.6062107002
10103,The Krays,0,0,0,0.0,0.0,0.0
10104,Ghost Dad,24707633,0,24707633,41234532.6483283,0.0,41234532.6483283
10105,Life is Sweet,0,0,0,0.0,0.0,0.0
10106,Hamlet,20710451,0,20710451,34563641.44315661,0.0,34563641.44315661
10107,Pacific Heights,29381956,0,29381956,49035503.479987204,0.0,49035503.479987204
10108,All for the Winner,0,0,0,0.0,0.0,0.0
10109,Narrow Margin,0,0,0,0.0,0.0,0.0
10110,One Hundred and One Dalmatians,215880014,4000000,211880014,1574814739.70476,29179444.8318826,1545635294.8728774
10111,Breakfast at Tiffany's,9500000,2500000,7000000,69301181.47572121,18237153.019926604,51064028.4557946
10112,West Side Story,43656822,6000000,37656822,318470457.27107996,43769167.2478239,274701290.02325606
10113,The Guns of Navarone,28900000,6000000,22900000,210821488.910352,43769167.2478239,167052321.6625281
10114,Murder She Said,0,0,0,0.0,0.0,0.0
10115,Judgment at Nuremberg,10000000,3000000,7000000,72948612.07970649,21884583.6239119,51064028.45579459
10116,The Parent Trap,0,0,0,0.0,0.0,0.0
10117,The Comancheros,0,0,0,0.0,0.0,0.0
10118,El Cid,0,0,0,0.0,0.0,0.0
10119,The Innocents,0,0,0,0.0,0.0,0.0
10120,The Hustler,0,2000000,-2000000,0.0,14589722.4159413,-14589722.4159413
10121,King of Kings,14483352,5037000,9446352,105654042.666184,36744215.904548205,68909826.76163578
10122,The Misfits,0,4000000,-4000000,0.0,29179444.8318826,-29179444.8318826
10123,The Absent-Minded Professor,0,0,0,0.0,0.0,0.0
10124,The Pit and the Pendulum,2000000,200000,1800000,14589722.4159413,1458972.24159413,13130750.17434717
10125,Mysterious Island,0,0,0,0.0,0.0,0.0
10126,Splendor in the Grass,0,0,0,0.0,0.0,0.0
10127,The Curse of the Werewolf,0,0,0,0.0,0.0,0.0
10128,The Children's Hour,0,0,0,0.0,0.0,0.0
10129,Babes in Toyland,0,0,0,0.0,0.0,0.0
10130,One-Eyed Jacks,4300000,6000000,-1700000,31367903.194273803,43769167.2478239,-12401264.053550098
10131,"One, Two, Three",4000000,3000000,1000000,29179444.8318826,21884583.6239119,7294861.207970701
10132,Devchata,0,0,0,0.0,0.0,0.0
10133,Barabbas,0,0,0,0.0,0.0,0.0
10134,Pocketful of Miracles,5000000,2900000,2100000,36474306.03985321,21155097.503114898,15319208.53673831
10135,Blue Hawaii,0,0,0,0.0,0.0,0.0
10136,Il colosso di Rodi,0,0,0,0.0,0.0,0.0
10137,The Day the Earth Caught Fire,0,0,0,0.0,0.0,0.0
10138,The Ladies Man,0,0,0,0.0,0.0,0.0
10139,Two Rode Together,0,0,0,0.0,0.0,0.0
10140,A Raisin in the Sun,0,1500000,-1500000,0.0,10942291.8119559,-10942291.8119559
10141,Psycho,32000000,806948,31193052,235934958.630279,5949601.34364958,229985357.28662944
10142,The Magnificent Seven,4905000,2000000,2905000,36164405.377547495,14745934.9143924,21418470.463155095
10143,Spartacus,60000000,12000000,48000000,442378047.431774,88475609.4863548,353902437.9454192
10144,The Apartment,25000000,3000000,22000000,184324186.429905,22118902.3715887,162205284.0583163
10145,Let's Make Love,0,0,0,0.0,0.0,0.0
10146,The Time Machine,0,750000,-750000,0.0,5529725.59289717,-5529725.59289717
10147,Peeping Tom,0,0,0,0.0,0.0,0.0
10148,Swiss Family Robinson,0,0,0,0.0,0.0,0.0
10149,Ocean's Eleven,0,0,0,0.0,0.0,0.0
10150,The Unforgiven,0,0,0,0.0,0.0,0.0
10151,The Grass Is Greener,6000000,0,6000000,44237804.7431774,0.0,44237804.7431774
10152,The Brides of Dracula,0,0,0,0.0,0.0,0.0
10153,House of Usher,0,270000,-270000,0.0,1990701.21344298,-1990701.21344298
10154,Saturday Night and Sunday Morning,0,0,0,0.0,0.0,0.0
10155,Sergeant Rutledge,0,0,0,0.0,0.0,0.0
10156,Comanche Station,0,0,0,0.0,0.0,0.0
10157,Flaming Star,0,0,0,0.0,0.0,0.0
10158,Pollyanna,0,0,0,0.0,0.0,0.0
10159,Midnight Lace,0,0,0,0.0,0.0,0.0
10160,The Little Shop of Horrors,0,30000,-30000,0.0,221189.023715887,-221189.023715887
10161,The Alamo,0,0,0,0.0,0.0,0.0
10162,Sink the Bismarck!,0,0,0,0.0,0.0,0.0
10163,Inherit the Wind,0,0,0,0.0,0.0,0.0
10164,The Lost World,0,0,0,0.0,0.0,0.0
10165,Elmer Gantry,0,0,0,0.0,0.0,0.0
10166,Carry On Constable,0,0,0,0.0,0.0,0.0
10167,Village of the Damned,0,200000,-200000,0.0,1474593.49143924,-1474593.49143924
10168,The Bellboy,10000000,0,10000000,73729674.5719623,0.0,73729674.5719623
10169,13 Ghosts,0,0,0,0.0,0.0,0.0
10170,Cinderfella,7100000,3000000,4100000,52348068.9460932,22118902.3715887,30229166.574504502
10171,The City of the Dead,0,0,0,0.0,0.0,0.0
10172,Exodus,0,0,0,0.0,0.0,0.0
10173,Taxi Driver,28262574,1300000,26962574,108293649.075468,4981207.43701933,103312441.63844867
10174,Rocky,117235147,1100000,116135147,449209681.628042,4214867.83132405,444994813.79671794
10175,Carrie,33800000,1800000,32000000,129511393.36250201,6897056.45125754,122614336.91124447
10176,The Omen,60922980,2800000,58122980,233438462.35490698,10728754.479733901,222709707.87517306
10177,Logan's Run,25000000,9000000,16000000,95792450.7119103,34485282.2562877,61307168.455622606
10178,King Kong,52614445,24000000,28614445,201602665.17588,91960752.6834339,109641912.49244611
10179,All the President's Men,70600000,8500000,62100000,270517880.810434,32569433.2420495,237948447.56838447
10180,The Enforcer,46236000,9000000,37236000,177162390.044635,34485282.2562877,142677107.7883473
10181,Family Plot,7900000,2000000,5900000,30270414.424963597,7663396.05695282,22607018.368010778
10182,The Outlaw Josey Wales,31800000,3700000,28100000,121847997.305549,14177282.705362698,107670714.6001863
10183,Marathon Man,21709020,6500000,15209020,83182409.134155,24906037.1850966,58276371.949058406
10184,Stay Hungry,0,0,0,0.0,0.0,0.0
10185,Network,23689877,3800000,19889877,90772454.9957487,14560452.5082103,76212002.4875384
10186,The Eagle Has Landed,0,0,0,0.0,0.0,0.0
10187,Up!,0,0,0,0.0,0.0,0.0
10188,Murder by Death,0,0,0,0.0,0.0,0.0
10189,Silver Streak,51079064,0,51079064,195719548.82522,0.0,195719548.82522
10190,Assault on Precinct 13,0,150000,-150000,0.0,574754.704271461,-574754.704271461
10191,The Pink Panther Strikes Again,33833201,6000000,27833201,129638609.568746,22990188.170858398,106648421.3978876
10192,Futureworld,0,0,0,0.0,0.0,0.0
10193,The Shootist,0,0,0,0.0,0.0,0.0
10194,The Cassandra Crossing,0,0,0,0.0,0.0,0.0
10195,The Killing of a Chinese Bookie,0,0,0,0.0,0.0,0.0
10196,The Missouri Breaks,0,0,0,0.0,0.0,0.0
10197,Freaky Friday,0,0,0,0.0,0.0,0.0
10198,The Boy in the Plastic Bubble,0,0,0,0.0,0.0,0.0
10199,The Man Who Fell to Earth,0,1500000,-1500000,0.0,5747547.04271462,-5747547.04271462
10200,The Little Girl Who Lives Down the Lane,0,0,0,0.0,0.0,0.0
10201,Alice Sweet Alice,0,0,0,0.0,0.0,0.0
10202,Two-Minute Warning,0,0,0,0.0,0.0,0.0
10203,Obsession,0,0,0,0.0,0.0,0.0
10204,Robin and Marian,0,0,0,0.0,0.0,0.0
10205,Bugsy Malone,0,0,0,0.0,0.0,0.0
10206,Silent Movie,0,0,0,0.0,0.0,0.0
10207,Burnt Offerings,0,0,0,0.0,0.0,0.0
10208,A Star Is Born,161000000,6000000,155000000,616903382.5847019,22990188.170858398,593913194.4138435
10209,Squirm,0,0,0,0.0,0.0,0.0
10210,Midway,0,0,0,0.0,0.0,0.0
10211,The Front,0,0,0,0.0,0.0,0.0
10212,Cannonball,0,0,0,0.0,0.0,0.0
10213,The Song Remains the Same,0,0,0,0.0,0.0,0.0
10214,Car Wash,0,0,0,0.0,0.0,0.0
10215,Î¤Î± Ï€Î±Î¹Î´Î¹Î¬ Ï„Î¿Ï… Î´Î¹Î±Î²ÏŒÎ»Î¿Ï…,0,0,0,0.0,0.0,0.0
10216,Du bi quan wang da po xue di zi,0,0,0,0.0,0.0,0.0
10217,The Food of the Gods,0,0,0,0.0,0.0,0.0
10218,The Bad News Bears,35323292,35000000,323292,135348188.315696,134109430.996674,1238757.3190219998
10219,The Town That Dreaded Sundown,0,0,0,0.0,0.0,0.0
10220,Groundhog Day,70906973,14600000,56306973,107031945.81848101,22038261.440801103,84993684.37767991
10221,The Nightmare Before Christmas,75634409,18000000,57634409,114167868.45633401,27170459.3105767,86997409.14575732
10222,Schindler's List,321265768,22000000,299265768,484941026.518066,33208339.1573716,451732687.3606944
10223,Jurassic Park,920100000,63000000,857100000,1388863311.75898,95096607.5870186,1293766704.1719615
10224,Demolition Man,159055768,57000000,102055768,240089904.03091803,86039787.8168264,154050116.21409163
10225,Mrs. Doubtfire,441286195,25000000,416286195,666108255.864819,37736749.0424677,628371506.8223513
10226,The Fugitive,368875760,44000000,324875760,556806879.318782,66416678.3147432,490390201.00403875
10227,In the Line of Fire,176997168,40000000,136997168,267171908.40173998,60378798.46794829,206793109.9337917
10228,Philadelphia,206678440,26000000,180678440,311974896.910748,39246219.0041664,272728677.9065816
10229,Dazed and Confused,7993039,6900000,1093039,12065252.2731862,10415342.735721001,1649909.537465198
10230,Last Action Hero,137298489,85000000,52298489,207247944.93212,128304946.74439,78942998.18773
10231,A Perfect World,135130999,30000000,105130999,203976183.88483799,45284098.85096121,158692085.03387678
10232,Robin Hood: Men in Tights,35739755,20000000,15739755,53948086.610971205,30189399.233974103,23758687.376997102
10233,Addams Family Values,48919043,0,48919043,73841825.9635475,0.0,73841825.9635475
10234,Cliffhanger,255000211,70000000,185000211,384915158.731332,105662897.31890899,279252261.412423
10235,Sliver,116300000,40000000,76300000,175551356.54555902,60378798.46794829,115172558.07761073
10236,Teenage Mutant Ninja Turtles III,42,21,21,63.397738391345705,31.698869195672803,31.698869195672902
10237,Stalingrad,0,0,0,0.0,0.0,0.0
10238,The Wrong Trousers,0,0,0,0.0,0.0,0.0
10239,Cool Runnings,154864401,14000000,140864401,233763161.445963,21132579.463781897,212630581.9821811
10240,Sleepless in Seattle,227799884,21000000,206799884,343857082.17645,31698869.195672803,312158212.9807772
10241,Tombstone,56505065,25000000,31505065,85292698.301333,37736749.0424677,47555949.2588653
10242,Benny & Joon,23202734,0,23202734,35023830.0022853,0.0,35023830.0022853
10243,For Love or Money,11146270,30000000,-18853730,16824959.7499834,45284098.85096121,-28459139.10097781
10244,Carlito's Way,36516012,30000000,6516012,55119823.2350296,45284098.85096121,9835724.384068392
10245,Hot Shots! Part Deux,133752825,25000000,108752825,201895871.62984398,37736749.0424677,164159122.5873763
10246,True Romance,12281551,12500000,-218449,18538632.3175707,18868374.5212338,-329742.20366309956
10247,Super Mario Bros.,20844907,42000000,-21155093,31464760.970903102,63397738.3913457,-31932977.4204426
10248,Sister Act 2: Back in the Habit,57319029,38000000,19319029,86521352.5092372,57359858.5445509,29161493.964686297
10249,Judgment Night,12136938,0,12136938,18320343.3379996,0.0,18320343.3379996
10250,The Pelican Brief,195268056,45000000,150268056,294751265.011301,67926148.2764419,226825116.73485908
10251,The Three Musketeers,53898845,30000000,23898845,81358687.49775459,45284098.85096121,36074588.64679338
10252,RoboCop 3,10696210,22000000,-11303790,16145607.699021302,33208339.1573716,-17062731.458350297
10253,What's Eating Gilbert Grape,30000000,11000000,19000000,45284098.85096121,16604169.5786858,28679929.27227541
10254,Dennis the Menace,117270765,35000000,82270765,177016697.152928,52831448.6594548,124185248.4934732
10255,Kalifornia,2395231,9000000,-6604769,3615529.24582956,13585229.655288301,-9969700.409458742
10256,A Bronx Tale,17287898,22000000,-4712102,26095562.7319111,33208339.1573716,-7112776.425460499
10257,Manhattan Murder Mystery,11285588,13500000,-2214412,17035256.0861074,20377844.4829325,-3342588.396825101
10258,Falling Down,40903593,25000000,15903593,61742744.9590495,37736749.0424677,24005995.916581802
10259,The Sandlot,32416586,0,32416586,48931862.8278229,0.0,48931862.8278229
10260,The Firm,270248367,42000000,228248367,407931792.18462795,63397738.3913457,344534053.7932823
10261,The Dark Half,10611160,15000000,-4388840,16017227.278778799,22642049.425480604,-6624822.146701805
10262,Nowhere to Run,0,0,0,0.0,0.0,0.0
10263,Hocus Pocus,39514713,28000000,11514713,59646272.318645395,42265158.927563794,17381113.3910816
10264,Point of No Return,0,0,0,0.0,0.0,0.0
10265,In the Name of the Father,65796862,13000000,52796862,99318386.76303521,19623109.5020832,79695277.26095201
10266,Body Snatchers,428868,13000000,-12571132,647363.363533802,19623109.5020832,-18975746.1385494
10267,Free Willy,153698625,20000000,133698625,232003457.591894,30189399.233974103,201814058.3579199
10268,Mad Dog and Glory,11081586,0,11081586,16727321.194980899,0.0,16727321.194980899
10269,Son in Law,36448200,0,36448200,55017463.05798679,0.0,55017463.05798679
10270,The Vanishing,0,0,0,0.0,0.0,0.0
10271,Joshua Tree,0,0,0,0.0,0.0,0.0
10272,This Boyâ€™s Life,4104962,0,4104962,6196316.83291465,0.0,6196316.83291465
10273,Striking Distance,0,30,-30,0.0,45.2840988509612,-45.2840988509612
10274,The Piano,116700000,7000000,109700000,176155144.530239,10566289.7318909,165588854.7983481
10275,Geronimo: An American Legend,18635620,35000000,-16364380,28129908.607631702,52831448.6594548,-24701540.0518231
10276,Bound by Honor,0,35000000,-35000000,0.0,52831448.6594548,-52831448.6594548
10277,Homeward Bound: The Incredible Journey,0,0,0,0.0,0.0,0.0
10278,Much Ado About Nothing,0,8000000,-8000000,0.0,12075759.6935896,-12075759.6935896
10279,The Good Son,44456478,17000000,27456478,67105718.1439195,25660989.348878,41444728.7950415
10280,Wayne's World 2,47965000,0,47965000,72401726.71287851,0.0,72401726.71287851
10281,Hard Target,74189677,18000000,56189677,111987088.899629,27170459.3105767,84816629.58905229
10282,The Remains of the Day,23237911,11500000,11737911,35076928.627128005,17358904.559535097,17718024.067592908
10283,Batman: Mask of the Phantasm,5617391,6000000,-382609,8479282.97761667,9056819.77019225,-577536.792575581
10284,The Age of Innocence,32255440,34000000,-1744560,48688617.781375,51321978.697756104,-2633360.916381106
10285,Trois couleurs : Bleu,0,0,0,0.0,0.0,0.0
10286,Rising Sun,0,0,0,0.0,0.0,0.0
10287,Fearless,0,0,0,0.0,0.0,0.0
10288,Another Stakeout,0,0,0,0.0,0.0,0.0
10289,Dave,63000000,0,63000000,95096607.5870186,0.0,95096607.5870186
10290,Needful Things,0,0,0,0.0,0.0,0.0
10291,Alive,36733909,32000000,4733909,55448732.21127379,48303038.774358705,7145693.436915085
10292,Malice,46405336,0,46405336,70047460.7545357,0.0,70047460.7545357
10293,Sniper,18994653,0,18994653,28671858.136390198,0.0,28671858.136390198
10294,Jason Goes to Hell: The Final Friday,15,3000000,-2999985,22.6420494254806,4528409.88509612,-4528387.243046694
10295,Sommersby,140081992,0,140081992,211449559.098918,0.0,211449559.098918
10296,Grumpy Old Men,0,0,0,0.0,0.0,0.0
10297,National Lampoon's Loaded Weapon 1,27,8,19,40.755688965865104,12.0757596935896,28.679929272275505
10298,Look Who's Talking Now!,0,0,0,0.0,0.0,0.0
10299,Rudy,22750363,12000000,10750363,34340989.5662417,18113639.5403845,16227350.025857195
10300,Shadowlands,0,22000000,-22000000,0.0,33208339.1573716,-33208339.1573716
10301,Splitting Heirs,3200000,0,3200000,4830303.87743587,0.0,4830303.87743587
10302,Coneheads,0,0,0,0.0,0.0,0.0
10303,Beethoven's 2nd,118243066,15000000,103243066,178484356.306157,22642049.425480604,155842306.8806764
10304,Gettysburg,25000000,0,25000000,37736749.0424677,0.0,37736749.0424677
10305,Short Cuts,6110979,0,6110979,9224339.23707161,0.0,9224339.23707161
10306,So I Married an Axe Murderer,11585483,20000000,-8414517,17487938.580271,30189399.233974103,-12701460.653703105
10307,The House of the Spirits,6,25000000,-24999994,9.05681977019225,37736749.0424677,-37736739.98564793
10308,Sirens,7770731,0,7770731,11729685.0249409,0.0,11729685.0249409
10309,Weekend at Bernie's II,0,0,0,0.0,0.0,0.0
10310,Naked,0,0,0,0.0,0.0,0.0
10311,Babylon 5: The Gathering,0,0,0,0.0,0.0,0.0
10312,Indecent Proposal,266614059,38000000,228614059,402445913.427067,57359858.5445509,345086054.8825161
10313,Arizona Dream,0,19000000,-19000000,0.0,28679929.272275396,-28679929.272275396
10314,Romeo Is Bleeding,0,10000000,-10000000,0.0,15094699.616987,-15094699.616987
10315,Menace II Society,27900000,3500000,24400000,42114211.9313939,5283144.86594548,36831067.06544842
10316,The Tommyknockers,0,12,-12,0.0,18.1136395403845,-18.1136395403845
10317,Body of Evidence,13273595,30000000,-16726405,20036092.936254103,45284098.85096121,-25248005.914707106
10318,My Life,27484464,0,27484464,41486972.821389504,0.0,41486972.821389504
10319,Heaven & Earth,0,33000000,-33000000,0.0,49812508.7360574,-49812508.7360574
10320,Sharpe's Rifles,0,0,0,0.0,0.0,0.0
10321,The Man Without a Face,24760338,0,24760338,37374986.452507004,0.0,37374986.452507004
10322,Heart and Souls,16589540,0,16589540,25041412.3083992,0.0,25041412.3083992
10323,Red Rock West,2000000,8000000,-6000000,3018939.92339741,12075759.6935896,-9056819.77019219
10324,What's Love Got to Do with It,0,0,0,0.0,0.0,0.0
10325,Six Degrees of Separation,0,0,0,0.0,0.0,0.0
10326,Amos & Andrew,0,0,0,0.0,0.0,0.0
10327,Leprechaun,8556940,900000,7656940,12916443.894058099,1358522.96552883,11557920.92852927
10328,Body Bags,0,0,0,0.0,0.0,0.0
10329,Rookie of the Year,53579269,0,53579269,80876297.12527479,0.0,80876297.12527479
10330,Fatal Instinct,0,0,0,0.0,0.0,0.0
10331,Son of the Pink Panther,2438031,25000000,-22561969,3680134.56019026,37736749.0424677,-34056614.48227744
10332,Bad Boy Bubby,0,750000,-750000,0.0,1132102.47127403,-1132102.47127403
10333,And the Band Played On,0,0,0,0.0,0.0,0.0
10334,The Secret Garden,0,0,0,0.0,0.0,0.0
10335,Little Buddha,4858139,35000000,-30141861,7333214.890257001,52831448.6594548,-45498233.7691978
10336,Killing Zoe,418961,1500000,-1081039,632409.044623252,2264204.94254806,-1631795.8979248079
10337,Mr. Jones,0,0,0,0.0,0.0,0.0
10338,Poetic Justice,27515786,14000000,13515786,41534252.4395298,21132579.463781897,20401672.975747902
10339,Germinal,0,0,0,0.0,0.0,0.0
10340,Matinee,9532895,0,9532895,14389618.650527801,0.0,14389618.650527801
10341,Searching for Bobby Fischer,7266383,0,7266383,10968386.8686981,0.0,10968386.8686981
10342,Even Cowgirls Get the Blues,0,8000000,-8000000,0.0,12075759.6935896,-12075759.6935896
10343,M. Butterfly,1499795,0,1499795,2263895.50120591,0.0,2263895.50120591
10344,Children of the Corn II: The Final Sacrifice,6980986,900000,6080986,10537588.6700392,1358522.96552883,9179065.704510368
10345,Swing Kids,5632086,0,5632086,8501464.63870383,0.0,8501464.63870383
10346,Freaked,0,0,0,0.0,0.0,0.0
10347,The Program,23042200,0,23042200,34781508.7514539,0.0,34781508.7514539
10348,The Joy Luck Club,32861136,11000000,21861136,49602897.699296005,16604169.5786858,32998728.120610207
10349,Made in America,0,22000000,-22000000,0.0,33208339.1573716,-33208339.1573716
10350,The Beverly Hillbillies,0,0,0,0.0,0.0,0.0
10351,Cop and Â½,0,0,0,0.0,0.0,0.0
10352,Untamed Heart,18899204,0,18899204,28527780.738016,0.0,28527780.738016
10353,Warlock: The Armageddon,0,0,0,0.0,0.0,0.0
10354,The Crush,13609396,6000000,7609396,20542974.4588625,9056819.77019225,11486154.688670248
10355,Fire in the Sky,19724334,19885552,-161218,29773289.6875125,30016643.415797602,-243353.72828510404
10356,We're Back! A Dinosaur's Story,9317021,0,9317021,14063763.332016,0.0,14063763.332016
10357,King of the Hill,0,0,0,0.0,0.0,0.0
10358,American Ninja 5,0,0,0,0.0,0.0,0.0
10359,"Double, Double, Toil and Trouble",0,0,0,0.0,0.0,0.0
10360,Cronos,0,0,0,0.0,0.0,0.0
10361,Fong Sai Yuk juk jaap,2967668,0,2967668,4479605.70229448,0.0,4479605.70229448
10362,Cyborg 2,0,5000000,-5000000,0.0,7547349.80849354,-7547349.80849354
10363,Sing si lip yan,0,0,0,0.0,0.0,0.0
10364,Only the Strong,3283371,6000000,-2716629,4956149.89761265,9056819.77019225,-4100669.8725796007
10365,Father Hood,3418141,0,3418141,5159581.16435078,0.0,5159581.16435078
10366,Zhong an zu,194720,0,194720,293923.990941972,0.0,293923.990941972
10367,Undercover Blues,12416686,0,12416686,18742614.5408449,0.0,18742614.5408449
10368,Man's Best Friend,12974636,6000000,6974636,19584823.3059746,9056819.77019225,10528003.535782348
10369,Boxing Helena,1796389,0,1796389,2711595.23502598,0.0,2711595.23502598
10370,Fong Sai Yuk,3956913,0,3956913,5972841.31455512,0.0,5972841.31455512
10371,The Thing Called Love,0,14000000,-14000000,0.0,21132579.463781897,-21132579.463781897
10372,Cannibal! The Musical,0,125000,-125000,0.0,188683.74521233802,-188683.74521233802
10373,Once Upon a Forest,6574896,0,6574896,9924608.01329299,0.0,9924608.01329299
10374,Ticks,0,2000000,-2000000,0.0,3018939.92339741,-3018939.92339741
10375,Necronomicon,0,0,0,0.0,0.0,0.0
10376,Just One of the Girls,0,0,0,0.0,0.0,0.0
10377,The Meteor Man,0,30,-30,0.0,45.2840988509612,-45.2840988509612
10378,Dragon: The Bruce Lee Story,63513743,14000000,49513743,95872087.2135516,21132579.463781897,74739507.7497697
10379,The Snapper,0,0,0,0.0,0.0,0.0
10380,Mr. Nanny,0,0,0,0.0,0.0,0.0
10381,Return of the Living Dead 3,54207,2000000,-1945793,81823.83821380191,3018939.92339741,-2937116.0851836083
10382,Boiling Point,0,0,0,0.0,0.0,0.0
10383,Doppelganger,0,0,0,0.0,0.0,0.0
10384,The Adventures of Huck Finn,0,0,0,0.0,0.0,0.0
10385,å¤ªæžå¼ ä¸‰ä¸°,0,0,0,0.0,0.0,0.0
10386,The Making of 'The Nightmare Before Christmas',0,0,0,0.0,0.0,0.0
10387,My Boyfriend's Back,0,0,0,0.0,0.0,0.0
10388,The Real McCoy,0,0,0,0.0,0.0,0.0
10389,Surf Ninjas,4916135,0,4916135,7420758.11015568,0.0,7420758.11015568
10390,Wong Fei Hung V: Tit gai dau ng gung,0,0,0,0.0,0.0,0.0
10391,Xi yan,6933459,1000000,5933459,10465848.0911695,1509469.9616987,8956378.129470801
10392,"Clean, Shaven",0,68000,-68000,0.0,102643.95739551198,-102643.95739551198
10393,AcciÃ³n mutante,0,0,0,0.0,0.0,0.0
10394,CB4,17953778,0,17953778,27100688.5900071,0.0,27100688.5900071
10395,12:01,0,0,0,0.0,0.0,0.0
10396,The Thief and the Cobbler,0,0,0,0.0,0.0,0.0
10397,Bill Hicks: Revelations,0,0,0,0.0,0.0,0.0
10398,The Jungle Book,205843612,4000000,201843612,1345551058.9884,26147054.9591484,1319404004.0292516
10399,The Graduate,104397102,3000000,101397102,682419190.892457,19610291.2193613,662808899.6730957
10400,Casino Royale,41744718,12000000,29744718,272875358.950038,78441164.87744541,194434194.07259262
10401,You Only Live Twice,111584787,9500000,102084787,729403389.573469,62099255.5279776,667304134.0454915
10402,Bonnie and Clyde,50700000,2500000,48200000,331413921.607207,16341909.3494678,315072012.2577392
10403,Belle de jour,0,0,0,0.0,0.0,0.0
10404,Cool Hand Luke,16217773,3000000,13217773,106011750.486498,19610291.2193613,86401459.2671367
10405,Wait Until Dark,11000000,4000000,7000000,71904401.1376583,26147054.9591484,45757346.1785099
10406,Dance of the Vampires,0,0,0,0.0,0.0,0.0
10407,The Producers,0,947000,-947000,0.0,6190315.261578401,-6190315.261578401
10408,Billion Dollar Brain,0,0,0,0.0,0.0,0.0
10409,The Dirty Dozen,45300000,25000000,20300000,296115397.412356,163419093.494678,132696303.91767803
10410,In the Heat of the Night,27379978,2000000,25379978,178976447.386569,13073527.4795742,165902919.9069948
10411,The Night of the Generals,0,0,0,0.0,0.0,0.0
10412,"To Sir, with Love",0,640000,-640000,0.0,4183528.79346375,-4183528.79346375
10413,Guess Who's Coming to Dinner,56666667,4000000,52666667,370416614.100191,26147054.9591484,344269559.1410426
10414,Quatermass and the Pit,0,0,0,0.0,0.0,0.0
10415,In Cold Blood,0,3500000,-3500000,0.0,22878673.089254897,-22878673.089254897
10416,The Taming of the Shrew,0,0,0,0.0,0.0,0.0
10417,Carry On Doctor,0,0,0,0.0,0.0,0.0
10418,Doctor Dolittle,9000000,18000000,-9000000,58830873.65808411,117661747.316168,-58830873.658083886
10419,Hombre,0,0,0,0.0,0.0,0.0
10420,Valley of the Dolls,50000000,5000000,45000000,326838186.989356,32683818.6989356,294154368.29042035
10421,Barefoot in the Park,0,0,0,0.0,0.0,0.0
10422,Two for the Road,0,0,0,0.0,0.0,0.0
10423,Point Blank,0,0,0,0.0,0.0,0.0
10424,The War Wagon,6000000,0,6000000,39220582.43872271,0.0,39220582.43872271
10425,A Countess from Hong Kong,2000000,3500000,-1500000,13073527.4795742,22878673.089254897,-9805145.609680697
10426,Magical Mystery Tour,0,0,0,0.0,0.0,0.0
10427,Spider Baby,0,65000,-65000,0.0,424889.643086163,-424889.643086163
10428,KaijÅ«tÅ no Kessen: Gojira no Musuko,0,0,0,0.0,0.0,0.0
10429,Bedazzled,0,0,0,0.0,0.0,0.0
10430,Dont Look Back,0,0,0,0.0,0.0,0.0
10431,The Gnome-Mobile,0,0,0,0.0,0.0,0.0
10432,Thoroughly Modern Millie,0,0,0,0.0,0.0,0.0
10433,Frankenstein Created Woman,0,0,0,0.0,0.0,0.0
10434,Six Men Getting Sick,0,200,-200,0.0,1307.35274795742,-1307.35274795742
10435,Who's That Knocking at My Door,0,0,0,0.0,0.0,0.0
10436,Follow That Camel,0,0,0,0.0,0.0,0.0
10437,In Like Flint,0,0,0,0.0,0.0,0.0
10438,From Russia With Love,78898765,2500000,76398765,561773358.994459,17800448.428896803,543972910.5655622
10439,The Sword in the Stone,0,0,0,0.0,0.0,0.0
10440,The Birds,11403529,2500000,8903529,81195171.9487717,17800448.428896803,63394723.5198749
10441,Charade,13474588,4000000,9474588,95941483.5178528,28480717.4862349,67460766.0316179
10442,Dinner for One,0,0,0,0.0,0.0,0.0
10443,Cleopatra,57750000,31115000,26635000,411190358.707516,221544381.14604902,189645977.561467
10444,"It's a Mad, Mad, Mad, Mad World",0,9400000,-9400000,0.0,66929686.092652,-66929686.092652
10445,The Pink Panther,10878107,0,10878107,77454073.06300859,0.0,77454073.06300859
10446,The Great Escape,5000000,4000000,1000000,35600896.85779361,28480717.4862349,7120179.371558707
10447,The Haunting,0,0,0,0.0,0.0,0.0
10448,Lord of the Flies,0,0,0,0.0,0.0,0.0
10449,Irma la Douce,0,0,0,0.0,0.0,0.0
10450,Murder at the Gallop,0,0,0,0.0,0.0,0.0
10451,The Day of the Triffids,0,750000,-750000,0.0,5340134.52866904,-5340134.52866904
10452,Hud,0,0,0,0.0,0.0,0.0
10453,Tom Jones,0,1000000,-1000000,0.0,7120179.37155872,-7120179.37155872
10454,The Raven,0,0,0,0.0,0.0,0.0
10455,Donovan's Reef,0,0,0,0.0,0.0,0.0
10456,Shock Corridor,0,0,0,0.0,0.0,0.0
10457,55 Days at Peking,10000000,17000000,-7000000,71201793.71558721,121043049.316498,-49841255.60091078
10458,The Terror,0,0,0,0.0,0.0,0.0
10459,Le Feu follet,0,0,0,0.0,0.0,0.0
10460,The Nutty Professor,0,0,0,0.0,0.0,0.0
10461,This Sporting Life,0,0,0,0.0,0.0,0.0
10462,McLintock!,0,0,0,0.0,0.0,0.0
10463,Jason and the Argonauts,0,1000000,-1000000,0.0,7120179.37155872,-7120179.37155872
10464,X: The Man with the X-Ray Eyes,0,0,0,0.0,0.0,0.0
10465,Billy Liar,0,0,0,0.0,0.0,0.0
10466,The Haunted Palace,0,0,0,0.0,0.0,0.0
10467,The Servant,0,0,0,0.0,0.0,0.0
10468,Lilies of the Field,0,0,0,0.0,0.0,0.0
10469,The Prize,0,0,0,0.0,0.0,0.0
10470,The Kiss of the Vampire,0,0,0,0.0,0.0,0.0
10471,La frusta e il corpo,0,66500,-66500,0.0,473491.928208655,-473491.928208655
10472,Aliens,131060248,18500000,112560248,260732097.580384,36804018.6009499,223928078.97943407
10473,Highlander,5900000,16000000,-10100000,11737497.8240867,31830502.5737945,-20093004.7497078
10474,Platoon,138530565,6000000,132530565,275593594.111357,11936438.4651729,263657155.6461841
10475,Top Gun,356830601,15000000,341830601,709881085.221197,29841096.1629323,680039989.0582647
10476,Ferris Bueller's Day Off,70136369,6000000,64136369,139529742.123193,11936438.4651729,127593303.6580201
10477,Stand by Me,52287000,8000000,44287000,104020093.004749,15915251.2868972,88104841.7178518
10478,AstÃ©rix chez les Bretons,0,0,0,0.0,0.0,0.0
10479,An American Tail,84542002,0,84542002,168188400.765921,0.0,168188400.765921
10480,The Fly,60629159,15000000,45629159,120616037.599781,29841096.1629323,90774941.4368487
10481,Nine 1/2 Weeks,6735922,17000000,-10264078,13400486.4098674,33819908.9846567,-20419422.5747893
10482,The Great Mouse Detective,82424789,14000000,68424789,163976403.65056002,27851689.752070196,136124713.89848983
10483,Pirates,1641825,40000000,-38358175,3266257.18051376,79576256.43448628,-76309999.25397253
10484,Allan Quatermain and the Lost City of Gold,0,0,0,0.0,0.0,0.0
10485,Short Circuit,40697761,0,40697761,80964386.6411359,0.0,80964386.6411359
10486,Blue Velvet,8551228,6000000,2551228,17011867.803944,11936438.4651729,5075429.338771099
10487,Star Trek IV: The Voyage Home,133000000,24000000,109000000,264591052.644667,47745753.86069179,216845298.7839752
10488,Howard the Duck,37962774,37000000,962774,75523385.9697112,73608037.2018998,1915348.7678114027
10489,Big Trouble in Little China,11000000,25000000,-14000000,21883470.5194837,49735160.271553904,-27851689.752070203
10490,The Color of Money,52293982,13800000,38493982,104033983.04031,27453808.4698977,76580174.5704123
10491,The Name of the Rose,77200000,20000000,57200000,153582174.918558,39788128.217243105,113794046.7013149
10492,Labyrinth,12729917,25000000,-12270083,25324978.489543103,49735160.271553904,-24410181.7820108
10493,Cobra,49042224,0,49042224,97564914.828538,0.0,97564914.828538
10494,The Hitcher,5844868,0,5844868,11627817.869842999,0.0,11627817.869842999
10495,"The Karate Kid, Part II",115103979,113,115103866,228988593.73834303,224.802924427423,228988368.9354186
10496,Flight of the Navigator,18564613,0,18564613,36932560.1173749,0.0,36932560.1173749
10497,Â¡Three Amigos!,0,25000000,-25000000,0.0,49735160.271553904,-49735160.271553904
10498,Raw Deal,16209459,8500000,7709459,32247201.651207298,16909954.4923283,15337247.158878997
10499,Crocodile Dundee,328203506,5000000,323203506,652930158.903837,9947032.05431079,642983126.8495262
10500,Heartbreak Ridge,42724017,15000000,27724017,84995433.3175838,29841096.1629323,55154337.1546515
10501,The Golden Child,79817939,25000000,54817939,158790319.548404,49735160.271553904,109055159.2768501
10502,Ruthless People,71624879,0,71624879,142490993.459826,0.0,142490993.459826
10503,Poltergeist II: The Other Side,40996665,19000000,21996665,81559028.1749682,37798721.806381,43760306.368587196
10504,The Money Pit,54999651,10000000,44999651,109416658.29458101,19894064.1086215,89522594.18595952
10505,Little Shop of Horrors,38748395,25000000,13748395,77086305.4236192,49735160.271553904,27351145.152065292
10506,Nothing in Common,0,0,0,0.0,0.0,0.0
10507,The Mission,17218023,24500000,-7281977,34253645.3385721,48740457.0661229,-14486811.727550797
10508,Hoosiers,28607524,9000000,19607524,56911991.644493006,17904657.6977594,39007333.94673361
10509,Friday the 13th Part VI: Jason Lives,19472057,3000000,16472057,38737835.028473295,5968219.23258647,32769615.795886826
10510,The Mosquito Coast,14302779,0,14302779,28454040.235744603,0.0,28454040.235744603
10511,From Beyond,1261000,4500000,-3239000,2508641.48409718,8952328.84887971,-6443687.36478253
10512,"No Retreat, No Surrender",4662137,0,4662137,9274885.23611767,0.0,9274885.23611767
10513,Police Academy 3: Back in Training,43579163,0,43579163,86696666.252207,0.0,86696666.252207
10514,Critters,13167232,2000000,11167232,26194975.7541093,3978812.82172431,22216162.93238499
10515,Pretty in Pink,40471663,0,40471663,80514585.8304528,0.0,80514585.8304528
10516,Sid & Nancy,2826523,4000000,-1173477,5623102.97664934,7957625.64344863,-2334522.66679929
10517,Crossroads,5738952,0,5738952,11417107.900430199,0.0,11417107.900430199
10518,DÃ¨moni 2,0,1500000,-1500000,0.0,2984109.61629323,-2984109.61629323
10519,Hannah and Her Sisters,40084041,6400000,33684041,79743448.1386616,12732201.029517801,67011247.10914379
10520,Soul Man,0,0,0,0.0,0.0,0.0
10521,King Kong Lives,4711220,10000000,-5288780,9372531.27098202,19894064.1086215,-10521532.83763948
10522,Salvador,0,4500000,-4500000,0.0,8952328.84887971,-8952328.84887971
10523,The Transformers: The Movie,5706456,0,5706456,11352460.149702802,0.0,11352460.149702802
10524,Jumpin' Jack Flash,0,0,0,0.0,0.0,0.0
10525,Down and Out in Beverly Hills,62134225,14000000,48134225,123610225.548951,27851689.752070196,95758535.79688081
10526,The Big Easy,0,0,0,0.0,0.0,0.0
10527,Maximum Overdrive,7433663,10000000,-2566337,14788576.8283888,19894064.1086215,-5105487.2802327
10528,A Room with a View,20966644,3000000,17966644,41711175.9878646,5968219.23258647,35742956.755278125
10529,Firewalker,11949484,0,11949484,23772380.0760947,0.0,23772380.0760947
10530,Peggy Sue Got Married,41382841,18000000,23382841,82327289.18508941,35809315.3955188,46517973.78957061
10531,Something Wild,8362969,0,8362969,16637344.1424414,0.0,16637344.1424414
10532,April Fool's Day,0,5000000,-5000000,0.0,9947032.05431079,-9947032.05431079
10533,Psycho III,14481606,0,14481606,28809799.8159799,0.0,28809799.8159799
10534,Mona Lisa,0,0,0,0.0,0.0,0.0
10535,Down by Law,0,0,0,0.0,0.0,0.0
10536,Black Moon Rising,6637565,0,6637565,13204814.3635142,0.0,13204814.3635142
10537,Henry: Portrait of a Serial Killer,0,111000,-111000,0.0,220824.11160569897,-220824.11160569897
10538,Mala Noche,0,22500,-22500,0.0,44761.6442443985,-44761.6442443985
10539,The Wraith,3500000,2700000,800000,6962922.43801755,5371397.30932783,1591525.1286897203
10540,Trick or Treat,6797218,0,6797218,13522429.0652276,0.0,13522429.0652276
10541,The Texas Chainsaw Massacre 2,8025872,4700000,3325872,15966721.209559,9350210.13105214,6616511.078506859
10542,Back to School,91258000,0,91258000,181549250.24245802,0.0,181549250.24245802
10543,Heartburn,0,0,0,0.0,0.0,0.0
10544,Gung Ho,36611610,0,36611610,72835371.6459851,0.0,72835371.6459851
10545,Tough Guys,0,0,0,0.0,0.0,0.0
10546,Deadly Friend,8988731,0,8988731,17882239.0769154,0.0,17882239.0769154
10547,Nan bei Shao Lin,0,10000000,-10000000,0.0,19894064.1086215,-19894064.1086215
10548,About Last Night...,38702310,0,38702310,76994623.62917459,0.0,76994623.62917459
10549,F/X,20603715,0,20603715,40989162.70857679,0.0,40989162.70857679
10550,Luxo Jr.,0,0,0,0.0,0.0,0.0
10551,House,0,3000000,-3000000,0.0,5968219.23258647,-5968219.23258647
10552,Invaders from Mars,4884663,12000000,-7115337,9717579.88710118,23872876.930345897,-14155297.043244716
10553,Clockwise,0,0,0,0.0,0.0,0.0
10554,Class of Nuke 'Em High,0,2000000,-2000000,0.0,3978812.82172431,-3978812.82172431
10555,Running Scared,0,0,0,0.0,0.0,0.0
10556,The Manhattan Project,3900000,18000000,-14100000,7758685.00236242,35809315.3955188,-28050630.393156383
10557,Rad,2015882,0,2015882,4010408.57434163,0.0,4010408.57434163
10558,At Close Range,2347000,6500000,-4153000,4669136.84629348,12931141.670604,-8262004.82431052
10559,One Crazy Summer,0,0,0,0.0,0.0,0.0
10560,Witchboard,0,0,0,0.0,0.0,0.0
10561,Round Midnight,0,0,0,0.0,0.0,0.0
10562,Iron Eagle,0,0,0,0.0,0.0,0.0
10563,Legal Eagles,0,0,0,0.0,0.0,0.0
10564,The Delta Force,17768900,0,17768900,35349563.573968604,0.0,35349563.573968604
10565,No Mercy,12303904,0,12303904,24477465.496232502,0.0,24477465.496232502
10566,Troll,5450815,1100000,4350815,10843886.305423599,2188347.05194837,8655539.253475228
10567,Caravaggio,0,0,0,0.0,0.0,0.0
10568,The Boy Who Could Fly,7177431,0,7177431,14278827.2449207,0.0,14278827.2449207
10569,The Clan of the Cave Bear,0,15000000,-15000000,0.0,29841096.1629323,-29841096.1629323
10570,Night of the Creeps,0,0,0,0.0,0.0,0.0
10571,Chopping Mall,0,800000,-800000,0.0,1591525.12868972,-1591525.12868972
10572,Armed and Dangerous,15945534,12000000,3945534,31722147.564220503,23872876.930345897,7849270.633874606
10573,Haunted Honeymoon,8033397,0,8033397,15981691.4928008,0.0,15981691.4928008
10574,Children of a Lesser God,31853080,0,31853080,63368721.5577052,0.0,63368721.5577052
10575,MacskafogÃ³,0,0,0,0.0,0.0,0.0
10576,Lucas,0,0,0,0.0,0.0,0.0
10577,Wildcats,0,0,0,0.0,0.0,0.0
10578,Club Paradise,12308521,15000000,-2691479,24486650.5856315,29841096.1629323,-5354445.577300798
10579,Youngblood,0,0,0,0.0,0.0,0.0
10580,She's Gotta Have It,0,0,0,0.0,0.0,0.0
10581,Captain EO,0,0,0,0.0,0.0,0.0
10582,When the Wind Blows,0,0,0,0.0,0.0,0.0
10583,Kuryer,0,0,0,0.0,0.0,0.0
10584,SpaceCamp,9697739,18000000,-8302261,19292744.1374679,35809315.3955188,-16516571.258050904
10585,Dead End Drive-In,0,0,0,0.0,0.0,0.0
10586,Absolute Beginners,0,0,0,0.0,0.0,0.0
10587,Gothic,0,0,0,0.0,0.0,0.0
10588,Vamp,4790926,1900000,2890926,9531098.898366198,3779872.1806381005,5751226.717728097
10589,Manhunter,8620929,15000000,-6379071,17150531.4201875,29841096.1629323,-12690564.7427448
10590,TerrorVision,0,0,0,0.0,0.0,0.0
10591,Lady Jane,0,8500000,-8500000,0.0,16909954.4923283,-16909954.4923283
10592,Yuppies 2,0,0,0,0.0,0.0,0.0
10593,Robin Hood,32056467,15000000,17056467,157434424.969513,73667393.6819896,83767031.2875234
10594,The Exorcist,441306145,8000000,433306145,2167324901.19974,39289276.6303944,2128035624.5693455
10595,Live and Let Die,161777836,7000000,154777836,794516768.908823,34378117.0515951,760138651.8572279
10596,Mean Streets,3000000,500000,2500000,14733478.7363979,2455579.78939965,12277898.94699825
10597,Enter the Dragon,90000000,850000,89150000,442004362.091937,4174485.64197941,437829876.4499576
10598,Westworld,0,0,0,0.0,0.0,0.0
10599,Battle for the Planet of the Apes,8844595,1700000,7144595,43437217.4548504,8348971.28395882,35088246.170891576
10600,Don't Look Now,0,1500000,-1500000,0.0,7366739.36819896,-7366739.36819896
10601,The Sting,159616327,5500000,154116327,783901253.278813,27011377.6833962,756889875.5954168
10602,Magnum Force,39768000,0,39768000,195306994.12969,0.0,195306994.12969
10603,High Plains Drifter,0,0,0,0.0,0.0,0.0
10604,The Day of the Jackal,0,0,0,0.0,0.0,0.0
10605,Breezy,0,0,0,0.0,0.0,0.0
10606,American Graffiti,115000000,777000,114223000,564783351.56192,3815970.99272706,560967380.569193
10607,Soylent Green,3,0,3,14.7334787363979,0.0,14.7334787363979
10608,Papillon,53267000,12000000,41267000,261602737.283902,58933914.945591696,202668822.3383103
10609,Sleeper,18344729,2000000,16344729,90093891.54882741,9822319.15759862,80271572.3912288
10610,Jesus Christ Superstar,13200000,0,13200000,64827306.44015079,0.0,64827306.44015079
10611,Serpico,29800000,3000000,26800000,146352555.448219,14733478.7363979,131619076.71182111
10612,Charley Varrick,0,0,0,0.0,0.0,0.0
10613,Paper Moon,0,0,0,0.0,0.0,0.0
10614,The Three Musketeers,0,0,0,0.0,0.0,0.0
10615,The Long Goodbye,0,0,0,0.0,0.0,0.0
10616,Pat Garrett & Billy the Kid,0,4638783,-4638783,0.0,22781803.5644214,-22781803.5644214
10617,The Golden Voyage of Sinbad,11000000,0,11000000,54022755.3667924,0.0,54022755.3667924
10618,The Legend of Hell House,0,0,0,0.0,0.0,0.0
10619,The Last Detail,0,0,0,0.0,0.0,0.0
10620,Charlotte's Web,0,0,0,0.0,0.0,0.0
10621,Cahill U.S. Marshal,0,0,0,0.0,0.0,0.0
10622,Badlands,0,0,0,0.0,0.0,0.0
10623,Coffy,0,500000,-500000,0.0,2455579.78939965,-2455579.78939965
10624,The Vault of Horror,0,0,0,0.0,0.0,0.0
10625,Sisters,0,500000,-500000,0.0,2455579.78939965,-2455579.78939965
10626,The Train Robbers,0,0,0,0.0,0.0,0.0
10627,A Charlie Brown Thanksgiving,0,0,0,0.0,0.0,0.0
10628,Walking Tall,0,0,0,0.0,0.0,0.0
10629,Frankenstein and the Monster from Hell,0,0,0,0.0,0.0,0.0
10630,The Holy Mountain,0,0,0,0.0,0.0,0.0
10631,Electra Glide in Blue,0,0,0,0.0,0.0,0.0
10632,The Friends of Eddie Coyle,0,0,0,0.0,0.0,0.0
10633,The Way We Were,45000000,0,45000000,221002181.04596803,0.0,221002181.04596803
10634,VÃ©ritÃ©s et Mensonges,0,0,0,0.0,0.0,0.0
10635,The Offence,0,0,0,0.0,0.0,0.0
10636,The Satanic Rites of Dracula,0,0,0,0.0,0.0,0.0
10637,Sssssss,0,0,0,0.0,0.0,0.0
10638,Messiah of Evil,0,0,0,0.0,0.0,0.0
10639,Don't Be Afraid of the Dark,0,0,0,0.0,0.0,0.0
10640,The Seven-Ups,0,0,0,0.0,0.0,0.0
10641,Scarecrow,0,0,0,0.0,0.0,0.0
10642,The Wicker Man,0,0,0,0.0,0.0,0.0
10643,Flesh for Frankenstein,0,450000,-450000,0.0,2210021.81045968,-2210021.81045968
10644,The Crazies,0,275000,-275000,0.0,1350568.88416981,-1350568.88416981
10645,The Last of Sheila,0,0,0,0.0,0.0,0.0
10646,Theatre of Blood,0,0,0,0.0,0.0,0.0
10647,Dillinger,2000000,1000000,1000000,9822319.15759862,4911159.57879931,4911159.57879931
10648,The Aristocats,55675257,4000000,51675257,312692750.95337796,22465473.375605803,290227277.57777214
10649,Beneath the Planet of the Apes,18999718,3000000,15999718,106709414.718254,16849105.0317044,89860309.6865496
10650,MASH,81600000,3500000,78100000,458295656.862359,19657289.2036551,438638367.65870386
10651,Kelly's Heroes,5200000,0,5200000,29205115.388287604,0.0,29205115.388287604
10652,Taste the Blood of Dracula,0,0,0,0.0,0.0,0.0
10653,Patton,89800000,12000000,77800000,504349877.28235096,67396420.1268176,436953457.1555334
10654,Love Story,136400000,2200000,134200000,766072642.10816,12356010.356583199,753716631.7515768
10655,Ryan's Daughter,0,0,0,0.0,0.0,0.0
10656,Tora! Tora! Tora!,29548291,25485000,4063291,165954086.188788,143133147.244328,22820938.944460005
10657,Beyond the Valley of the Dolls,0,0,0,0.0,0.0,0.0
10658,Two Mules for Sister Sara,5050000,0,5050000,28362660.1367024,0.0,28362660.1367024
10659,The Party at Kitty and Stud's,0,5000,-5000,0.0,28081.8417195073,-28081.8417195073
10660,Airport,100489151,10000000,90489151,564384086.581934,56163683.4390146,508220403.14291936
10661,Zabriskie Point,900000,7000000,-6100000,5054731.50951132,39314578.4073102,-34259846.89779888
10662,Scream and Scream Again,0,0,0,0.0,0.0,0.0
10663,Santa Claus Is Comin' to Town,0,0,0,0.0,0.0,0.0
10664,Catch-22,0,0,0,0.0,0.0,0.0
10665,Little Big Man,31559552,15000000,16559552,177250068.80051202,84245525.158522,93004543.64199002
10666,Colossus: The Forbin Project,0,0,0,0.0,0.0,0.0
10667,Soldier Blue,0,0,0,0.0,0.0,0.0
10668,The Twelve Chairs,0,0,0,0.0,0.0,0.0
10669,Scrooge,0,0,0,0.0,0.0,0.0
10670,"Nachts, wenn Dracula erwacht",0,0,0,0.0,0.0,0.0
10671,Performance,0,0,0,0.0,0.0,0.0
10672,Five Easy Pieces,0,0,0,0.0,0.0,0.0
10673,The Wizard of Gore,0,60000,-60000,0.0,336982.100634088,-336982.100634088
10674,Woodstock,0,0,0,0.0,0.0,0.0
10675,The Ballad of Cable Hogue,3500000,3716946,-216946,19657289.2036551,20875737.8503911,-1218448.6467359997
10676,Carry On Up the Jungle,0,0,0,0.0,0.0,0.0
10677,A Man Called Horse,0,0,0,0.0,0.0,0.0
10678,Gimme Shelter,0,0,0,0.0,0.0,0.0
10679,Chisum,0,6000000,-6000000,0.0,33698210.0634088,-33698210.0634088
10680,Let It Be,0,0,0,0.0,0.0,0.0
10681,Rio Lobo,0,0,0,0.0,0.0,0.0
10682,Deep End,0,0,0,0.0,0.0,0.0
10683,The Private Life of Sherlock Holmes,1500000,10000000,-8500000,8424552.5158522,56163683.4390146,-47739130.9231624
10684,Waterloo,0,25000000,-25000000,0.0,140409208.597536,-140409208.597536
10685,The Vampire Lovers,0,0,0,0.0,0.0,0.0
10686,And Soon the Darkness,0,0,0,0.0,0.0,0.0
10687,The Man Who Haunted Himself,0,0,0,0.0,0.0,0.0
10688,There Was a Crooked Man...,0,0,0,0.0,0.0,0.0
10689,Thunderball,141195658,11000000,130195658,977153544.4705039,76126200.6312938,901027343.8392102
10690,The Sound of Music,163214286,8200000,155014286,1129534861.9935699,56748622.288782604,1072786239.7047873
10691,Doctor Zhivago,111721910,14000000,97721910,773178594.14285,96887891.7125557,676290702.4302943
10692,Those Magnificent Men in Their Flying Machines or How I Flew from London to Paris in 25 hours 11 minutes,29950000,5600000,24350000,207270882.627931,38755156.685022295,168515725.9429087
10693,A Charlie Brown Christmas,0,0,0,0.0,0.0,0.0
10694,Ten Little Indians,0,0,0,0.0,0.0,0.0
10695,Dr. Terror's House of Horrors,0,0,0,0.0,0.0,0.0
10696,In Harm's Way,0,0,0,0.0,0.0,0.0
10697,The Flight of the Phoenix,0,0,0,0.0,0.0,0.0
10698,Help!,0,1500000,-1500000,0.0,10380845.540630901,-10380845.540630901
10699,The Sons of Katie Elder,0,0,0,0.0,0.0,0.0
10700,The Ipcress File,0,0,0,0.0,0.0,0.0
10701,"Faster, Pussycat! Kill! Kill!",0,45000,-45000,0.0,311425.366218929,-311425.366218929
10702,The Cincinnati Kid,0,0,0,0.0,0.0,0.0
10703,What's New Pussycat?,0,0,0,0.0,0.0,0.0
10704,Von Ryan's Express,0,5760000,-5760000,0.0,39862446.8760229,-39862446.8760229
10705,Operation Crossbow,0,115,-115,0.0,795.8648247817081,-795.8648247817081
10706,The Spy Who Came in from the Cold,0,0,0,0.0,0.0,0.0
10707,Dr. Goldfoot and the Bikini Machine,0,0,0,0.0,0.0,0.0
10708,The Hill,0,0,0,0.0,0.0,0.0
10709,Shenandoah,0,0,0,0.0,0.0,0.0
10710,The Heroes of Telemark,0,0,0,0.0,0.0,0.0
10711,Darling,0,0,0,0.0,0.0,0.0
10712,Battle of the Bulge,0,0,0,0.0,0.0,0.0
10713,Repulsion,0,300000,-300000,0.0,2076169.10812619,-2076169.10812619
10714,The Skull,0,0,0,0.0,0.0,0.0
10715,Bunny Lake Is Missing,0,0,0,0.0,0.0,0.0
10716,The Greatest Story Ever Told,12000000,20000000,-8000000,83046764.3250478,138411273.875079,-55364509.5500312
10717,Cat Ballou,0,0,0,0.0,0.0,0.0
10718,The Agony and the Ecstasy,0,0,0,0.0,0.0,0.0
10719,Major Dundee,0,3800000,-3800000,0.0,26298142.0362651,-26298142.0362651
10720,Ship of Fools,0,0,0,0.0,0.0,0.0
10721,That Darn Cat!,0,0,0,0.0,0.0,0.0
10722,I Saw What You Did,0,0,0,0.0,0.0,0.0
10723,"Die, Monster, Die!",0,0,0,0.0,0.0,0.0
10724,On Her Majesty's Secret Service,81974493,7000000,74974493,487278044.146861,41609849.40801071,445668194.7388503
10725,Butch Cassidy and the Sundance Kid,102308889,6000000,96308889,608151066.341555,35665585.206866294,572485481.1346887
10726,Easy Rider,0,360000,-360000,0.0,2139935.11241198,-2139935.11241198
10727,Midnight Cowboy,44785053,3600000,41185053,266214187.294254,21399351.1241198,244814836.17013422
10728,The Wild Bunch,638641,6244087,-5605446,3796250.83368305,37116502.822931,-33320251.989247948
10729,Take the Money and Run,0,1500000,-1500000,0.0,8916396.30171658,-8916396.30171658
10730,Battle of Britain,0,12000000,-12000000,0.0,71331170.41373259,-71331170.41373259
10731,Topaz,0,4000000,-4000000,0.0,23777056.8045775,-23777056.8045775
10732,Frosty the Snowman,0,0,0,0.0,0.0,0.0
10733,"They Shoot Horses, Don't They?",0,0,0,0.0,0.0,0.0
10734,Paint Your Wagon,0,0,0,0.0,0.0,0.0
10735,"Hello, Dolly!",0,0,0,0.0,0.0,0.0
10736,Kes,0,0,0,0.0,0.0,0.0
10737,Mackenna's Gold,0,0,0,0.0,0.0,0.0
10738,A Boy Named Charlie Brown,0,0,0,0.0,0.0,0.0
10739,The Computer Wore Tennis Shoes,0,0,0,0.0,0.0,0.0
10740,True Grit,14250000,0,14250000,84705764.8663075,0.0,84705764.8663075
10741,Cactus Flower,0,0,0,0.0,0.0,0.0
10742,Women in Love,0,1250000,-1250000,0.0,7430330.25143048,-7430330.25143048
10743,The Valley of Gwangi,0,0,0,0.0,0.0,0.0
10744,Support Your Local Sheriff,0,0,0,0.0,0.0,0.0
10745,The Bridge at Remagen,0,0,0,0.0,0.0,0.0
10746,Carry On Again Doctor,0,0,0,0.0,0.0,0.0
10747,Castle Keep,0,0,0,0.0,0.0,0.0
10748,Hercules in New York,0,0,0,0.0,0.0,0.0
10749,The Oblong Box,0,175000,-175000,0.0,1040246.23520026,-1040246.23520026
10750,The Prime of Miss Jean Brodie,0,0,0,0.0,0.0,0.0
10751,DoppelgÃ¤nger,0,0,0,0.0,0.0,0.0
10752,Downhill Racer,0,0,0,0.0,0.0,0.0
10753,Carry On Camping,0,0,0,0.0,0.0,0.0
10754,Bambi Meets Godzilla,0,0,0,0.0,0.0,0.0
10755,Grease,181813770,6000000,175813770,607749015.323942,20056204.169484198,587692811.1544578
10756,Jaws 2,187884007,20000000,167884007,628040000.7621349,66854013.898280896,561185986.863854
10757,Dawn of the Dead,55000000,650000,54350000,183848538.220272,2172755.45169413,181675782.76857787
10758,Superman,300218018,55000000,245218018,1003538977.39431,183848538.220272,819690439.1740379
10759,Halloween,70000000,300000,69700000,233989048.643983,1002810.20847421,232986238.4355088
10760,Animal House,141000000,2700000,138300000,471320797.98288,9025291.87626792,462295506.1066121
10761,Revenge of the Pink Panther,49579269,0,49579269,165728656.93963,0.0,165728656.93963
10762,The Deer Hunter,50000000,15000000,35000000,167135034.745702,50140510.423710704,116994524.3219913
10763,The Driver,0,0,0,0.0,0.0,0.0
10764,Up in Smoke,41590893,0,41590893,139025906.933195,0.0,139025906.933195
10765,Days of Heaven,0,0,0,0.0,0.0,0.0
10766,Paradise Alley,7185518,0,7185518,24019036.0119173,0.0,24019036.0119173
10767,Game of Death,0,0,0,0.0,0.0,0.0
10768,The Star Wars Holiday Special,0,0,0,0.0,0.0,0.0
10769,Pretty Baby,0,0,0,0.0,0.0,0.0
10770,Midnight Express,35000000,2300000,32700000,116994524.321991,7688211.598302299,109306312.72368869
10771,The Lord of the Rings,30471420,4000000,26471420,101856836.809017,13370802.7796561,88486034.0293609
10772,Capricorn One,0,5000000,-5000000,0.0,16713503.4745702,-16713503.4745702
10773,Foul Play,0,0,0,0.0,0.0,0.0
10774,Coma,0,0,0,0.0,0.0,0.0
10775,Death on the Nile,14560084,7920000,6640084,48670002.9048069,26474189.5037192,22195813.401087698
10776,The Silent Partner,0,0,0,0.0,0.0,0.0
10777,F.I.S.T.,11,11,0,36.7697076440545,36.7697076440545,0.0
10778,Force 10 from Navarone,7230000,5000000,2230000,24167726.024228502,16713503.4745702,7454222.549658302
10779,Convoy,22765081,12000000,10765081,76096852.0784745,40112408.3389685,35984443.739506006
10780,Invasion of the Body Snatchers,24046533,3500000,20546533,80380362.5693735,11699452.4321991,68680910.1371744
10781,Piranha,0,660000,-660000,0.0,2206182.45864327,-2206182.45864327
10782,The Wild Geese,0,10000000,-10000000,0.0,33427006.9491404,-33427006.9491404
10783,Starcrash,0,0,0,0.0,0.0,0.0
10784,Day of the Woman,0,650000,-650000,0.0,2172755.45169413,-2172755.45169413
10785,Every Which Way But Loose,0,0,0,0.0,0.0,0.0
10786,The Buddy Holly Story,0,0,0,0.0,0.0,0.0
10787,Return From Witch Mountain,16393000,0,16393000,54796892.4917259,0.0,54796892.4917259
10788,The Wiz,21049053,24000000,-2950947,70360684.0903826,80224816.67793709,-9864132.587554485
10789,Magic,0,0,0,0.0,0.0,0.0
10790,I Wanna Hold Your Hand,0,2700000,-2700000,0.0,9025291.87626792,-9025291.87626792
10791,Damien: Omen II,26518355,6800000,19718355,88642923.68647741,22730364.725415498,65912558.96106191
10792,Faces of Death,0,0,0,0.0,0.0,0.0
10793,Watership Down,3713768,1000000,2713768,12414014.8743495,3342700.69491404,9071314.179435458
10794,Goin' South,0,0,0,0.0,0.0,0.0
10795,Battlestar Galactica,0,3000000,-3000000,0.0,10028102.084742099,-10028102.084742099
10796,The Swarm,0,0,0,0.0,0.0,0.0
10797,Blue Collar,0,0,0,0.0,0.0,0.0
10798,Heaven Can Wait,0,0,0,0.0,0.0,0.0
10799,Patrick,0,0,0,0.0,0.0,0.0
10800,Big Wednesday,0,11000000,-11000000,0.0,36769707.644054495,-36769707.644054495
10801,The Fury,0,0,0,0.0,0.0,0.0
10802,Fedora,0,6727000,-6727000,0.0,22486347.5746867,-22486347.5746867
10803,Eyes of Laura Mars,0,0,0,0.0,0.0,0.0
10804,Interiors,0,0,0,0.0,0.0,0.0
10805,The Boys from Brazil,0,0,0,0.0,0.0,0.0
10806,Gates of Heaven,0,0,0,0.0,0.0,0.0
10807,The Medusa Touch,0,0,0,0.0,0.0,0.0
10808,The Manitou,0,0,0,0.0,0.0,0.0
10809,Someone's Watching Me!,0,0,0,0.0,0.0,0.0
10810,Attack of the Killer Tomatoes!,0,90000,-90000,0.0,300843.062542264,-300843.062542264
10811,Can que,0,0,0,0.0,0.0,0.0
10812,Gray Lady Down,5438927,0,5438927,18180705.0624867,0.0,18180705.0624867
10813,KISS Meets the Phantom of the Park,0,0,0,0.0,0.0,0.0
10814,The Cat from Outer Space,0,0,0,0.0,0.0,0.0
10815,Coming Home,0,3000000,-3000000,0.0,10028102.084742099,-10028102.084742099
10816,The Rutles: All You Need Is Cash,0,0,0,0.0,0.0,0.0
10817,The Last Waltz,321952,0,321952,1076189.17412896,0.0,1076189.17412896
10818,Long Weekend,0,0,0,0.0,0.0,0.0
10819,Hooper,78000000,0,78000000,260730654.20329502,0.0,260730654.20329502
10820,How the Grinch Stole Christmas!,0,315000,-315000,0.0,2116174.62807391,-2116174.62807391
10821,Fahrenheit 451,0,0,0,0.0,0.0,0.0
10822,Who's Afraid of Virginia Woolf?,33736689,7500000,26236689,226643572.371492,50385110.1922359,176258462.17925608
10823,One Million Years B.C.,0,0,0,0.0,0.0,0.0
10824,The Bible: In the Beginning...,0,18000000,-18000000,0.0,120924264.461366,-120924264.461366
10825,Blow-Up,0,0,0,0.0,0.0,0.0
10826,A Man for All Seasons,0,0,0,0.0,0.0,0.0
10827,Batman,0,1377800,-1377800,0.0,9256080.64304836,-9256080.64304836
10828,Torn Curtain,13000000,3000000,10000000,87334190.99987571,20154044.0768943,67180146.92298141
10829,El Dorado,6000000,4653000,1347000,40308088.1537887,31258922.3632632,9049165.7905255
10830,Cul-de-sac,0,0,0,0.0,0.0,0.0
10831,The Fortune Cookie,0,0,0,0.0,0.0,0.0
10832,Arabesque,0,4800000,-4800000,0.0,32246470.523031,-32246470.523031
10833,How to Steal a Million,0,0,0,0.0,0.0,0.0
10834,Return of the Seven,0,0,0,0.0,0.0,0.0
10835,The Sand Pebbles,20000000,12000000,8000000,134360293.84596202,80616176.3075775,53744117.53838451
10836,Walk Don't Run,0,0,0,0.0,0.0,0.0
10837,The Blue Max,0,0,0,0.0,0.0,0.0
10838,The Professionals,0,0,0,0.0,0.0,0.0
10839,"It's the Great Pumpkin, Charlie Brown",0,0,0,0.0,0.0,0.0
10840,Funeral in Berlin,0,0,0,0.0,0.0,0.0
10841,The Shooting,0,75000,-75000,0.0,503851.10192235897,-503851.10192235897
10842,Winnie the Pooh and the Honey Tree,0,0,0,0.0,0.0,0.0
10843,Khartoum,0,0,0,0.0,0.0,0.0
10844,Our Man Flint,0,0,0,0.0,0.0,0.0
10845,Carry On Cowboy,0,0,0,0.0,0.0,0.0
10846,Dracula: Prince of Darkness,0,0,0,0.0,0.0,0.0
10847,Island of Terror,0,0,0,0.0,0.0,0.0
10848,Fantastic Voyage,12000000,5115000,6885000,80616176.3075775,34362645.151104905,46253531.1564726
10849,Gambit,0,0,0,0.0,0.0,0.0
10850,Harper,0,0,0,0.0,0.0,0.0
10851,Born Free,0,0,0,0.0,0.0,0.0
10852,A Big Hand for the Little Lady,0,0,0,0.0,0.0,0.0
10853,Alfie,0,0,0,0.0,0.0,0.0
10854,The Chase,0,0,0,0.0,0.0,0.0
10855,The Ghost & Mr. Chicken,0,700000,-700000,0.0,4702610.28460869,-4702610.28460869
10856,The Ugly Dachshund,0,0,0,0.0,0.0,0.0
10857,Nevada Smith,0,0,0,0.0,0.0,0.0
10858,"The Russians Are Coming, The Russians Are Coming",0,0,0,0.0,0.0,0.0
10859,Seconds,0,0,0,0.0,0.0,0.0
10860,Carry On Screaming!,0,0,0,0.0,0.0,0.0
10861,The Endless Summer,0,0,0,0.0,0.0,0.0
10862,Grand Prix,0,0,0,0.0,0.0,0.0
10863,Beregis Avtomobilya,0,0,0,0.0,0.0,0.0
10864,"What's Up, Tiger Lily?",0,0,0,0.0,0.0,0.0
10865,Manos: The Hands of Fate,0,19000,-19000,0.0,127642.279153664,-127642.279153664
